序号,TEAM,result,MIN,FG,FGA,FGP,3P,3PA,3PP,2P,2PA,2PP,FT,FTA,FTP,ORB,DRB,TRB,AST,STL,BLK,TOV,PF
1,HOU,0,240,35,80,43.8,12,48,25,23,32,71.88,14,16,87.5,1,26,27,25,10,9,17,18
2,TOR,1,240,45,90,50,18,35,51.4,27,55,49.09,9,14,64.3,13,38,51,27,8,5,19,24
3,IND,1,240,43,89,48.3,15,38,39.5,28,51,54.9,8,11,72.7,12,39,51,32,11,3,20,27
4,MIA,0,240,31,87,35.6,10,38,26.3,21,49,42.86,20,27,74.1,14,34,48,14,6,5,19,15
5,PHI,1,240,49,87,56.3,18,38,47.4,31,49,63.27,18,22,81.8,8,43,51,31,8,4,16,19
6,OKC,0,265,38,106,35.8,14,44,31.8,24,62,38.71,13,22,59.1,11,37,48,18,5,6,16,29
7,LAC,1,265,34,85,40,12,37,32.4,22,48,45.83,27,39,69.2,12,49,61,23,10,2,23,22
8,DEN,0,240,36,87,41.4,16,38,42.1,20,49,40.82,21,23,91.3,9,32,41,27,9,11,16,15
9,UTA,1,240,47,101,46.5,15,46,32.6,32,55,58.18,9,10,90,12,31,43,25,7,5,9,23
10,POR,1,240,50,104,48.1,13,39,33.3,37,65,56.92,21,24,87.5,14,28,42,25,10,4,9,21
11,MEM,1,240,45,90,50,13,33,39.4,32,57,56.14,16,23,69.6,9,46,55,36,4,3,18,18
12,BKN,0,240,53,96,55.2,14,33,42.4,39,63,61.9,13,19,68.4,12,34,46,28,5,5,14,23
13,ORL,1,240,48,84,57.1,15,28,53.6,33,56,58.93,22,30,73.3,6,27,33,25,6,2,12,22
14,NOP,0,240,48,87,55.2,10,34,29.4,38,53,71.7,21,27,77.8,9,31,40,22,6,4,13,22
15,WAS,1,240,34,88,38.6,10,26,38.5,24,62,38.71,18,24,75,18,38,56,22,11,6,18,19
16,SAS,0,240,39,79,49.4,10,20,50,29,59,49.15,24,36,66.7,9,35,44,24,4,8,15,20
17,LAL,0,240,48,98,49,15,35,42.9,33,63,52.38,11,15,73.3,15,32,47,29,6,1,17,18
18,BOS,0,240,35,88,39.8,8,35,22.9,27,53,50.94,12,14,85.7,13,38,51,22,8,7,19,19
19,SAC,1,240,54,95,56.8,21,47,44.7,33,48,68.75,7,12,58.3,9,35,44,37,12,2,15,15
20,DAL,0,240,39,89,43.8,8,26,30.8,31,63,49.21,16,19,84.2,11,32,43,17,3,4,11,18
21,MIL,0,240,39,98,39.8,13,41,31.7,26,57,45.61,15,23,65.2,9,36,45,27,8,3,15,22
22,PHX,1,240,49,89,55.1,14,34,41.2,35,55,63.64,16,21,76.2,7,38,45,34,6,4,6,14
23,MIA,0,240,42,86,48.8,14,42,33.3,28,44,63.64,17,20,85,6,34,40,24,14,2,12,23
24,HOU,0,240,32,86,37.2,16,57,28.1,16,29,55.17,24,28,85.7,6,43,49,20,8,6,20,20
25,PHI,0,240,39,84,46.4,17,40,42.5,22,44,50,26,33,78.8,9,38,47,27,9,10,17,29
26,LAC,1,240,46,85,54.1,14,37,37.8,32,48,66.67,18,23,78.3,6,34,40,29,11,1,8,25
27,OKC,1,240,39,89,43.8,16,42,38.1,23,47,48.94,22,27,81.5,14,36,50,20,7,4,16,19
28,TOR,1,240,40,90,44.4,18,43,41.9,22,47,46.81,27,40,67.5,11,36,47,28,8,7,12,23
29,IND,1,240,40,100,40,11,31,35.5,29,69,42.03,17,22,77.3,12,42,54,25,15,7,15,25
30,DEN,0,240,43,87,49.4,13,35,37.1,30,52,57.69,12,19,63.2,9,33,42,33,4,3,12,19
31,NOP,0,240,42,82,51.2,7,24,29.2,35,58,60.34,15,19,78.9,5,29,34,25,8,6,19,18
32,PHX,1,240,49,89,55.1,12,28,42.9,37,61,60.66,20,21,95.2,11,33,44,28,4,3,7,18
33,BKN,1,240,38,89,42.7,13,43,30.2,25,46,54.35,19,24,79.2,8,39,47,26,9,4,15,20
34,BOS,1,240,44,86,51.2,16,37,43.2,28,49,57.14,18,23,78.3,10,36,46,29,7,7,15,27
35,SAS,1,240,46,93,49.5,13,32,40.6,33,61,54.1,18,20,90,9,50,59,28,10,5,22,20
36,SAC,1,240,43,88,48.9,11,26,42.3,32,62,51.61,15,16,93.8,14,31,45,27,4,6,21,22
37,POR,1,240,46,98,46.9,15,38,39.5,31,60,51.67,27,29,93.1,12,36,48,18,9,3,8,31
38,HOU,0,240,36,89,40.4,14,48,29.2,22,41,53.66,19,21,90.5,4,33,37,18,14,3,18,19
39,MIL,1,240,44,87,50.6,18,38,47.4,26,49,53.06,20,28,71.4,9,44,53,25,6,0,15,26
40,PHI,0,240,46,93,49.5,15,33,45.5,31,60,51.67,10,14,71.4,11,23,34,28,5,4,9,20
41,WAS,0,240,39,95,41.1,12,35,34.3,27,60,45,23,30,76.7,11,33,44,22,2,3,11,23
42,MEM,0,240,35,89,39.3,7,29,24.1,28,60,46.67,30,38,78.9,14,30,44,26,8,4,8,15
43,DAL,0,240,42,81,51.9,20,44,45.5,22,37,59.46,27,33,81.8,5,32,37,28,4,5,17,23
44,ORL,0,240,32,83,38.6,7,23,30.4,25,60,41.67,25,29,86.2,12,37,49,13,9,3,17,24
45,OKC,0,240,35,90,38.9,13,39,33.3,22,51,43.14,18,21,85.7,8,32,40,24,10,2,19,23
46,TOR,1,240,42,97,43.3,12,40,30,30,57,52.63,18,26,69.2,16,39,55,24,11,6,14,27
47,LAL,1,240,44,81,54.3,14,29,48.3,30,52,57.69,22,32,68.8,14,18,32,28,8,4,10,18
48,MIA,1,240,44,98,44.9,13,40,32.5,31,58,53.45,13,19,68.4,13,46,59,29,11,9,14,20
49,PHX,1,240,42,89,47.2,17,34,50,25,55,45.45,27,29,93.1,12,41,53,29,11,7,20,23
50,UTA,0,240,39,82,47.6,21,46,45.7,18,36,50,15,20,75,11,27,38,28,5,6,12,19
51,DEN,0,240,45,77,58.4,13,23,56.5,32,54,59.26,18,23,78.3,10,25,35,27,6,2,14,20
52,IND,0,240,33,84,39.3,10,35,28.6,23,49,46.94,16,25,64,6,39,45,20,5,4,17,19
53,MIL,0,240,33,84,39.3,14,43,32.6,19,41,46.34,26,35,74.3,11,38,49,25,4,6,19,21
54,DAL,1,240,48,85,56.5,12,24,50,36,61,59.02,14,16,87.5,4,30,34,29,6,3,8,23
55,LAC,0,240,45,93,48.4,13,36,36.1,32,57,56.14,17,20,85,10,29,39,23,8,2,10,19
56,WAS,0,240,38,92,41.3,9,36,25,29,56,51.79,18,22,81.8,13,31,44,23,6,3,16,18
57,BKN,1,240,47,85,55.3,20,43,46.5,27,42,64.29,15,19,78.9,8,38,46,32,5,5,16,25
58,MEM,0,240,37,91,40.7,14,42,33.3,23,49,46.94,11,16,68.8,10,32,42,24,14,3,22,27
59,OKC,1,240,43,84,51.2,18,39,46.2,25,45,55.56,17,22,77.3,8,35,43,25,7,3,12,18
60,POR,1,240,43,91,47.3,11,35,31.4,32,56,57.14,27,29,93.1,7,34,41,19,8,6,10,16
61,PHI,0,240,47,97,48.5,14,30,46.7,33,67,49.25,13,17,76.5,14,34,48,24,6,3,15,23
62,SAS,1,240,40,89,44.9,11,28,39.3,29,61,47.54,31,32,96.9,15,36,51,22,12,6,17,27
63,ORL,0,265,41,102,40.2,15,47,31.9,26,55,47.27,22,26,84.6,12,40,52,24,7,4,14,25
64,HOU,1,240,43,91,47.3,18,57,31.6,25,34,73.53,25,30,83.3,8,40,48,21,9,3,15,18
65,NOP,0,240,42,96,43.8,12,30,40,30,66,45.45,17,22,77.3,16,32,48,30,5,5,20,26
66,BOS,1,265,45,102,44.1,12,40,30,33,62,53.23,20,24,83.3,13,41,54,32,9,7,13,19
67,TOR,1,240,34,71,47.9,15,39,38.5,19,32,59.38,25,33,75.8,5,35,40,25,17,7,26,23
68,SAC,0,240,41,87,47.1,10,37,27,31,50,62,20,23,87,5,36,41,29,9,2,18,22
69,LAC,1,240,42,85,49.4,15,34,44.1,27,51,52.94,23,28,82.1,9,36,45,24,5,2,14,22
70,MIA,0,240,41,84,48.8,11,36,30.6,30,48,62.5,19,22,86.4,3,34,37,28,6,9,12,21
71,PHX,1,240,44,92,47.8,12,32,37.5,32,60,53.33,19,20,95,12,40,52,27,5,4,11,21
72,DAL,1,265,48,115,41.7,17,53,32.1,31,62,50,23,25,92,11,43,54,37,6,2,7,26
73,MIL,0,265,47,99,47.5,15,44,34.1,32,55,58.18,23,34,67.6,9,46,55,26,3,9,13,26
74,IND,1,240,44,84,52.4,15,33,45.5,29,51,56.86,13,14,92.9,7,35,42,25,12,4,20,21
75,LAL,0,240,42,100,42,13,39,33.3,29,61,47.54,14,19,73.7,15,29,44,20,13,6,15,16
76,UTA,0,290,47,105,44.8,22,55,40,25,50,50,16,22,72.7,15,36,51,34,6,4,23,30
77,POR,0,240,44,90,48.9,17,43,39.5,27,47,57.45,12,17,70.6,9,32,41,24,5,2,11,26
78,DEN,1,290,51,108,47.2,9,37,24.3,42,71,59.15,23,30,76.7,12,40,52,29,10,5,11,24
79,BKN,1,240,42,86,48.8,17,40,42.5,25,46,54.35,18,28,64.3,7,37,44,30,9,3,11,23
80,TOR,0,240,38,89,42.7,10,38,26.3,28,51,54.9,14,17,82.4,9,39,48,20,8,7,18,18
81,NOP,1,240,42,88,47.7,12,35,34.3,30,53,56.6,22,26,84.6,11,34,45,25,7,8,20,19
82,WAS,0,240,38,90,42.2,10,27,37,28,63,44.44,21,23,91.3,10,30,40,22,9,4,16,27
83,BOS,1,240,47,96,49,16,46,34.8,31,50,62,12,16,75,9,43,52,27,8,2,15,22
84,SAS,1,240,45,89,50.6,9,22,40.9,36,67,53.73,20,26,76.9,8,39,47,27,10,5,13,18
85,ORL,0,240,37,88,42,8,32,25,29,56,51.79,19,25,76,10,37,47,17,5,2,11,24
86,SAC,0,240,38,89,42.7,12,40,30,26,49,53.06,18,24,75,13,37,50,19,3,4,15,26
87,PHI,1,240,38,93,40.9,8,29,27.6,30,64,46.88,24,33,72.7,15,36,51,19,4,4,9,20
88,UTA,0,240,38,91,41.8,16,37,43.2,22,54,40.74,19,24,79.2,10,39,49,25,8,4,16,19
89,MEM,1,240,46,83,55.4,11,31,35.5,35,52,67.31,18,20,90,12,46,58,24,6,4,20,19
90,OKC,0,240,34,97,35.1,13,43,30.2,21,54,38.89,11,15,73.3,12,24,36,19,12,2,10,20
91,IND,0,240,37,85,43.5,10,29,34.5,27,56,48.21,15,19,78.9,5,33,38,20,6,5,15,22
92,NOP,0,240,47,82,57.3,14,34,41.2,33,48,68.75,17,23,73.9,5,25,30,31,4,3,17,26
93,DEN,0,240,44,84,52.4,14,28,50,30,56,53.57,13,17,76.5,11,33,44,30,5,4,16,22
94,POR,1,240,43,92,46.7,23,39,59,20,53,37.74,16,20,80,13,26,39,30,7,6,9,18
95,PHX,1,240,43,92,46.7,9,34,26.5,34,58,58.62,19,20,95,12,41,53,27,6,4,16,20
96,DAL,0,240,39,87,44.8,17,48,35.4,22,39,56.41,16,21,76.2,8,29,37,24,3,4,8,17
97,LAC,1,240,50,92,54.3,14,31,45.2,36,61,59.02,12,15,80,9,36,45,22,3,3,8,21
98,MIL,1,240,41,78,52.6,15,37,40.5,26,41,63.41,33,38,86.8,5,39,44,27,7,3,14,21
99,LAL,0,240,35,77,45.5,2,19,10.5,33,58,56.9,25,36,69.4,12,36,48,18,11,6,25,20
100,HOU,1,240,36,84,42.9,21,57,36.8,15,27,55.56,20,23,87,4,30,34,26,11,5,20,28
101,SAC,1,240,50,93,53.8,16,33,48.5,34,60,56.67,24,33,72.7,13,26,39,26,11,3,8,20
102,MIA,0,240,35,83,42.2,21,46,45.7,14,37,37.84,25,27,92.6,6,33,39,28,6,1,19,28
103,WAS,0,240,36,85,42.4,7,21,33.3,29,64,45.31,19,24,79.2,9,39,48,17,8,5,15,26
104,BOS,1,240,50,88,56.8,20,39,51.3,30,49,61.22,29,35,82.9,6,37,43,29,10,10,14,23
105,TOR,1,240,38,78,48.7,12,33,36.4,26,45,57.78,21,30,70,3,41,44,25,6,2,15,21
106,ORL,0,240,35,87,40.2,11,41,26.8,24,46,52.17,18,26,69.2,8,35,43,26,8,4,13,26
107,SAS,0,240,46,93,49.5,11,30,36.7,35,63,55.56,23,27,85.2,10,25,35,29,10,5,9,20
108,OKC,1,240,34,79,43,5,24,20.8,29,55,52.73,32,36,88.9,4,48,52,17,9,2,14,23
109,LAL,0,240,31,88,35.2,5,37,13.5,26,51,50.98,19,29,65.5,10,36,46,17,7,3,11,24
110,BKN,0,240,45,95,47.4,8,32,25,37,63,58.73,17,21,81,7,27,34,23,9,2,18,22
111,UTA,1,240,38,84,45.2,18,45,40,20,39,51.28,30,33,90.9,11,35,46,25,5,4,18,23
112,DEN,1,240,50,91,54.9,14,36,38.9,36,55,65.45,18,21,85.7,14,32,46,31,6,5,14,21
113,PHI,1,240,38,82,46.3,11,29,37.9,27,53,50.94,20,29,69,6,35,41,27,11,4,14,21
114,MEM,0,240,43,91,47.3,11,29,37.9,32,62,51.61,18,25,72,9,32,41,21,7,3,14,28
115,MIL,0,240,42,88,47.7,17,51,33.3,25,37,67.57,15,23,65.2,7,47,54,28,3,5,19,19
116,MIA,1,240,34,77,44.2,15,43,34.9,19,34,55.88,29,39,74.4,12,30,42,22,8,5,13,19
117,LAC,0,240,42,85,49.4,8,29,27.6,34,56,60.71,23,27,85.2,8,40,48,21,2,3,10,16
118,SAC,0,265,43,104,41.3,16,43,37.2,27,61,44.26,8,12,66.7,8,39,47,26,8,3,11,37
119,PHX,1,240,45,96,46.9,17,32,53.1,28,64,43.75,10,14,71.4,11,33,44,25,5,0,8,21
120,DAL,1,265,33,90,36.7,9,41,22,24,49,48.98,39,50,78,17,44,61,22,4,2,17,21
121,ORL,0,240,39,82,47.6,12,34,35.3,27,48,56.25,19,23,82.6,11,32,43,21,3,2,18,22
122,HOU,0,240,34,87,39.1,19,53,35.8,15,34,44.12,15,24,62.5,5,34,39,24,7,3,10,26
123,BKN,1,240,43,103,41.7,21,57,36.8,22,46,47.83,12,16,75,7,35,42,30,5,6,7,26
124,BOS,0,240,37,85,43.5,10,33,30.3,27,52,51.92,22,27,81.5,14,31,45,15,7,4,16,26
125,POR,1,240,39,95,41.1,12,31,38.7,27,64,42.19,20,29,69,15,49,64,18,7,5,12,21
126,IND,1,240,46,84,54.8,13,33,39.4,33,51,64.71,15,19,78.9,2,30,32,29,10,3,7,17
127,TOR,1,240,29,67,43.3,16,32,50,13,35,37.14,33,36,91.7,3,36,39,19,6,3,21,19
128,LAL,1,240,41,82,50,9,26,34.6,32,56,57.14,25,31,80.6,4,34,38,23,12,3,14,24
129,OKC,0,265,37,87,42.5,15,36,41.7,22,51,43.14,24,31,77.4,8,34,42,20,4,5,16,32
130,UTA,0,240,37,83,44.6,12,43,27.9,25,40,62.5,22,25,88,7,35,42,25,8,3,21,29
131,IND,1,240,44,92,47.8,7,26,26.9,37,66,56.06,16,16,100,9,36,45,20,6,11,10,15
132,MEM,0,240,37,93,39.8,12,43,27.9,25,50,50,13,15,86.7,8,35,43,25,3,10,14,32
133,PHI,1,240,46,87,52.9,14,31,45.2,32,56,57.14,26,30,86.7,8,27,35,26,6,6,13,25
134,DEN,1,265,42,87,48.3,7,25,28,35,62,56.45,30,39,76.9,9,37,46,23,10,3,13,29
135,MIA,0,240,37,87,42.5,14,45,31.1,23,42,54.76,15,16,93.8,8,33,41,29,9,8,15,24
136,NOP,1,240,37,82,45.1,11,29,37.9,26,53,49.06,24,39,61.5,8,41,49,25,7,1,15,20
137,SAS,0,240,46,93,49.5,12,26,46.2,34,67,50.75,26,29,89.7,13,31,44,21,7,6,14,23
138,WAS,0,240,41,94,43.6,11,30,36.7,30,64,46.88,7,13,53.8,9,36,45,30,6,7,13,19
139,WAS,0,240,40,88,45.5,9,31,29,31,57,54.39,21,27,77.8,10,36,46,26,6,6,13,31
140,BOS,1,240,42,77,54.5,18,30,60,24,47,51.06,26,34,76.5,6,30,36,24,9,6,14,21
141,BKN,1,240,38,90,42.2,11,33,33.3,27,57,47.37,31,37,83.8,13,35,48,23,5,4,11,24
142,PHX,1,240,42,93,45.2,12,33,36.4,30,60,50,21,23,91.3,6,43,49,22,5,4,11,29
143,SAC,0,240,45,91,49.5,8,28,28.6,37,63,58.73,18,22,81.8,9,30,39,30,10,0,15,28
144,SAS,1,240,36,86,41.9,12,29,41.4,24,57,42.11,24,33,72.7,12,37,49,22,5,6,17,20
145,MIL,0,240,45,92,48.9,9,35,25.7,36,57,63.16,17,23,73.9,17,48,65,21,6,6,23,23
146,MEM,0,240,42,91,46.2,7,30,23.3,35,61,57.38,15,18,83.3,3,36,39,27,5,3,12,27
147,POR,0,240,45,90,50,19,42,45.2,26,48,54.17,15,16,93.8,9,26,35,31,8,5,12,25
148,HOU,1,240,36,91,39.6,21,61,34.4,15,30,50,27,31,87.1,6,30,36,22,15,3,9,24
149,ORL,1,240,43,82,52.4,18,38,47.4,25,44,56.82,28,35,80,12,34,46,31,10,4,18,25
150,DAL,0,240,38,93,40.9,6,31,19.4,32,62,51.61,33,37,89.2,10,39,49,22,8,5,8,22
151,DEN,0,240,39,89,43.8,8,35,22.9,31,54,57.41,19,24,79.2,13,25,38,28,7,2,19,32
152,MIA,1,240,40,72,55.6,13,29,44.8,27,43,62.79,32,37,86.5,6,32,38,29,7,2,16,28
153,PHI,0,240,46,93,49.5,9,25,36,37,68,54.41,20,25,80,20,35,55,20,6,5,21,30
154,LAC,1,240,37,87,42.5,25,47,53.2,12,40,30,27,35,77.1,8,40,48,23,10,2,10,28
155,NOP,0,240,38,85,44.7,9,30,30,29,55,52.73,18,28,64.3,9,39,48,24,4,1,18,23
156,TOR,1,240,35,84,41.7,14,34,41.2,21,50,42,23,26,88.5,7,44,51,24,7,5,18,28
157,UTA,0,240,34,87,39.1,8,31,25.8,26,56,46.43,18,22,81.8,12,23,35,17,11,4,16,21
158,IND,1,240,48,95,50.5,14,34,41.2,34,61,55.74,17,23,73.9,10,24,34,31,8,5,10,25
159,LAL,0,240,29,82,35.4,10,40,25,19,42,45.24,24,33,72.7,8,32,40,17,8,12,18,25
160,OKC,1,240,41,77,53.2,10,26,38.5,31,51,60.78,18,24,75,11,36,47,19,9,8,22,21
161,SAC,0,240,46,95,48.4,12,38,31.6,34,57,59.65,16,20,80,8,34,42,22,11,2,18,25
162,HOU,1,265,52,101,51.5,19,48,39.6,33,53,62.26,30,39,76.9,7,36,43,26,12,10,9,31
163,MIL,1,240,39,84,46.4,13,41,31.7,26,43,60.47,28,34,82.4,7,40,47,25,9,7,15,26
164,WAS,0,240,42,91,46.2,8,22,36.4,34,69,49.28,20,23,87,8,28,36,18,7,2,18,26
165,MEM,0,265,42,93,45.2,13,41,31.7,29,52,55.77,38,50,76,10,29,39,25,9,5,13,26
166,BKN,0,240,44,91,48.4,13,42,31,31,49,63.27,17,23,73.9,10,29,39,30,4,2,14,25
167,DAL,0,265,50,105,47.6,21,49,42.9,29,56,51.79,28,38,73.7,13,42,55,30,7,4,20,36
168,POR,1,265,49,91,53.8,13,30,43.3,36,61,59.02,29,34,85.3,9,33,42,27,10,9,17,36
169,ORL,1,240,46,87,52.9,11,31,35.5,35,56,62.5,25,28,89.3,6,36,42,31,8,3,14,23
170,SAS,1,240,48,90,53.3,11,25,44,37,65,56.92,22,27,81.5,9,33,42,32,6,4,15,17
171,PHX,1,240,42,80,52.5,11,32,34.4,31,48,64.58,30,32,93.8,4,33,37,29,10,3,18,24
172,BOS,0,240,37,91,40.7,11,37,29.7,26,54,48.15,27,34,79.4,14,34,48,18,8,5,16,28
173,LAC,0,240,32,74,43.2,16,36,44.4,16,38,42.11,21,28,75,4,32,36,17,6,5,22,30
174,NOP,0,240,40,94,42.6,11,31,35.5,29,63,46.03,13,18,72.2,15,30,45,22,12,2,21,25
175,LAL,1,240,32,82,39,11,36,30.6,21,46,45.65,28,37,75.7,11,34,45,21,6,3,16,27
176,UTA,1,240,37,84,44,8,34,23.5,29,50,58,24,28,85.7,12,31,43,17,11,6,20,23
177,ATL,0,265,48,106,45.3,14,41,34.1,34,65,52.31,21,26,80.8,15,38,53,26,6,3,17,25
178,CHA,1,240,37,82,45.1,17,34,50,20,48,41.67,18,22,81.8,15,35,50,20,7,4,14,9
179,PHI,1,240,42,83,50.6,14,33,42.4,28,50,56,26,32,81.3,13,37,50,28,7,4,14,18
180,NYK,1,265,50,94,53.2,11,28,39.3,39,66,59.09,25,34,73.5,6,41,47,32,14,9,12,23
181,DEN,0,240,39,83,47,14,39,35.9,25,44,56.82,5,8,62.5,3,37,40,23,6,4,16,20
182,DET,0,240,39,84,46.4,11,35,31.4,28,49,57.14,17,25,68,6,26,32,25,10,3,9,24
183,MIA,0,240,39,84,46.4,15,44,34.1,24,40,60,5,6,83.3,9,27,36,32,8,5,14,17
184,DAL,1,240,42,92,45.7,12,35,34.3,30,57,52.63,17,23,73.9,13,39,52,23,9,2,11,14
185,NYK,0,240,42,81,51.9,8,21,38.1,34,60,56.67,23,31,74.2,8,28,36,30,10,3,19,29
186,HOU,1,240,41,80,51.3,15,38,39.5,26,42,61.9,20,26,76.9,5,28,33,24,9,5,18,20
187,DAL,0,240,42,92,45.7,17,44,38.6,25,48,52.08,8,11,72.7,7,35,42,23,8,3,14,19
188,ORL,1,240,43,92,46.7,14,33,42.4,29,59,49.15,20,22,90.9,12,29,41,31,10,3,16,26
189,IND,0,240,46,93,49.5,9,24,37.5,37,69,53.62,10,11,90.9,10,33,43,23,5,8,12,20
190,GSW,0,240,37,79,46.8,11,38,28.9,26,41,63.41,22,27,81.5,4,31,35,25,3,0,10,17
191,CHI,1,240,42,84,50,12,34,35.3,30,50,60,12,15,80,14,32,46,23,8,6,21,21
192,BOS,1,240,41,93,44.1,13,37,35.1,28,56,50,19,22,86.4,11,35,46,19,9,4,10,15
193,PHX,0,240,35,87,40.2,11,32,34.4,24,55,43.64,24,25,96,9,34,43,26,3,5,14,16
194,SAS,1,240,46,89,51.7,15,32,46.9,31,57,54.39,12,15,80,6,34,40,32,11,10,12,15
195,WAS,1,240,35,74,47.3,14,35,40,21,39,53.85,38,45,84.4,9,28,37,23,8,4,19,25
196,LAL,0,240,40,87,46,15,40,37.5,25,47,53.19,7,12,58.3,8,38,46,24,7,4,15,22
197,LAC,1,240,46,92,50,20,44,45.5,26,48,54.17,19,19,100,11,36,47,28,5,2,11,19
198,BKN,1,240,37,90,41.1,13,40,32.5,24,50,48,17,23,73.9,14,33,47,24,7,3,11,18
199,CLE,0,240,40,80,50,6,24,25,34,56,60.71,17,23,73.9,9,26,35,29,9,5,18,15
200,MIN,0,240,40,83,48.2,14,35,40,26,48,54.17,17,23,73.9,8,33,41,21,9,0,19,20
201,MEM,0,240,38,76,50,11,29,37.9,27,47,57.45,28,38,73.7,7,32,39,24,7,5,21,22
202,POR,1,240,45,89,50.6,17,35,48.6,28,54,51.85,14,17,82.4,9,37,46,20,9,9,11,17
203,CHA,0,290,49,104,47.1,19,48,39.6,30,56,53.57,21,23,91.3,8,27,35,31,9,6,5,22
204,UTA,0,240,33,83,39.8,16,43,37.2,17,40,42.5,10,14,71.4,6,28,34,24,12,4,11,20
205,ATL,1,290,53,96,55.2,21,43,48.8,32,53,60.38,16,27,59.3,12,41,53,33,1,5,16,26
206,TOR,1,240,36,83,43.4,13,36,36.1,23,47,48.94,16,18,88.9,14,39,53,22,9,2,20,14
207,DEN,1,240,41,94,43.6,16,41,39,25,53,47.17,11,12,91.7,6,42,48,28,11,8,14,20
208,MIL,0,240,34,90,37.8,15,50,30,19,40,47.5,12,18,66.7,11,37,48,23,8,4,17,15
209,CLE,1,265,43,94,45.7,13,34,38.2,30,60,50,33,45,73.3,14,46,60,26,4,4,18,24
210,NYK,1,240,36,82,43.9,6,19,31.6,30,63,47.62,18,25,72,13,38,51,15,10,5,12,16
211,LAL,1,240,39,87,44.8,10,35,28.6,29,52,55.77,24,28,85.7,9,36,45,22,8,7,14,28
212,DET,0,240,29,80,36.3,11,38,28.9,18,42,42.86,15,22,68.2,5,30,35,21,8,2,13,19
213,TOR,1,240,39,82,47.6,19,48,39.6,20,34,58.82,21,27,77.8,2,34,36,27,10,3,9,22
214,MIA,1,240,32,66,48.5,13,28,46.4,19,38,50,23,28,82.1,5,41,46,21,7,8,23,25
215,IND,1,240,46,88,52.3,8,23,34.8,38,65,58.46,12,18,66.7,6,41,47,23,5,6,11,23
216,NOP,1,240,44,90,48.9,11,35,31.4,33,55,60,21,31,67.7,10,44,54,28,7,5,25,23
217,MIN,0,240,37,94,39.4,8,33,24.2,29,61,47.54,25,31,80.6,9,33,42,20,15,3,17,23
218,BKN,1,240,32,64,50,11,30,36.7,21,34,61.76,35,41,85.4,5,45,50,21,4,5,29,24
219,LAC,0,240,34,86,39.5,7,31,22.6,27,55,49.09,28,37,75.7,15,34,49,12,5,5,16,26
220,ORL,1,240,44,91,48.4,13,29,44.8,31,62,50,25,31,80.6,13,36,49,21,11,4,15,17
221,SAC,0,240,42,90,46.7,8,31,25.8,34,59,57.63,21,23,91.3,10,40,50,24,5,7,11,22
222,DAL,0,240,39,91,42.9,14,43,32.6,25,48,52.08,17,25,68,9,33,42,19,7,5,11,17
223,MIL,0,240,51,95,53.7,13,33,39.4,38,62,61.29,16,21,76.2,7,29,36,23,7,3,10,29
224,SAS,0,265,43,98,43.9,10,26,38.5,33,72,45.83,33,36,91.7,6,38,44,20,15,6,9,34
225,CHI,0,240,39,92,42.4,12,34,35.3,27,58,46.55,17,25,68,5,26,31,23,14,3,7,31
226,OKC,1,240,35,79,44.3,10,25,40,25,54,46.3,25,34,73.5,4,35,39,16,9,7,18,22
227,HOU,0,240,39,88,44.3,9,32,28.1,30,56,53.57,19,25,76,11,27,38,21,10,7,18,23
228,BOS,0,240,38,92,41.3,13,37,35.1,25,55,45.45,15,19,78.9,11,35,46,22,9,5,13,25
229,WAS,0,240,26,78,33.3,19,47,40.4,7,31,22.58,18,21,85.7,4,25,29,19,11,2,14,26
230,PHX,1,240,47,85,55.3,19,43,44.2,28,42,66.67,27,31,87.1,8,39,47,30,6,4,15,23
231,ATL,0,240,32,95,33.7,13,49,26.5,19,46,41.3,24,28,85.7,14,32,46,23,9,2,14,24
232,PHI,0,240,41,84,48.8,13,34,38.2,28,50,56,19,22,86.4,11,30,41,29,3,2,11,21
233,HOU,0,240,35,76,46.1,15,45,33.3,20,31,64.52,14,20,70,13,29,42,22,9,3,21,25
234,DEN,0,240,43,85,50.6,13,32,40.6,30,53,56.6,3,8,37.5,9,24,33,28,15,0,18,19
235,UTA,1,240,40,77,51.9,10,33,30.3,30,44,68.18,21,28,75,9,31,40,17,10,4,10,19
236,MEM,1,240,43,87,49.4,12,33,36.4,31,54,57.41,20,33,60.6,15,43,58,27,9,6,17,18
237,CLE,1,240,42,76,55.3,12,28,42.9,30,48,62.5,8,12,66.7,8,31,39,32,8,2,22,17
238,CHA,1,240,37,70,52.9,15,32,46.9,22,38,57.89,19,25,76,6,24,30,29,7,1,17,15
239,POR,0,240,42,89,47.2,10,39,25.6,32,50,64,17,26,65.4,10,31,41,22,9,3,11,16
240,SAC,1,240,41,85,48.2,21,39,53.8,20,46,43.48,20,23,87,11,36,47,30,9,3,15,23
241,GSW,1,240,44,80,55,9,25,36,35,55,63.64,21,28,75,7,28,35,30,4,2,7,19
242,DET,0,240,40,86,46.5,9,30,30,31,56,55.36,16,22,72.7,10,28,38,24,4,2,11,23
243,ORL,1,240,51,84,60.7,7,21,33.3,44,63,69.84,23,31,74.2,6,39,45,31,5,5,11,18
244,NOP,1,240,38,91,41.8,14,38,36.8,24,53,45.28,20,28,71.4,15,38,53,28,7,6,17,25
245,IND,1,240,38,75,50.7,8,22,36.4,30,53,56.6,24,33,72.7,10,36,46,24,9,8,22,16
246,MEM,0,240,39,84,46.4,9,30,30,30,54,55.56,9,13,69.2,9,38,47,29,7,4,19,15
247,SAS,0,240,43,92,46.7,10,34,29.4,33,58,56.9,24,27,88.9,2,36,38,25,3,5,6,20
248,MIL,0,240,37,89,41.6,12,43,27.9,25,46,54.35,17,23,73.9,5,40,45,22,8,1,20,32
249,LAL,1,240,38,91,41.8,6,32,18.8,32,59,54.24,31,38,81.6,10,42,52,19,11,4,16,27
250,WAS,1,240,36,76,47.4,15,31,48.4,21,45,46.67,31,35,88.6,9,29,38,24,9,4,18,19
251,BOS,0,240,35,94,37.2,10,36,27.8,25,58,43.1,14,18,77.8,13,32,45,19,6,6,13,13
252,MIN,0,240,46,98,46.9,10,37,27,36,61,59.02,16,20,80,10,26,36,30,6,3,8,21
253,POR,0,240,43,87,49.4,13,32,40.6,30,55,54.55,18,24,75,9,30,39,26,6,6,16,19
254,UTA,1,240,36,80,45,17,45,37.8,19,35,54.29,10,12,83.3,8,32,40,23,8,7,18,19
255,DAL,1,240,45,95,47.4,18,47,38.3,27,48,56.25,13,17,76.5,13,35,48,30,11,9,11,11
256,BKN,1,240,51,96,53.1,15,36,41.7,36,60,60,22,31,71,9,43,52,32,1,2,8,22
257,MIA,0,240,37,86,43,9,33,27.3,28,53,52.83,21,31,67.7,10,35,45,27,11,9,16,23
258,OKC,1,240,47,96,49,12,31,38.7,35,65,53.85,20,25,80,10,28,38,26,8,6,4,18
259,NYK,0,240,41,91,45.1,4,24,16.7,37,67,55.22,17,22,77.3,13,35,48,19,4,8,12,20
260,PHX,1,240,45,91,49.5,19,42,45.2,26,49,53.06,18,19,94.7,15,32,47,29,9,4,13,22
261,CHI,0,240,40,97,41.2,9,38,23.7,31,59,52.54,13,15,86.7,17,28,45,27,12,6,17,25
262,ATL,0,240,46,86,53.5,12,32,37.5,34,54,62.96,8,12,66.7,6,30,36,25,9,4,18,25
263,HOU,0,240,35,97,36.1,7,42,16.7,28,55,50.91,28,36,77.8,15,36,51,19,6,5,11,25
264,TOR,1,240,40,84,47.6,13,41,31.7,27,43,62.79,28,31,90.3,3,36,39,28,10,3,12,24
265,DEN,1,240,44,83,53,8,26,30.8,36,57,63.16,18,20,90,13,25,38,29,7,5,13,21
266,GSW,0,240,40,98,40.8,14,52,26.9,26,46,56.52,19,25,76,14,38,52,34,4,5,16,23
267,LAC,1,240,39,84,46.4,13,40,32.5,26,44,59.09,29,39,74.4,9,48,57,22,5,6,16,25
268,CHA,0,240,38,77,49.4,13,33,39.4,25,44,56.82,23,28,82.1,9,25,34,24,7,2,14,23
269,SAC,0,240,42,79,53.2,11,29,37.9,31,50,62,13,18,72.2,4,33,37,23,7,4,18,21
270,PHI,1,240,47,96,49,17,37,45.9,30,59,50.85,14,17,82.4,14,31,45,24,8,2,13,18
271,BKN,0,240,30,90,33.3,7,42,16.7,23,48,47.92,12,17,70.6,13,29,42,15,6,4,14,17
272,OKC,1,240,46,75,61.3,10,24,41.7,36,51,70.59,12,17,70.6,2,31,33,25,13,8,16,18
273,CLE,0,240,39,89,43.8,13,38,34.2,26,51,50.98,15,20,75,17,33,50,24,6,2,13,19
274,UTA,1,240,41,81,50.6,10,36,27.8,31,45,68.89,20,25,80,6,31,37,26,5,5,14,20
275,NYK,0,240,41,85,48.2,7,20,35,34,65,52.31,15,18,83.3,11,31,42,23,3,1,13,18
276,DET,0,240,40,86,46.5,18,43,41.9,22,43,51.16,9,15,60,9,27,36,27,8,5,17,21
277,ORL,0,240,44,84,52.4,13,30,43.3,31,54,57.41,12,14,85.7,5,30,35,28,6,5,12,17
278,IND,0,240,42,97,43.3,7,27,25.9,35,70,50,9,11,81.8,7,32,39,22,12,2,16,18
279,CHI,0,240,45,94,47.9,11,30,36.7,34,64,53.12,7,11,63.6,9,31,40,24,10,5,10,19
280,MIA,1,240,41,79,51.9,22,44,50,19,35,54.29,12,15,80,6,30,36,31,8,5,14,17
281,POR,1,240,42,81,51.9,13,31,41.9,29,50,58,28,32,87.5,7,40,47,24,7,11,16,24
282,MIN,1,240,40,81,49.4,19,43,44.2,21,38,55.26,16,25,64,10,33,43,27,5,4,18,15
283,WAS,0,240,40,103,38.8,11,35,31.4,29,68,42.65,13,21,61.9,18,30,48,27,8,4,10,29
284,DAL,1,265,44,95,46.3,22,50,44,22,45,48.89,17,24,70.8,6,43,49,30,6,13,17,17
285,MEM,1,240,43,100,43,20,44,45.5,23,56,41.07,12,14,85.7,18,41,59,21,8,5,12,15
286,BOS,1,240,40,86,46.5,11,30,36.7,29,56,51.79,21,26,80.8,13,36,49,16,10,7,11,20
287,MIL,1,240,43,94,45.7,13,46,28.3,30,48,62.5,20,22,90.9,11,45,56,26,8,4,18,14
288,NOP,0,265,50,114,43.9,17,46,37,33,68,48.53,6,11,54.5,15,37,52,28,8,4,14,23
289,GSW,1,240,42,82,51.2,18,41,43.9,24,41,58.54,14,22,63.6,5,30,35,31,8,3,11,23
290,DEN,0,240,39,87,44.8,3,20,15,36,67,53.73,19,26,73.1,19,34,53,22,6,5,16,26
291,MIN,1,240,54,97,55.7,14,34,41.2,40,63,63.49,17,20,85,10,32,42,31,11,2,16,22
292,TOR,1,240,40,86,46.5,14,34,41.2,26,52,50,29,35,82.9,9,38,47,17,9,5,15,25
293,WAS,0,240,41,80,51.3,16,38,42.1,25,42,59.52,28,34,82.4,2,29,31,28,10,5,14,22
294,PHX,0,240,39,85,45.9,15,39,38.5,24,46,52.17,21,25,84,6,29,35,30,6,6,18,22
295,LAL,1,240,46,86,53.5,13,33,39.4,33,53,62.26,15,18,83.3,10,33,43,25,9,6,13,18
296,NOP,0,240,52,100,52,14,39,35.9,38,61,62.3,16,27,59.3,13,31,44,37,13,2,15,18
297,SAS,1,240,38,80,47.5,11,32,34.4,27,48,56.25,17,20,85,6,27,33,25,12,5,10,16
298,PHI,0,240,38,85,44.7,16,40,40,22,45,48.89,15,20,75,12,30,42,24,10,1,15,17
299,OKC,0,240,34,81,42,9,28,32.1,25,53,47.17,17,26,65.4,8,35,43,16,7,7,15,22
300,BOS,0,265,44,103,42.7,15,49,30.6,29,54,53.7,17,23,73.9,13,29,42,24,10,6,15,30
301,LAC,1,240,38,84,45.2,11,36,30.6,27,48,56.25,22,26,84.6,6,35,41,19,7,1,10,22
302,CHA,0,240,39,82,47.6,12,29,41.4,27,53,50.94,13,18,72.2,14,32,46,25,4,2,17,16
303,BKN,1,265,43,100,43,14,49,28.6,29,51,56.86,29,38,76.3,22,41,63,22,7,6,21,26
304,SAC,1,240,50,89,56.2,13,29,44.8,37,60,61.67,20,24,83.3,8,34,42,23,13,2,15,24
305,ATL,0,240,32,99,32.3,9,35,25.7,23,64,35.94,15,16,93.8,16,27,43,20,6,8,17,21
306,MEM,1,240,46,92,50,14,32,43.8,32,60,53.33,21,31,67.7,14,46,60,30,12,8,15,16
307,HOU,0,240,39,94,41.5,20,56,35.7,19,38,50,25,27,92.6,8,26,34,25,11,5,12,20
308,CLE,0,240,42,91,46.2,17,41,41.5,25,50,50,12,18,66.7,11,25,36,28,10,1,7,18
309,DAL,0,240,40,84,47.6,12,42,28.6,28,42,66.67,15,20,75,9,35,44,26,9,5,18,20
310,MIA,1,240,37,86,43,18,37,48.6,19,49,38.78,13,18,72.2,6,40,46,28,4,4,10,19
311,IND,1,240,39,78,50,15,31,48.4,24,47,51.06,23,26,88.5,6,34,40,22,9,5,13,20
312,NYK,1,240,47,97,48.5,12,30,40,35,67,52.24,19,30,63.3,20,45,65,26,6,7,19,19
313,MIL,0,240,35,86,40.7,7,34,20.6,28,52,53.85,12,19,63.2,8,40,48,19,4,5,15,18
314,SAS,0,240,40,77,51.9,16,32,50,24,45,53.33,15,19,78.9,3,30,33,21,6,5,15,19
315,ORL,0,240,37,96,38.5,14,43,32.6,23,53,43.4,19,22,86.4,11,28,39,29,3,2,6,11
316,UTA,1,240,47,83,56.6,20,41,48.8,27,42,64.29,12,14,85.7,8,39,47,30,3,7,15,17
317,CHI,1,240,44,94,46.8,10,36,27.8,34,58,58.62,11,17,64.7,12,30,42,24,7,5,14,21
318,POR,1,240,49,88,55.7,16,33,48.5,33,55,60,16,16,100,6,43,49,27,6,4,12,24
319,MIN,0,240,36,99,36.4,13,42,31,23,57,40.35,6,15,40,14,43,57,19,9,3,14,17
320,DET,0,240,33,80,41.3,18,42,42.9,15,38,39.47,16,24,66.7,7,35,42,23,6,4,16,25
321,DAL,1,240,44,94,46.8,11,40,27.5,33,54,61.11,12,19,63.2,6,50,56,28,10,7,14,16
322,PHI,0,240,48,95,50.5,21,43,48.8,27,52,51.92,13,20,65,10,27,37,27,7,4,10,28
323,GSW,0,240,42,89,47.2,9,28,32.1,33,61,54.1,17,24,70.8,18,34,52,25,7,7,22,24
324,NOP,0,240,40,95,42.1,7,32,21.9,33,63,52.38,27,33,81.8,15,37,52,24,7,3,16,11
325,CHA,0,240,34,96,35.4,8,35,22.9,26,61,42.62,9,10,90,12,35,47,22,7,8,10,18
326,SAC,1,240,37,91,40.7,9,35,25.7,28,56,50,23,26,88.5,17,34,51,18,8,7,11,20
327,LAL,1,240,50,97,51.5,13,35,37.1,37,62,59.68,9,10,90,6,30,36,23,9,10,13,26
328,TOR,0,240,41,89,46.1,10,38,26.3,31,51,60.78,26,29,89.7,8,28,36,24,9,4,12,24
329,LAC,1,240,45,76,59.2,13,24,54.2,32,52,61.54,33,41,80.5,6,31,37,25,6,6,11,17
330,WAS,1,240,40,82,48.8,20,30,66.7,20,52,38.46,24,27,88.9,5,29,34,24,10,5,13,20
331,MIL,1,240,35,87,40.2,7,31,22.6,28,56,50,16,21,76.2,15,46,61,20,7,6,17,11
332,DEN,1,240,47,83,56.6,18,36,50,29,47,61.7,21,30,70,7,34,41,38,6,1,16,22
333,ATL,1,240,46,84,54.8,18,42,42.9,28,42,66.67,19,22,86.4,5,31,36,34,7,5,19,18
334,PHX,0,240,34,83,41,12,29,41.4,22,54,40.74,19,23,82.6,8,32,40,24,3,5,20,25
335,POR,0,240,47,94,50,8,28,28.6,39,66,59.09,15,21,71.4,13,29,42,14,9,4,17,26
336,GSW,1,240,41,87,47.1,9,30,30,32,57,56.14,24,32,75,13,36,49,30,9,6,10,21
337,CLE,0,240,41,85,48.2,5,22,22.7,36,63,57.14,17,20,85,6,30,36,30,9,3,16,13
338,MIA,1,240,41,91,45.1,14,38,36.8,27,53,50.94,20,24,83.3,10,35,45,27,4,4,7,21
339,BOS,0,265,39,100,39,13,42,31,26,58,44.83,19,25,76,14,40,54,22,11,6,14,18
340,ORL,0,240,41,84,48.8,15,37,40.5,26,47,55.32,16,23,69.6,10,31,41,28,9,5,19,16
341,CHI,0,240,41,89,46.1,17,35,48.6,24,54,44.44,16,23,69.6,13,20,33,26,12,3,8,22
342,IND,1,240,47,87,54,8,23,34.8,39,64,60.94,11,14,78.6,8,30,38,30,10,6,13,20
343,HOU,1,265,41,98,41.8,15,55,27.3,26,43,60.47,14,18,77.8,12,41,53,17,10,8,16,20
344,SAS,1,240,44,84,52.4,14,31,45.2,30,53,56.6,12,16,75,4,27,31,28,11,5,17,20
345,NYK,1,240,47,85,55.3,8,20,40,39,65,60,23,33,69.7,17,33,50,29,6,4,17,19
346,MEM,1,240,43,95,45.3,10,31,32.3,33,64,51.56,9,11,81.8,15,36,51,27,10,4,10,14
347,LAL,0,240,36,87,41.4,9,35,25.7,27,52,51.92,7,12,58.3,13,32,45,26,5,3,16,13
348,BKN,0,240,40,86,46.5,16,44,36.4,24,42,57.14,17,23,73.9,8,36,44,30,3,3,10,23
349,CHA,1,240,34,78,43.6,13,30,43.3,21,48,43.75,18,25,72,11,47,58,23,3,8,18,22
350,UTA,1,240,44,89,49.4,19,37,51.4,25,52,48.08,22,30,73.3,15,39,54,23,7,5,15,22
351,DEN,0,240,41,91,45.1,9,25,36,32,66,48.48,12,16,75,13,26,39,19,7,6,15,18
352,NOP,1,240,48,88,54.5,9,23,39.1,39,65,60,11,15,73.3,12,37,49,36,12,8,17,17
353,DET,1,240,44,90,48.9,13,32,40.6,31,58,53.45,12,16,75,10,21,31,27,14,3,10,19
354,ATL,1,240,50,97,51.5,19,39,48.7,31,58,53.45,22,30,73.3,15,37,52,32,8,4,10,15
355,DAL,0,240,40,84,47.6,21,50,42,19,34,55.88,17,19,89.5,4,31,35,25,0,3,11,25
356,LAC,1,240,48,89,53.9,18,39,46.2,30,50,60,18,20,90,11,35,46,35,6,5,12,19
357,MEM,0,240,39,91,42.9,8,30,26.7,31,61,50.82,15,20,75,10,42,52,27,7,5,14,16
358,WAS,0,240,45,98,45.9,14,37,37.8,31,61,50.82,15,21,71.4,13,28,41,23,12,4,11,20
359,ORL,1,240,53,98,54.1,12,40,30,41,58,70.69,18,22,81.8,10,44,54,36,6,7,16,20
360,TOR,0,240,33,95,34.7,10,43,23.3,23,52,44.23,20,29,69,14,31,45,19,11,3,5,25
361,OKC,0,240,33,91,36.3,6,35,17.1,27,56,48.21,14,20,70,5,31,36,14,8,3,14,15
362,MIL,1,240,50,100,50,21,45,46.7,29,55,52.73,12,14,85.7,14,52,66,34,6,2,17,21
363,MIN,0,240,46,95,48.4,17,44,38.6,29,51,56.86,16,24,66.7,6,27,33,27,10,6,15,20
364,SAC,1,240,38,91,41.8,11,38,28.9,27,53,50.94,17,21,81,8,39,47,24,11,3,9,16
365,MIA,1,240,41,79,51.9,17,35,48.6,24,44,54.55,27,36,75,6,34,40,30,6,2,11,21
366,BKN,0,240,42,92,45.7,18,46,39.1,24,46,52.17,16,21,76.2,7,31,38,30,5,8,13,19
367,CLE,0,240,43,95,45.3,11,31,35.5,32,64,50,7,12,58.3,10,24,34,27,7,2,14,13
368,PHX,0,240,45,75,60,9,23,39.1,36,52,69.23,12,17,70.6,5,33,38,31,9,5,18,14
369,POR,0,240,41,89,46.1,9,30,30,32,59,54.24,9,14,64.3,10,35,45,14,5,5,14,21
370,LAL,1,240,45,88,51.1,8,24,33.3,37,64,57.81,18,27,66.7,8,36,44,24,13,5,17,17
371,NYK,0,240,42,83,50.6,8,23,34.8,34,60,56.67,14,24,58.3,9,30,39,28,2,3,8,11
372,SAC,0,240,41,91,45.1,12,35,34.3,29,56,51.79,14,14,100,12,33,45,30,6,2,15,33
373,IND,1,240,40,90,44.4,8,25,32,32,65,49.23,18,23,78.3,13,35,48,21,8,4,14,12
374,PHI,1,240,45,91,49.5,15,31,48.4,30,60,50,10,13,76.9,11,33,44,32,5,7,6,17
375,GSW,0,240,34,80,42.5,9,32,28.1,25,48,52.08,9,10,90,5,32,37,27,7,3,27,27
376,OKC,1,240,41,84,48.8,9,26,34.6,32,58,55.17,21,29,72.4,10,27,37,20,6,4,11,20
377,PHI,0,240,36,89,40.4,13,38,34.2,23,51,45.1,9,14,64.3,8,23,31,22,13,9,9,11
378,CLE,1,240,41,78,52.6,11,24,45.8,30,54,55.56,15,17,88.2,9,39,48,24,5,4,19,16
379,MIA,0,240,41,78,52.6,11,26,42.3,30,52,57.69,33,43,76.7,8,35,43,30,9,8,22,21
380,NYK,0,240,43,85,50.6,4,15,26.7,39,70,55.71,11,17,64.7,13,29,42,22,5,6,15,24
381,ORL,1,240,49,100,49,14,32,43.8,35,68,51.47,18,25,72,13,39,52,30,7,9,9,21
382,HOU,1,240,52,93,55.9,23,50,46,29,43,67.44,13,15,86.7,9,35,44,22,8,7,19,25
383,CHA,1,240,39,83,47,10,30,33.3,29,53,54.72,19,25,76,10,27,37,25,7,4,14,19
384,SAS,0,240,39,92,42.4,11,33,33.3,28,59,47.46,14,19,73.7,13,42,55,22,8,7,16,21
385,DAL,1,240,36,86,41.9,17,45,37.8,19,41,46.34,20,30,66.7,5,38,43,25,11,9,16,20
386,BKN,0,240,36,87,41.4,10,36,27.8,26,51,50.98,24,35,68.6,15,41,56,15,7,1,18,24
387,ATL,0,240,42,94,44.7,13,36,36.1,29,58,50,23,25,92,9,33,42,30,5,5,9,22
388,UTA,0,240,40,89,44.9,12,40,30,28,49,57.14,11,15,73.3,13,28,41,16,5,3,10,16
389,BOS,1,240,45,84,53.6,11,26,42.3,34,58,58.62,13,16,81.3,9,35,44,21,7,4,9,17
390,WAS,1,240,41,96,42.7,15,39,38.5,26,57,45.61,13,16,81.3,9,30,39,22,9,2,11,26
391,MIN,1,240,47,91,51.6,17,46,37,30,45,66.67,18,25,72,5,28,33,28,16,8,16,35
392,LAC,1,240,37,84,44,14,38,36.8,23,46,50,14,15,93.3,11,35,46,22,11,2,16,22
393,MEM,0,240,43,108,39.8,13,39,33.3,30,69,43.48,13,21,61.9,22,27,49,28,9,3,16,16
394,PHX,0,240,34,87,39.1,9,34,26.5,25,53,47.17,15,18,83.3,14,34,48,29,8,3,16,17
395,CHI,0,240,52,97,53.6,12,31,38.7,40,66,60.61,6,9,66.7,13,26,39,22,6,4,11,25
396,MIL,1,240,32,84,38.1,14,42,33.3,18,42,42.86,30,36,83.3,8,45,53,23,10,10,14,19
397,OKC,1,240,42,76,55.3,14,30,46.7,28,46,60.87,26,35,74.3,7,30,37,25,8,7,12,17
398,GSW,0,240,35,79,44.3,4,28,14.3,31,51,60.78,20,24,83.3,5,29,34,21,7,2,17,25
399,LAL,1,240,45,102,44.1,13,44,29.5,32,58,55.17,15,21,71.4,14,37,51,27,10,12,16,20
400,BOS,1,240,43,90,47.8,19,39,48.7,24,51,47.06,13,14,92.9,8,37,45,19,6,3,14,19
401,DEN,1,240,44,76,57.9,9,19,47.4,35,57,61.4,18,22,81.8,9,32,41,33,12,3,18,20
402,SAC,1,240,40,76,52.6,13,30,43.3,27,46,58.7,19,34,55.9,2,38,40,25,7,4,10,23
403,IND,1,240,49,86,57,10,23,43.5,39,63,61.9,11,13,84.6,7,49,56,35,8,11,15,17
404,DET,0,240,33,81,40.7,15,41,36.6,18,40,45,17,21,81,12,21,33,24,8,2,16,26
405,NOP,0,240,39,86,45.3,8,27,29.6,31,59,52.54,23,30,76.7,6,39,45,31,10,2,20,24
406,POR,0,240,38,85,44.7,13,31,41.9,25,54,46.3,17,23,73.9,8,33,41,24,8,4,17,15
407,TOR,0,240,32,91,35.2,18,52,34.6,14,39,35.9,15,21,71.4,9,34,43,21,4,5,17,26
408,CHA,0,240,31,93,33.3,10,33,30.3,21,60,35,8,18,44.4,13,26,39,22,10,1,11,13
409,DAL,1,240,51,101,50.5,16,44,36.4,35,57,61.4,21,28,75,14,40,54,28,7,3,13,28
410,PHX,1,240,49,87,56.3,12,20,60,37,67,55.22,21,24,87.5,11,27,38,33,10,1,15,31
411,MEM,0,240,37,89,41.6,7,27,25.9,30,62,48.39,16,22,72.7,11,34,45,20,6,7,13,18
412,BKN,0,240,46,96,47.9,16,37,43.2,30,59,50.85,5,8,62.5,13,36,49,29,6,3,12,19
413,PHI,1,240,45,88,51.1,12,30,40,33,58,56.9,27,30,90,9,39,48,27,9,5,12,22
414,CLE,1,265,43,97,44.3,14,37,37.8,29,60,48.33,25,34,73.5,13,40,53,25,8,6,12,20
415,MIN,0,240,42,95,44.2,15,42,35.7,27,53,50.94,24,34,70.6,7,35,42,16,4,6,12,22
416,WAS,0,265,47,98,48,15,35,42.9,32,63,50.79,25,33,75.8,6,35,41,27,8,0,17,27
417,NYK,0,240,40,91,44,11,29,37.9,29,62,46.77,21,30,70,16,38,54,20,12,8,17,21
418,UTA,0,240,32,68,47.1,10,26,38.5,22,42,52.38,37,43,86,5,25,30,16,8,2,20,23
419,ATL,0,240,40,97,41.2,8,38,21.1,32,59,54.24,24,27,88.9,14,30,44,19,5,2,13,26
420,MIL,1,265,49,86,57,17,37,45.9,32,49,65.31,22,27,81.5,4,41,45,26,7,4,21,28
421,HOU,1,240,43,86,50,16,48,33.3,27,38,71.05,21,31,67.7,5,33,38,20,11,7,13,22
422,MIA,0,265,44,96,45.8,16,42,38.1,28,54,51.85,15,20,75,9,40,49,33,6,11,15,22
423,LAC,1,240,47,94,50,16,37,43.2,31,57,54.39,14,17,82.4,11,39,50,33,7,5,12,20
424,ORL,1,240,44,89,49.4,13,34,38.2,31,55,56.36,14,17,82.4,7,34,41,27,6,9,10,11
425,OKC,1,240,50,87,57.5,10,22,45.5,40,65,61.54,21,24,87.5,6,48,54,28,7,7,13,17
426,MIN,0,240,40,90,44.4,14,40,35,26,50,52,22,29,75.9,9,29,38,26,7,2,15,16
427,DET,0,240,37,86,43,11,35,31.4,26,51,50.98,19,20,95,11,33,44,18,7,5,11,17
428,LAL,1,240,39,86,45.3,11,34,32.4,28,52,53.85,25,37,67.6,11,35,46,20,9,4,13,22
429,POR,1,240,41,84,48.8,13,30,43.3,28,54,51.85,12,19,63.2,9,32,41,20,6,5,10,18
430,SAS,0,240,38,103,36.9,11,38,28.9,27,65,41.54,16,19,84.2,14,29,43,27,5,1,9,23
431,NOP,1,240,46,98,46.9,17,42,40.5,29,56,51.79,6,13,46.2,14,38,52,34,7,5,13,15
432,BOS,0,240,38,83,45.8,13,34,38.2,25,49,51.02,23,30,76.7,8,36,44,20,7,3,17,29
433,TOR,1,240,47,92,51.1,17,44,38.6,30,48,62.5,16,18,88.9,10,47,57,32,9,10,17,21
434,IND,0,240,31,95,32.6,8,33,24.2,23,62,37.1,11,17,64.7,12,27,39,23,13,4,18,20
435,DEN,1,240,53,90,58.9,11,30,36.7,42,60,70,11,17,64.7,5,33,38,29,9,7,14,24
436,GSW,0,240,40,92,43.5,11,35,31.4,29,57,50.88,10,15,66.7,11,37,48,28,9,7,15,16
437,CHI,1,240,45,81,55.6,18,37,48.6,27,44,61.36,18,28,64.3,10,27,37,27,15,4,29,28
438,WAS,0,240,37,73,50.7,12,30,40,25,43,58.14,31,36,86.1,7,27,34,24,15,3,24,27
439,BKN,1,240,42,87,48.3,17,47,36.2,25,40,62.5,14,19,73.7,9,45,54,26,10,6,10,20
440,MIL,1,240,48,91,52.7,14,41,34.1,34,50,68,9,13,69.2,8,49,57,35,2,6,17,16
441,CHI,0,240,36,83,43.4,14,38,36.8,22,45,48.89,18,21,85.7,11,27,38,18,11,7,26,29
442,MIA,1,240,45,79,57,19,40,47.5,26,39,66.67,15,20,75,4,25,29,34,16,4,16,20
443,CLE,0,240,38,79,48.1,13,36,36.1,25,43,58.14,16,22,72.7,11,29,40,29,8,2,25,18
444,SAC,1,240,40,89,44.9,12,31,38.7,28,58,48.28,20,26,76.9,11,37,48,25,11,4,13,24
445,UTA,0,240,42,90,46.7,7,31,22.6,35,59,59.32,19,24,79.2,6,40,46,18,1,2,13,14
446,PHI,0,240,35,99,35.4,13,38,34.2,22,61,36.07,15,18,83.3,11,32,43,17,10,4,12,17
447,PHX,1,240,38,86,44.2,10,30,33.3,28,56,50,26,31,83.9,17,30,47,26,10,4,21,23
448,ATL,1,240,43,98,43.9,8,37,21.6,35,61,57.38,17,26,65.4,13,40,53,27,9,4,10,21
449,CHA,0,240,31,88,35.2,12,35,34.3,19,53,35.85,12,21,57.1,9,36,45,22,5,2,13,16
450,LAC,0,240,34,87,39.1,10,30,33.3,24,57,42.11,25,29,86.2,13,34,47,20,7,3,19,22
451,HOU,1,240,45,92,48.9,20,48,41.7,25,44,56.82,10,14,71.4,6,36,42,20,9,5,10,25
452,DAL,0,240,40,89,44.9,14,44,31.8,26,45,57.78,13,19,68.4,10,38,48,23,5,10,16,22
453,NOP,1,240,45,84,53.6,18,34,52.9,27,50,54,20,33,60.6,9,37,46,36,8,3,19,23
454,BOS,1,240,44,95,46.3,10,29,34.5,34,66,51.52,29,37,78.4,16,42,58,21,5,6,11,26
455,UTA,0,240,35,82,42.7,12,33,36.4,23,49,46.94,22,26,84.6,6,41,47,25,4,6,17,18
456,WAS,0,240,41,106,38.7,9,37,24.3,32,69,46.38,17,23,73.9,17,30,47,24,12,3,12,26
457,MEM,0,240,42,92,45.7,5,15,33.3,37,77,48.05,16,31,51.6,16,34,50,22,9,1,17,27
458,ORL,0,240,41,104,39.4,9,43,20.9,32,61,52.46,15,19,78.9,16,32,48,21,11,2,8,22
459,MIN,0,240,36,89,40.4,15,42,35.7,21,47,44.68,30,35,85.7,8,35,43,23,8,10,10,27
460,OKC,1,240,40,87,46,9,26,34.6,31,61,50.82,24,27,88.9,14,30,44,19,12,3,12,19
461,POR,0,240,43,94,45.7,10,27,37,33,67,49.25,19,25,76,13,33,46,20,7,9,14,22
462,SAS,1,240,40,91,44,10,20,50,30,71,42.25,23,26,88.5,7,41,48,22,12,7,7,20
463,PHX,0,240,38,92,41.3,6,34,17.6,32,58,55.17,19,23,82.6,10,24,34,29,12,3,17,23
464,LAL,1,240,41,86,47.7,9,29,31,32,57,56.14,26,40,65,12,37,49,25,9,14,15,24
465,CLE,1,240,43,81,53.1,11,27,40.7,32,54,59.26,16,25,64,10,37,47,19,3,6,22,24
466,NYK,0,240,35,81,43.2,11,25,44,24,56,42.86,17,25,68,5,35,40,21,7,7,15,26
467,DEN,0,240,37,77,48.1,6,27,22.2,31,50,62,21,23,91.3,8,31,39,19,7,3,19,20
468,IND,1,240,36,88,40.9,8,28,28.6,28,60,46.67,26,33,78.8,12,38,50,20,7,5,11,22
469,DAL,1,240,43,84,51.2,15,38,39.5,28,46,60.87,21,26,80.8,8,42,50,26,6,7,16,14
470,TOR,1,240,42,80,52.5,14,37,37.8,28,43,65.12,20,22,90.9,7,41,48,24,7,13,25,20
471,CHI,0,240,37,87,42.5,7,31,22.6,30,56,53.57,12,19,63.2,12,26,38,24,12,3,14,23
472,MEM,0,240,43,85,50.6,12,30,40,31,55,56.36,27,32,84.4,11,40,51,25,5,5,20,29
473,ATL,1,240,41,85,48.2,16,35,45.7,25,50,50,31,35,88.6,6,35,41,22,8,6,16,27
474,MIA,0,240,40,98,40.8,11,37,29.7,29,61,47.54,33,38,86.8,15,36,51,28,9,7,15,31
475,DET,0,240,40,83,48.2,13,37,35.1,27,46,58.7,13,16,81.3,7,39,46,25,3,5,22,23
476,MIL,1,240,47,93,50.5,10,33,30.3,37,60,61.67,22,27,81.5,8,33,41,24,14,3,8,15
477,PHI,1,265,38,86,44.2,4,22,18.2,34,64,53.12,32,35,91.4,11,37,48,19,10,6,14,22
478,CHA,1,240,35,74,47.3,8,28,28.6,27,46,58.7,25,29,86.2,9,35,44,22,9,4,18,16
479,GSW,0,240,44,89,49.4,7,33,21.2,37,56,66.07,10,12,83.3,13,27,40,26,11,7,23,16
480,SAC,1,240,42,83,50.6,19,39,48.7,23,44,52.27,26,36,72.2,3,24,27,22,9,2,10,21
481,BKN,0,265,36,102,35.3,10,34,29.4,26,68,38.24,22,28,78.6,15,34,49,22,3,1,16,27
482,HOU,1,240,45,85,52.9,25,49,51,20,36,55.56,20,22,90.9,8,28,36,31,14,7,16,15
483,LAC,0,290,46,110,41.8,11,35,31.4,35,75,46.67,30,37,81.1,14,41,55,19,4,10,16,31
484,BOS,1,290,45,103,43.7,18,43,41.9,27,60,45,33,40,82.5,7,44,51,22,9,6,15,28
485,NOP,0,240,42,86,48.8,14,35,40,28,51,54.9,20,27,74.1,8,38,46,31,3,7,17,20
486,OKC,1,240,46,92,50,13,27,48.1,33,65,50.77,18,22,81.8,5,35,40,28,11,5,9,21
487,ORL,1,265,44,96,45.8,12,36,33.3,32,60,53.33,16,18,88.9,9,37,46,34,13,7,13,16
488,DET,0,265,40,92,43.5,18,45,40,22,47,46.81,14,15,93.3,9,38,47,28,5,7,21,20
489,UTA,1,240,41,85,48.2,14,36,38.9,27,49,55.1,20,23,87,10,43,53,23,6,3,15,16
490,TOR,0,240,34,90,37.8,13,43,30.2,21,47,44.68,10,13,76.9,6,36,42,21,6,4,13,20
491,MIA,0,240,38,88,43.2,13,39,33.3,25,49,51.02,12,16,75,6,31,37,19,11,4,11,22
492,SAC,0,240,41,99,41.4,12,39,30.8,29,60,48.33,17,22,77.3,10,30,40,26,7,2,5,16
493,MEM,1,240,45,95,47.4,6,23,26.1,39,72,54.17,15,22,68.2,15,42,57,26,8,9,12,18
494,WAS,1,240,40,84,47.6,10,28,35.7,30,56,53.57,24,33,72.7,6,34,40,25,13,7,14,21
495,POR,0,240,36,97,37.1,13,37,35.1,23,60,38.33,19,24,79.2,16,35,51,21,7,3,11,16
496,IND,1,240,45,86,52.3,9,27,33.3,36,59,61.02,19,24,79.2,8,36,44,28,10,3,16,21
497,CLE,1,240,48,94,51.1,10,28,35.7,38,66,57.58,21,25,84,17,38,55,25,8,6,17,22
498,DAL,1,240,48,85,56.5,17,40,42.5,31,45,68.89,17,21,81,3,44,47,34,1,7,12,18
499,DEN,0,265,44,88,50,11,25,44,33,63,52.38,17,22,77.3,3,39,42,32,9,2,12,26
500,CHA,1,240,43,92,46.7,14,34,41.2,29,58,50,15,23,65.2,12,40,52,22,7,4,14,16
501,ATL,0,240,36,84,42.9,13,34,38.2,23,50,46,20,25,80,9,29,38,24,11,5,17,26
502,BKN,1,240,36,88,40.9,9,35,25.7,27,53,50.94,20,25,80,12,43,55,27,7,5,17,16
503,GSW,0,240,39,77,50.6,11,31,35.5,28,46,60.87,17,19,89.5,4,34,38,27,8,7,22,20
504,MIL,0,240,37,91,40.7,13,37,35.1,24,54,44.44,24,25,96,11,33,44,18,7,5,18,21
505,LAL,1,265,47,93,50.5,12,33,36.4,35,60,58.33,14,27,51.9,10,39,49,29,8,4,12,22
506,MIN,0,240,39,101,38.6,14,49,28.6,25,52,48.08,16,20,80,14,34,48,25,10,7,11,19
507,PHX,1,240,42,91,46.2,14,37,37.8,28,54,51.85,14,15,93.3,8,32,40,25,14,4,14,21
508,NYK,0,240,36,88,40.9,3,23,13,33,65,50.77,21,29,72.4,14,38,52,19,10,3,22,27
509,PHI,1,240,44,95,46.3,8,27,29.6,36,68,52.94,14,21,66.7,11,39,50,25,3,7,8,11
510,BOS,0,240,37,85,43.5,11,32,34.4,26,53,49.06,20,25,80,10,38,48,24,11,4,18,26
511,SAS,1,240,41,84,48.8,7,25,28,34,59,57.63,25,27,92.6,7,39,46,20,9,7,12,19
512,POR,0,240,44,93,47.3,7,29,24.1,37,64,57.81,22,28,78.6,12,28,40,21,5,3,15,26
513,LAC,0,240,40,90,44.4,14,31,45.2,26,59,44.07,9,13,69.2,5,37,42,25,2,6,9,19
514,NOP,1,240,49,92,53.3,14,34,41.2,35,58,60.34,26,32,81.3,14,36,50,40,7,5,14,20
515,HOU,1,240,33,77,42.9,13,45,28.9,20,32,62.5,37,42,88.1,5,40,45,17,9,6,14,21
516,WAS,1,240,48,89,53.9,11,32,34.4,37,57,64.91,19,24,79.2,9,35,44,28,11,6,17,16
517,OKC,0,240,39,85,45.9,11,31,35.5,28,54,51.85,17,21,81,6,29,35,19,8,2,14,24
518,CHI,0,240,44,92,47.8,16,39,41,28,53,52.83,10,14,71.4,10,34,44,25,9,4,22,22
519,CHA,1,240,33,88,37.5,9,36,25,24,52,46.15,12,14,85.7,13,32,45,19,10,3,12,15
520,GSW,0,240,30,77,39,11,34,32.4,19,43,44.19,30,34,88.2,6,34,40,23,8,2,16,21
521,IND,0,240,45,92,48.9,7,30,23.3,38,62,61.29,8,11,72.7,6,34,40,28,7,3,6,21
522,MIL,1,240,43,96,44.8,18,42,42.9,25,54,46.3,19,23,82.6,8,47,55,26,7,5,13,18
523,DEN,1,240,45,80,56.3,18,35,51.4,27,45,60,19,23,82.6,9,28,37,34,7,5,11,16
524,PHX,0,240,32,76,42.1,11,31,35.5,21,45,46.67,25,31,80.6,3,26,29,26,7,2,13,19
525,BKN,1,240,35,87,40.2,12,37,32.4,23,50,46,24,32,75,14,39,53,20,5,7,10,15
526,LAL,1,240,47,91,51.6,14,37,37.8,33,54,61.11,17,25,68,16,43,59,28,8,4,16,22
527,TOR,1,240,51,89,57.3,17,33,51.5,34,56,60.71,18,23,78.3,9,32,41,29,15,4,20,26
528,DAL,0,240,39,83,47,15,43,34.9,24,40,60,26,31,83.9,4,22,26,24,8,3,7,18
529,MIA,1,240,43,87,49.4,12,33,36.4,31,54,57.41,15,21,71.4,7,38,45,36,10,3,12,19
530,ORL,1,240,50,95,52.6,18,38,47.4,32,57,56.14,17,22,77.3,14,31,45,33,9,5,11,14
531,ATL,0,240,47,88,53.4,16,37,43.2,31,51,60.78,16,17,94.1,4,27,31,33,5,5,12,18
532,MIN,0,240,39,86,45.3,18,40,45,21,46,45.65,30,35,85.7,10,28,38,24,6,4,23,19
533,SAC,0,240,42,101,41.6,14,43,32.6,28,58,48.28,13,18,72.2,10,39,49,23,6,5,13,22
534,UTA,1,240,46,78,59,15,35,42.9,31,43,72.09,16,21,76.2,10,35,45,27,5,2,21,29
535,SAS,0,240,41,85,48.2,16,32,50,25,53,47.17,22,25,88,9,27,36,33,7,1,10,17
536,DET,0,240,29,82,35.4,7,35,20,22,47,46.81,11,13,84.6,19,33,52,21,4,5,21,18
537,BOS,1,240,38,84,45.2,16,36,44.4,22,48,45.83,20,27,74.1,14,39,53,19,6,2,9,24
538,NYK,0,290,52,110,47.3,13,34,38.2,39,76,51.32,18,25,72,15,41,56,30,12,6,18,29
539,OKC,0,240,39,86,45.3,11,27,40.7,28,59,47.46,22,29,75.9,12,32,44,14,3,3,10,21
540,POR,1,240,40,85,47.1,19,42,45.2,21,43,48.84,16,22,72.7,5,38,43,20,9,6,14,22
541,ATL,1,290,49,108,45.4,14,40,35,35,68,51.47,28,31,90.3,11,39,50,29,9,8,15,24
542,MIA,0,240,39,98,39.8,20,49,40.8,19,49,38.78,11,14,78.6,13,36,49,31,6,5,13,22
543,CLE,0,240,35,95,36.8,7,33,21.2,28,62,45.16,15,22,68.2,16,29,45,22,9,1,16,17
544,WAS,0,240,35,100,35,7,33,21.2,28,67,41.79,22,29,75.9,9,41,50,25,7,4,7,22
545,LAC,1,240,53,93,57,12,36,33.3,41,57,71.93,15,20,75,10,42,52,28,11,6,12,21
546,UTA,1,240,42,86,48.8,15,38,39.5,27,48,56.25,15,18,83.3,10,38,48,25,2,4,16,14
547,MEM,1,240,43,102,42.2,5,32,15.6,38,70,54.29,15,25,60,13,49,62,19,4,4,15,23
548,CHI,0,240,43,88,48.9,12,32,37.5,31,56,55.36,13,17,76.5,14,28,42,23,8,3,18,24
549,PHI,1,240,42,84,50,11,27,40.7,31,57,54.39,23,32,71.9,15,29,44,29,12,6,16,18
550,HOU,0,240,44,95,46.3,15,42,35.7,29,53,54.72,10,14,71.4,7,29,36,20,10,5,8,19
551,GSW,0,240,46,89,51.7,13,32,40.6,33,57,57.89,15,23,65.2,8,25,33,31,15,6,18,27
552,LAC,0,240,41,86,47.7,9,26,34.6,32,60,53.33,24,29,82.8,8,35,43,24,8,5,15,17
553,ORL,0,240,37,98,37.8,10,40,25,27,58,46.55,11,14,78.6,10,36,46,28,10,6,9,15
554,PHX,0,240,38,87,43.7,9,32,28.1,29,55,52.73,23,23,100,11,30,41,25,7,4,14,18
555,DAL,1,240,44,87,50.6,17,35,48.6,27,52,51.92,11,11,100,11,35,46,29,5,6,12,18
556,LAL,1,240,43,82,52.4,14,29,48.3,29,53,54.72,25,34,73.5,12,35,47,29,11,2,24,22
557,CHA,0,240,38,87,43.7,11,36,30.6,27,51,52.94,13,18,72.2,12,27,39,15,5,4,11,13
558,TOR,1,240,45,95,47.4,14,35,40,31,60,51.67,15,21,71.4,13,35,48,22,6,5,7,22
559,DET,0,240,34,69,49.3,13,29,44.8,21,40,52.5,11,16,68.8,3,25,28,21,5,7,16,19
560,SAC,1,240,45,86,52.3,19,35,54.3,26,51,50.98,13,20,65,8,31,39,25,6,2,11,16
561,SAS,0,240,41,81,50.6,7,24,29.2,34,57,59.65,13,18,72.2,8,33,41,23,7,4,15,22
562,NOP,1,240,44,95,46.3,15,38,39.5,29,57,50.88,21,25,84,16,37,53,27,8,2,15,24
563,IND,0,240,44,83,53,9,26,34.6,35,57,61.4,20,27,74.1,2,35,37,25,5,9,14,25
564,DEN,1,240,45,82,54.9,11,28,39.3,34,54,62.96,16,21,76.2,8,32,40,23,7,7,14,22
565,MIL,1,240,42,93,45.2,15,39,38.5,27,54,50,12,16,75,10,52,62,26,4,5,16,11
566,NYK,1,240,38,85,44.7,8,22,36.4,30,63,47.62,11,17,64.7,16,31,47,24,5,6,15,21
567,BKN,0,240,41,92,44.6,16,44,36.4,25,48,52.08,20,24,83.3,13,33,46,27,5,5,9,16
568,MIN,1,240,52,95,54.7,26,44,59.1,26,51,50.98,12,18,66.7,9,37,46,39,8,3,13,21
569,MIA,0,240,34,77,44.2,12,40,30,22,37,59.46,17,25,68,7,35,42,21,7,5,20,16
570,BOS,1,240,37,86,43,16,37,43.2,21,49,42.86,22,27,81.5,11,36,47,23,5,8,13,18
571,MEM,0,240,38,93,40.9,5,21,23.8,33,72,45.83,26,31,83.9,9,31,40,25,13,6,14,15
572,UTA,1,240,45,91,49.5,10,30,33.3,35,61,57.38,17,24,70.8,13,43,56,21,6,2,15,19
573,IND,0,240,39,86,45.3,10,34,29.4,29,52,55.77,18,22,81.8,11,36,47,26,5,5,20,18
574,SAC,1,240,40,82,48.8,19,44,43.2,21,38,55.26,6,12,50,6,30,36,29,8,3,14,24
575,PHX,1,240,43,77,55.8,15,31,48.4,28,46,60.87,26,27,96.3,10,41,51,29,10,9,23,15
576,POR,0,240,44,97,45.4,17,40,42.5,27,57,47.37,9,14,64.3,10,33,43,14,9,4,9,18
577,WAS,1,240,45,90,50,19,38,50,26,52,50,10,13,76.9,8,31,39,28,8,4,13,19
578,PHI,1,240,48,90,53.3,14,25,56,34,65,52.31,9,15,60,10,40,50,34,8,11,21,25
579,DET,0,240,38,89,42.7,11,38,28.9,27,51,52.94,14,19,73.7,14,23,37,19,7,1,11,23
580,OKC,1,240,39,76,51.3,5,23,21.7,34,53,64.15,25,30,83.3,9,33,42,21,4,6,12,23
581,ATL,0,240,35,86,40.7,13,39,33.3,22,47,46.81,24,26,92.3,12,34,46,21,7,8,14,21
582,TOR,1,240,42,88,47.7,17,38,44.7,25,50,50,14,17,82.4,8,31,39,28,12,3,16,22
583,HOU,0,240,29,85,34.1,11,48,22.9,18,37,48.65,22,26,84.6,8,21,29,16,8,5,16,21
584,DAL,0,240,42,91,46.2,16,40,40,26,51,50.98,18,21,85.7,15,34,49,27,7,2,14,21
585,NOP,1,240,49,87,56.3,16,38,42.1,33,49,67.35,11,19,57.9,9,36,45,38,12,7,21,20
586,NYK,1,240,43,92,46.7,6,20,30,37,72,51.39,13,19,68.4,10,29,39,27,12,5,14,23
587,ORL,0,240,34,75,45.3,9,31,29,25,44,56.82,26,30,86.7,7,32,39,22,8,9,21,20
588,POR,1,240,49,92,53.3,18,37,48.6,31,55,56.36,9,12,75,9,41,50,28,2,6,12,19
589,LAL,0,240,45,91,49.5,9,31,29,36,60,60,12,16,75,6,32,38,33,10,4,16,18
590,PHI,0,240,37,99,37.4,19,45,42.2,18,54,33.33,8,14,57.1,11,39,50,24,7,4,11,14
591,SAS,0,240,41,92,44.6,10,28,35.7,31,64,48.44,25,28,89.3,8,31,39,25,9,3,4,10
592,CHI,0,240,46,93,49.5,13,29,44.8,33,64,51.56,14,23,60.9,11,29,40,25,11,1,16,16
593,HOU,1,240,43,85,50.6,19,42,45.2,24,43,55.81,16,18,88.9,6,31,37,20,8,4,16,22
594,MIL,1,240,44,94,46.8,12,37,32.4,32,57,56.14,12,18,66.7,9,51,60,19,3,8,14,18
595,LAC,1,240,45,89,50.6,24,54,44.4,21,35,60,14,19,73.7,8,43,51,35,6,5,14,21
596,OKC,1,240,38,81,46.9,9,26,34.6,29,55,52.73,24,30,80,5,35,40,21,9,6,12,15
597,PHX,0,240,42,77,54.5,12,26,46.2,30,51,58.82,12,15,80,7,30,37,29,4,5,16,21
598,MEM,1,240,47,89,52.8,12,25,48,35,64,54.69,15,20,75,10,42,52,27,6,4,11,24
599,DEN,1,240,39,90,43.3,7,30,23.3,32,60,53.33,13,18,72.2,13,39,52,23,8,5,11,17
600,GSW,0,240,35,96,36.5,5,39,12.8,30,57,52.63,13,18,72.2,7,27,34,20,6,7,7,14
601,DAL,0,240,34,94,36.2,17,43,39.5,17,51,33.33,22,24,91.7,12,30,42,19,5,6,9,18
602,MIA,0,240,40,93,43,16,42,38.1,24,51,47.06,15,21,71.4,10,36,46,29,7,2,9,16
603,ORL,0,240,32,75,42.7,13,31,41.9,19,44,43.18,23,30,76.7,9,30,39,20,10,6,17,13
604,ATL,1,240,43,82,52.4,13,32,40.6,30,50,60,28,30,93.3,7,37,44,23,7,4,21,22
605,BKN,1,240,51,100,51,14,34,41.2,37,66,56.06,13,15,86.7,14,51,65,29,4,1,15,15
606,TOR,1,240,43,86,50,12,32,37.5,31,54,57.41,21,24,87.5,7,30,37,27,12,0,10,17
607,UTA,0,240,36,86,41.9,14,39,35.9,22,47,46.81,9,14,64.3,7,39,46,20,5,1,14,16
608,IND,0,240,43,82,52.4,19,39,48.7,24,43,55.81,13,16,81.3,8,34,42,29,6,5,19,18
609,BOS,1,240,46,86,53.5,13,23,56.5,33,63,52.38,11,16,68.8,6,35,41,23,10,6,13,19
610,CLE,0,240,41,89,46.1,15,38,39.5,26,51,50.98,6,11,54.5,9,36,45,31,4,2,20,24
611,DET,1,240,46,95,48.4,12,28,42.9,34,67,50.75,12,16,75,14,28,42,31,9,2,9,15
612,MIN,0,240,45,91,49.5,9,35,25.7,36,56,64.29,21,28,75,6,27,33,18,13,7,17,21
613,HOU,1,240,43,97,44.3,20,60,33.3,23,37,62.16,19,23,82.6,7,34,41,25,11,5,5,19
614,DEN,1,240,46,90,51.1,17,34,50,29,56,51.79,18,25,72,12,38,50,30,5,7,14,22
615,POR,0,240,36,91,39.6,9,31,29,27,60,45,18,22,81.8,9,27,36,16,5,6,9,22
616,SAS,0,240,40,91,44,13,27,48.1,27,64,42.19,9,15,60,7,21,28,21,6,2,6,16
617,NOP,0,240,38,99,38.4,14,49,28.6,24,50,48,18,24,75,8,41,49,26,10,6,17,17
618,MIL,1,240,48,102,47.1,11,36,30.6,37,66,56.06,13,17,76.5,8,45,53,34,11,7,17,19
619,LAL,1,240,50,85,58.8,12,28,42.9,38,57,66.67,17,25,68,12,46,58,28,5,4,14,15
620,CHA,0,240,39,83,47,13,33,39.4,26,50,52,19,24,79.2,12,41,53,22,2,2,17,18
621,DAL,1,240,36,86,41.9,18,45,40,18,41,43.9,22,23,95.7,12,39,51,20,3,2,12,15
622,GSW,1,240,43,87,49.4,15,30,50,28,57,49.12,24,31,77.4,12,32,44,31,8,6,14,25
623,MEM,1,240,42,90,46.7,2,17,11.8,40,73,54.79,10,12,83.3,7,40,47,27,6,12,11,18
624,IND,0,240,44,96,45.8,7,34,20.6,37,62,59.68,8,11,72.7,8,32,40,28,7,6,4,18
625,CHA,0,240,41,89,46.1,9,31,29,32,58,55.17,9,14,64.3,15,31,46,24,8,2,12,16
626,BOS,1,240,48,90,53.3,12,29,41.4,36,61,59.02,15,17,88.2,11,33,44,21,10,5,15,22
627,MIA,1,240,48,85,56.5,16,32,50,32,53,60.38,25,30,83.3,6,29,35,27,8,1,3,18
628,CLE,0,265,52,92,56.5,18,35,51.4,34,57,59.65,12,18,66.7,5,29,34,34,6,3,15,18
629,PHI,0,240,36,83,43.4,13,38,34.2,23,45,51.11,21,25,84,14,30,44,24,3,1,14,21
630,NYK,1,265,57,102,55.9,10,26,38.5,47,76,61.84,15,21,71.4,12,34,46,33,11,1,12,18
631,ORL,1,240,43,80,53.8,16,34,47.1,27,46,58.7,10,17,58.8,8,29,37,35,7,3,10,12
632,SAC,1,240,38,75,50.7,14,27,51.9,24,48,50,23,31,74.2,7,27,34,26,7,7,17,20
633,BKN,1,240,43,89,48.3,15,34,44.1,28,55,50.91,18,21,85.7,10,34,44,28,8,5,17,26
634,DET,0,240,34,98,34.7,8,26,30.8,26,72,36.11,6,9,66.7,16,35,51,21,6,2,16,13
635,SAS,0,240,40,95,42.1,12,37,32.4,28,58,48.28,13,16,81.3,6,40,46,21,5,9,8,20
636,PHX,0,240,39,90,43.3,6,17,35.3,33,73,45.21,13,18,72.2,14,29,43,23,7,6,16,21
637,ATL,0,240,42,84,50,12,30,40,30,54,55.56,19,21,90.5,6,26,32,22,9,6,17,19
638,WAS,0,240,42,83,50.6,9,22,40.9,33,61,54.1,24,29,82.8,2,33,35,28,6,4,11,24
639,MIN,0,240,37,85,43.5,13,38,34.2,24,47,51.06,22,28,78.6,14,31,45,25,12,6,16,25
640,LAC,1,240,39,84,46.4,11,27,40.7,28,57,49.12,19,24,79.2,5,46,51,28,3,2,12,18
641,CHI,0,240,35,90,38.9,15,48,31.3,20,42,47.62,17,26,65.4,17,24,41,25,10,0,16,21
642,HOU,1,240,41,105,39,16,51,31.4,25,54,46.3,19,22,86.4,11,32,43,22,14,3,8,18
643,PHX,0,240,41,104,39.4,6,23,26.1,35,81,43.21,20,23,87,15,34,49,20,8,3,10,24
644,MIL,1,240,48,97,49.5,15,38,39.5,33,59,55.93,18,27,66.7,16,44,60,30,4,12,17,25
645,DEN,0,265,48,96,50,10,32,31.3,38,64,59.38,17,22,77.3,14,33,47,30,7,7,10,19
646,TOR,1,240,47,84,56,16,34,47.1,31,50,62,19,23,82.6,12,34,46,28,6,5,15,18
647,NOP,0,240,42,94,44.7,10,33,30.3,32,61,52.46,15,20,75,16,47,63,21,6,6,23,16
648,DET,1,265,48,94,51.1,14,31,45.2,34,63,53.97,18,24,75,11,32,43,33,4,2,12,22
649,IND,0,240,32,76,42.1,8,24,33.3,24,52,46.15,13,21,61.9,4,30,34,21,4,1,11,20
650,MIA,1,240,33,77,42.9,15,33,45.5,18,44,40.91,21,26,80.8,10,38,48,24,6,8,13,16
651,PHI,0,240,31,84,36.9,7,33,21.2,24,51,47.06,26,31,83.9,13,34,47,15,6,3,14,27
652,ATL,0,240,37,91,40.7,10,33,30.3,27,58,46.55,16,21,76.2,10,40,50,19,6,4,11,15
653,SAC,0,240,39,91,42.9,14,44,31.8,25,47,53.19,21,26,80.8,13,31,44,21,5,4,16,24
654,LAL,1,240,44,86,51.2,19,43,44.2,25,43,58.14,22,27,81.5,11,35,46,33,10,5,15,22
655,CHA,0,240,35,83,42.2,10,36,27.8,25,47,53.19,10,12,83.3,6,31,37,29,5,7,17,18
656,BOS,1,240,38,80,47.5,8,30,26.7,30,50,60,32,41,78,9,33,42,15,9,2,11,20
657,BKN,0,240,39,94,41.5,16,47,34,23,47,48.94,13,21,61.9,12,41,53,25,5,7,16,22
658,NYK,1,240,34,82,41.5,7,26,26.9,27,56,48.21,17,23,73.9,14,43,57,19,5,1,13,20
659,CLE,0,240,41,95,43.2,16,44,36.4,25,51,49.02,14,14,100,13,33,46,26,8,3,16,15
660,WAS,1,240,44,100,44,9,32,28.1,35,68,51.47,16,26,61.5,18,33,51,21,9,8,10,20
661,ORL,0,240,33,83,39.8,9,33,27.3,24,50,48,14,17,82.4,7,32,39,21,5,5,10,19
662,GSW,1,240,48,90,53.3,18,35,51.4,30,55,54.55,17,19,89.5,10,34,44,39,11,10,11,16
663,LAC,1,240,45,98,45.9,12,34,35.3,33,64,51.56,16,18,88.9,12,38,50,20,8,7,13,30
664,UTA,0,240,40,94,42.6,18,41,43.9,22,53,41.51,9,9,100,11,26,37,19,6,4,10,17
665,MIN,0,240,34,84,40.5,7,39,17.9,27,45,60,31,37,83.8,6,38,44,24,9,4,17,20
666,POR,1,240,47,92,51.1,15,29,51.7,32,63,50.79,15,18,83.3,14,37,51,20,4,5,12,19
667,SAS,1,240,45,87,51.7,10,28,35.7,35,59,59.32,14,21,66.7,7,37,44,27,13,2,12,14
668,DAL,1,240,44,94,46.8,20,39,51.3,24,55,43.64,15,16,93.8,10,43,53,26,6,8,9,14
669,LAL,0,240,45,96,46.9,11,32,34.4,34,64,53.12,18,28,64.3,19,43,62,28,2,10,19,21
670,TOR,1,240,44,85,51.8,9,27,33.3,35,58,60.34,8,11,72.7,7,35,42,26,6,7,16,27
671,HOU,1,240,45,98,45.9,21,45,46.7,24,53,45.28,17,20,85,7,30,37,25,11,5,7,20
672,MEM,0,240,45,96,46.9,6,31,19.4,39,65,60,15,26,57.7,11,23,34,17,10,8,11,21
673,MIL,0,240,43,95,45.3,12,40,30,31,55,56.36,17,26,65.4,7,39,46,29,7,5,13,14
674,DEN,1,240,48,100,48,22,46,47.8,26,54,48.15,9,9,100,7,43,50,29,8,10,13,19
675,CHI,0,240,42,86,48.8,12,34,35.3,30,52,57.69,22,26,84.6,11,27,38,27,7,3,14,21
676,DET,0,240,28,79,35.4,11,36,30.6,17,43,39.53,25,34,73.5,13,32,45,18,5,6,17,12
677,NOP,1,240,51,95,53.7,15,34,44.1,36,61,59.02,22,26,84.6,16,41,57,30,8,4,19,22
678,BKN,1,240,50,80,62.5,15,31,48.4,35,49,71.43,18,25,72,5,32,37,31,8,5,20,21
679,OKC,1,240,42,97,43.3,7,31,22.6,35,66,53.03,20,22,90.9,15,26,41,26,13,4,14,24
680,DAL,0,240,43,90,47.8,14,36,38.9,29,54,53.7,21,27,77.8,14,38,52,29,2,9,17,18
681,POR,1,240,49,97,50.5,13,36,36.1,36,61,59.02,16,21,76.2,6,34,40,25,10,8,7,22
682,PHX,0,240,36,76,47.4,9,24,37.5,27,52,51.92,26,29,89.7,11,29,40,20,6,6,20,25
683,SAC,1,240,44,88,50,21,41,51.2,23,47,48.94,15,18,83.3,11,36,47,27,11,8,12,21
684,ATL,1,240,42,87,48.3,11,35,31.4,31,52,59.62,32,37,86.5,10,38,48,29,5,4,16,29
685,PHI,0,240,38,82,46.3,9,31,29,29,51,56.86,32,45,71.1,8,34,42,22,11,2,12,21
686,UTA,0,240,36,78,46.2,17,37,45.9,19,41,46.34,11,17,64.7,5,30,35,24,4,6,16,17
687,LAC,0,240,35,92,38,13,31,41.9,22,61,36.07,20,25,80,11,28,39,26,6,6,15,20
688,CHA,0,240,43,99,43.4,9,30,30,34,69,49.28,12,19,63.2,16,22,38,32,9,4,9,24
689,WAS,1,240,41,86,47.7,14,37,37.8,27,49,55.1,25,27,92.6,19,38,57,24,3,6,20,22
690,TOR,1,240,41,84,48.8,12,32,37.5,29,52,55.77,21,28,75,9,28,37,23,13,3,14,20
691,CLE,0,240,42,90,46.7,13,36,36.1,29,54,53.7,12,14,85.7,15,37,52,23,7,3,23,21
692,DEN,1,240,40,85,47.1,9,27,33.3,31,58,53.45,17,21,81,8,35,43,25,7,5,10,16
693,GSW,0,240,33,77,42.9,12,39,30.8,21,38,55.26,26,30,86.7,3,27,30,24,11,6,17,19
694,BOS,1,240,42,88,47.7,15,35,42.9,27,53,50.94,20,22,90.9,14,37,51,27,12,4,23,24
695,DET,0,240,42,83,50.6,10,26,38.5,32,57,56.14,21,28,75,9,32,41,25,6,5,16,20
696,MEM,1,240,43,86,50,13,28,46.4,30,58,51.72,28,33,84.8,7,37,44,25,7,3,12,22
697,POR,1,240,46,89,51.7,13,36,36.1,33,53,62.26,20,27,74.1,10,40,50,24,8,8,19,20
698,NYK,0,240,39,91,42.9,9,28,32.1,30,63,47.62,19,29,65.5,11,35,46,26,9,6,18,22
699,SAS,1,240,46,82,56.1,8,31,25.8,38,51,74.51,27,30,90,4,31,35,23,5,2,9,27
700,HOU,0,240,40,94,42.6,17,47,36.2,23,47,48.94,15,18,83.3,9,30,39,21,8,5,15,23
701,UTA,0,240,37,84,44,14,38,36.8,23,46,50,32,46,69.6,12,31,43,18,4,0,13,22
702,CHI,0,265,45,85,52.9,6,33,18.2,39,52,75,10,15,66.7,6,28,34,26,10,3,20,17
703,IND,1,265,46,89,51.7,7,27,25.9,39,62,62.9,16,22,72.7,13,33,46,26,8,2,19,14
704,OKC,1,240,44,88,50,15,34,44.1,29,54,53.7,17,20,85,10,35,45,32,9,5,13,17
705,BKN,1,240,43,85,50.6,15,39,38.5,28,46,60.87,24,30,80,8,29,37,26,8,7,10,19
706,SAC,0,240,42,91,46.2,9,39,23.1,33,52,63.46,7,11,63.6,11,28,39,22,6,2,14,22
707,MIA,0,240,33,89,37.1,9,37,24.3,24,52,46.15,26,31,83.9,11,34,45,15,11,2,11,21
708,GSW,0,240,37,87,42.5,15,40,37.5,22,47,46.81,15,21,71.4,6,34,40,29,6,3,14,24
709,NYK,0,240,38,86,44.2,9,32,28.1,29,54,53.7,7,11,63.6,8,34,42,17,5,7,14,26
710,BOS,1,240,39,83,47,13,36,36.1,26,47,55.32,18,24,75,11,37,48,24,5,8,14,22
711,NOP,1,240,47,88,53.4,13,34,38.2,34,54,62.96,18,24,75,7,34,41,29,9,11,18,16
712,DAL,0,240,37,83,44.6,7,33,21.2,30,50,60,23,27,85.2,8,25,33,19,6,0,17,18
713,ATL,0,240,41,92,44.6,12,47,25.5,29,45,64.44,20,25,80,10,34,44,28,10,2,18,23
714,MEM,1,240,46,82,56.1,6,18,33.3,40,64,62.5,6,14,42.9,6,35,41,32,12,11,16,18
715,TOR,1,240,48,97,49.5,13,43,30.2,35,54,64.81,21,27,77.8,10,42,52,26,10,6,13,26
716,PHX,1,240,51,86,59.3,12,28,42.9,39,58,67.24,19,21,90.5,8,31,39,34,10,4,13,25
717,CLE,0,240,42,97,43.3,11,34,32.4,31,63,49.21,16,18,88.9,14,32,46,25,7,2,14,20
718,CHA,1,240,34,88,38.6,8,32,25,26,56,46.43,21,27,77.8,16,35,51,22,5,4,14,14
719,MIL,1,240,50,90,55.6,19,37,51.4,31,53,58.49,32,35,91.4,11,35,46,31,3,3,15,26
720,PHI,1,240,42,82,51.2,11,32,34.4,31,50,62,20,26,76.9,2,42,44,28,5,3,16,18
721,DEN,0,240,32,86,37.2,17,45,37.8,15,41,36.59,15,18,83.3,13,31,44,23,9,4,19,16
722,WAS,0,240,44,94,46.8,14,32,43.8,30,62,48.39,29,34,85.3,11,24,35,28,6,6,11,27
723,ORL,0,240,33,89,37.1,11,37,29.7,22,52,42.31,15,19,78.9,11,30,41,23,7,6,7,13
724,OKC,0,240,34,86,39.5,12,30,40,22,56,39.29,17,19,89.5,6,42,48,23,2,4,10,11
725,SAC,1,265,44,88,50,18,40,45,26,48,54.17,27,34,79.4,9,35,44,27,6,8,16,27
726,DAL,1,240,41,99,41.4,19,51,37.3,22,48,45.83,6,9,66.7,12,44,56,21,3,3,9,16
727,CLE,1,240,48,96,50,9,24,37.5,39,72,54.17,10,13,76.9,11,34,45,25,9,6,14,21
728,SAS,0,240,38,82,46.3,10,25,40,28,57,49.12,23,34,67.6,12,35,47,21,2,6,12,12
729,MIA,1,240,42,79,53.2,14,28,50,28,51,54.9,15,16,93.8,3,38,41,31,2,9,12,18
730,UTA,0,240,43,85,50.6,12,42,28.6,31,43,72.09,19,26,73.1,2,36,38,24,7,3,18,33
731,MIN,0,265,43,89,48.3,23,46,50,20,43,46.51,20,33,60.6,10,35,45,29,7,8,22,27
732,CHI,1,240,42,93,45.2,14,37,37.8,28,56,50,12,15,80,14,36,50,28,8,2,12,23
733,HOU,1,240,38,81,46.9,15,40,37.5,23,41,56.1,35,49,71.4,6,34,40,14,11,4,17,25
734,DET,0,240,38,84,45.2,12,35,34.3,26,49,53.06,12,17,70.6,9,28,37,18,8,7,18,20
735,TOR,1,240,41,99,41.4,16,50,32,25,49,51.02,12,15,80,14,36,50,31,11,2,9,22
736,ORL,0,240,34,95,35.8,7,32,21.9,27,63,42.86,22,32,68.8,16,28,44,27,9,7,7,23
737,POR,1,240,49,90,54.4,20,35,57.1,29,55,52.73,21,25,84,12,31,43,27,1,7,17,21
738,LAC,1,240,37,79,46.8,13,30,43.3,24,49,48.98,25,29,86.2,12,41,53,20,2,7,18,26
739,SAS,0,240,34,82,41.5,16,37,43.2,18,45,40,22,24,91.7,7,41,48,27,5,8,17,15
740,MEM,1,240,44,84,52.4,8,19,42.1,36,65,55.38,18,26,69.2,8,38,46,25,10,8,26,27
741,NOP,1,240,44,92,47.8,16,36,44.4,28,56,50,19,29,65.5,18,36,54,31,7,5,20,21
742,ATL,1,240,54,93,58.1,15,35,42.9,39,58,67.24,29,34,85.3,12,36,48,30,7,3,15,35
743,IND,0,240,48,93,51.6,13,28,46.4,35,65,53.85,20,21,95.2,6,25,31,31,5,2,7,19
744,DEN,1,240,44,93,47.3,11,28,39.3,33,65,50.77,18,20,90,11,31,42,28,10,3,15,23
745,BKN,0,240,34,81,42,13,39,33.3,21,42,50,16,23,69.6,7,27,34,21,6,4,16,14
746,HOU,0,240,40,88,45.5,11,33,33.3,29,55,52.73,19,27,70.4,15,29,44,19,6,7,18,21
747,NYK,1,240,49,92,53.3,6,19,31.6,43,73,58.9,6,13,46.2,14,34,48,19,7,8,15,23
748,PHX,0,240,35,92,38,11,29,37.9,24,63,38.1,28,35,80,12,30,42,23,14,7,18,27
749,WAS,0,240,42,88,47.7,11,33,33.3,31,55,56.36,38,42,90.5,8,26,34,20,5,7,12,26
750,BOS,0,240,41,89,46.1,8,33,24.2,33,56,58.93,18,22,81.8,7,30,37,21,6,5,17,29
751,CHI,1,240,44,85,51.8,12,33,36.4,32,52,61.54,18,24,75,7,29,36,24,15,2,11,16
752,UTA,1,240,40,91,44,15,43,34.9,25,48,52.08,17,22,77.3,12,42,54,22,5,6,13,21
753,OKC,1,240,39,80,48.8,11,24,45.8,28,56,50,24,25,96,3,40,43,20,8,9,14,14
754,MIN,0,240,40,90,44.4,12,43,27.9,28,47,59.57,12,18,66.7,7,34,41,33,9,4,13,21
755,BKN,1,265,42,94,44.7,15,42,35.7,27,52,51.92,22,25,88,11,44,55,19,3,5,11,17
756,DAL,0,240,42,97,43.3,16,41,39,26,56,46.43,7,13,53.8,10,34,44,19,6,3,9,24
757,LAL,0,240,35,76,46.1,6,31,19.4,29,45,64.44,15,23,65.2,6,29,35,23,12,1,22,18
758,PHI,1,240,41,78,52.6,13,37,35.1,28,41,68.29,13,19,68.4,8,33,41,19,12,3,23,18
759,DET,0,265,43,104,41.3,13,35,37.1,30,69,43.48,12,18,66.7,14,38,52,20,5,3,8,25
760,CLE,0,240,42,84,50,13,30,43.3,29,54,53.7,9,11,81.8,11,32,43,30,5,1,21,20
761,ORL,0,240,36,90,40,12,37,32.4,24,53,45.28,14,19,73.7,13,33,46,18,5,1,14,14
762,MIN,0,240,48,98,49,11,32,34.4,37,66,56.06,17,20,85,13,38,51,28,8,8,17,26
763,SAS,0,240,33,78,42.3,5,25,20,28,53,52.83,28,33,84.8,10,33,43,19,9,8,14,22
764,TOR,1,240,41,81,50.6,17,35,48.6,24,46,52.17,19,23,82.6,5,26,31,25,10,6,7,20
765,CHA,0,240,32,86,37.2,14,39,35.9,18,47,38.3,25,30,83.3,8,31,39,24,6,3,13,22
766,PHX,1,240,39,84,46.4,8,29,27.6,31,55,56.36,17,21,81,10,32,42,25,6,4,14,27
767,NYK,0,240,42,85,49.4,13,36,36.1,29,49,59.18,15,21,71.4,14,32,46,26,5,4,16,21
768,SAC,1,240,35,81,43.2,10,32,31.3,25,49,51.02,18,21,85.7,7,35,42,24,8,8,14,20
769,NOP,0,240,38,82,46.3,12,27,44.4,26,55,47.27,18,30,60,12,33,45,24,8,7,17,17
770,MEM,1,240,43,79,54.4,11,22,50,32,57,56.14,28,31,90.3,8,41,49,27,6,4,14,23
771,MIA,0,240,40,93,43,13,44,29.5,27,49,55.1,24,29,82.8,9,36,45,25,4,4,9,19
772,GSW,0,240,40,82,48.8,19,39,48.7,21,43,48.84,19,23,82.6,7,31,38,31,6,3,20,16
773,HOU,1,240,47,91,51.6,11,32,34.4,36,59,61.02,26,31,83.9,5,30,35,24,11,9,11,18
774,MIL,1,240,44,87,50.6,10,36,27.8,34,51,66.67,18,24,75,12,41,53,26,8,8,16,22
775,CHI,0,240,31,79,39.2,8,37,21.6,23,42,54.76,11,14,78.6,8,35,43,23,6,4,21,21
776,DEN,1,240,40,106,37.7,13,41,31.7,27,65,41.54,20,20,100,24,32,56,26,14,6,15,19
777,DET,0,240,39,91,42.9,11,32,34.4,28,59,47.46,23,31,74.2,10,27,37,23,8,1,8,23
778,OKC,1,240,50,86,58.1,14,25,56,36,61,59.02,26,34,76.5,6,39,45,28,6,5,14,20
779,ATL,0,240,42,92,45.7,11,36,30.6,31,56,55.36,16,20,80,10,27,37,24,6,7,11,27
780,IND,1,240,50,87,57.5,17,28,60.7,33,59,55.93,12,13,92.3,5,31,36,35,15,4,12,20
781,LAC,1,240,43,94,45.7,16,35,45.7,27,59,45.76,20,23,87,11,37,48,33,5,3,9,21
782,BOS,1,240,40,86,46.5,14,35,40,26,51,50.98,15,18,83.3,9,35,44,27,10,7,14,20
783,WAS,1,240,47,85,55.3,16,36,44.4,31,49,63.27,14,18,77.8,7,34,41,28,3,3,10,18
784,POR,0,240,46,91,50.5,21,39,53.8,25,52,48.08,12,15,80,11,32,43,20,4,4,15,20
785,BKN,0,240,40,91,44,21,46,45.7,19,45,42.22,12,15,80,8,33,41,30,12,3,16,17
786,LAL,1,240,47,94,50,19,38,50,28,56,50,15,20,75,11,41,52,28,9,6,16,15
787,DAL,1,240,48,93,51.6,22,47,46.8,26,46,56.52,15,24,62.5,12,29,41,27,5,7,9,17
788,CLE,0,240,44,96,45.8,11,33,33.3,33,63,52.38,13,17,76.5,10,26,36,24,7,1,9,21
789,BOS,1,240,45,89,50.6,14,32,43.8,31,57,54.39,15,20,75,9,35,44,32,11,9,11,14
790,IND,1,240,45,84,53.6,9,20,45,36,64,56.25,13,20,65,4,38,42,26,8,8,9,20
791,UTA,1,240,50,93,53.8,17,40,42.5,33,53,62.26,12,23,52.2,15,41,56,31,5,3,11,19
792,DET,1,240,39,73,53.4,12,29,41.4,27,44,61.36,37,44,84.1,3,45,48,19,9,4,17,19
793,WAS,0,265,50,99,50.5,13,42,31,37,57,64.91,16,20,80,7,34,41,30,10,5,11,29
794,OKC,1,240,46,76,60.5,9,19,47.4,37,57,64.91,19,23,82.6,0,36,36,22,10,7,15,17
795,SAC,0,240,42,98,42.9,10,35,28.6,32,63,50.79,12,23,52.2,12,33,45,23,10,1,11,28
796,LAL,1,240,36,82,43.9,9,27,33.3,27,55,49.09,19,28,67.9,11,32,43,18,13,8,10,14
797,MIA,1,265,43,85,50.6,17,33,51.5,26,52,50,31,36,86.1,6,37,43,29,3,6,16,18
798,SAS,1,240,45,89,50.6,11,27,40.7,34,62,54.84,20,25,80,9,35,44,17,7,4,11,23
799,NYK,0,240,36,88,40.9,11,34,32.4,25,54,46.3,9,13,69.2,13,34,47,24,4,4,17,23
800,ORL,0,240,44,92,47.8,14,35,40,30,57,52.63,12,16,75,11,28,39,26,9,3,15,25
801,PHI,0,240,32,84,38.1,18,46,39.1,14,38,36.84,13,18,72.2,8,37,45,25,8,6,13,23
802,DEN,0,240,42,92,45.7,10,28,35.7,32,64,50,11,15,73.3,13,27,40,25,12,6,15,21
803,MIN,0,240,41,86,47.7,15,44,34.1,26,42,61.9,13,24,54.2,10,33,43,27,7,3,18,25
804,GSW,0,240,35,88,39.8,6,23,26.1,29,65,44.62,20,24,83.3,11,26,37,20,5,5,8,23
805,ATL,1,240,36,102,35.3,11,35,31.4,25,67,37.31,19,23,82.6,23,40,63,21,8,3,15,31
806,CHI,1,240,39,84,46.4,9,30,30,30,54,55.56,30,37,81.1,12,38,50,21,9,2,13,22
807,TOR,1,240,40,86,46.5,13,33,39.4,27,53,50.94,14,21,66.7,8,45,53,27,6,2,12,19
808,HOU,1,240,42,89,47.2,13,29,44.8,29,60,48.33,24,28,85.7,18,35,53,26,10,7,19,16
809,MEM,0,240,36,85,42.4,11,32,34.4,25,53,47.17,12,15,80,5,35,40,24,7,8,19,16
810,PHX,0,240,30,84,35.7,4,20,20,26,64,40.62,23,26,88.5,9,35,44,13,7,3,13,20
811,NOP,0,240,39,84,46.4,14,36,38.9,25,48,52.08,25,32,78.1,8,33,41,26,6,3,14,21
812,LAC,0,240,33,78,42.3,4,21,19,29,57,50.88,25,39,64.1,8,37,45,19,5,8,14,20
813,LAC,1,240,36,97,37.1,12,38,31.6,24,59,40.68,26,33,78.8,20,37,57,19,9,3,11,21
814,DAL,0,240,39,91,42.9,12,43,27.9,27,48,56.25,17,24,70.8,12,37,49,23,7,8,13,28
815,ATL,0,240,41,83,49.4,12,33,36.4,29,50,58,23,33,69.7,9,41,50,26,9,8,24,34
816,IND,0,240,39,93,41.9,7,26,26.9,32,67,47.76,3,7,42.9,9,21,30,23,15,9,14,14
817,MIN,0,240,38,91,41.8,13,42,31,25,49,51.02,11,14,78.6,11,31,42,26,7,5,9,11
818,DEN,1,240,43,90,47.8,11,31,35.5,32,59,54.24,10,12,83.3,13,40,53,26,9,1,13,18
819,CHI,0,240,34,92,37,14,48,29.2,20,44,45.45,16,18,88.9,7,32,39,18,11,2,17,21
820,POR,1,265,44,100,44,14,44,31.8,30,56,53.57,27,30,90,12,42,54,21,4,11,12,19
821,SAS,1,240,43,87,49.4,17,31,54.8,26,56,46.43,17,22,77.3,6,25,31,30,12,7,9,23
822,UTA,1,240,47,87,54,12,31,38.7,35,56,62.5,12,12,100,11,42,53,22,5,4,21,11
823,HOU,0,240,43,97,44.3,9,45,20,34,52,65.38,12,17,70.6,9,34,43,21,6,7,11,23
824,PHI,1,240,42,94,44.7,13,39,33.3,29,55,52.73,20,27,74.1,12,31,43,30,12,6,13,24
825,CHA,0,240,29,76,38.2,10,33,30.3,19,43,44.19,15,20,75,9,30,39,21,4,5,18,18
826,GSW,0,265,48,116,41.4,9,36,25,39,80,48.75,19,22,86.4,19,41,60,30,7,5,9,25
827,CLE,0,240,32,94,34,11,33,33.3,21,61,34.43,11,17,64.7,16,37,53,15,5,4,10,14
828,MIA,1,265,42,83,50.6,16,42,38.1,26,41,63.41,18,22,81.8,5,37,42,26,9,3,21,20
829,NOP,1,240,42,88,47.7,21,48,43.8,21,40,52.5,21,24,87.5,5,38,43,24,7,7,17,18
830,NYK,1,240,41,85,48.2,9,23,39.1,32,62,51.61,15,17,88.2,7,42,49,17,6,9,10,17
831,ORL,1,240,44,92,47.8,14,28,50,30,64,46.88,4,9,44.4,15,32,47,25,9,4,11,15
832,DET,0,240,38,89,42.7,10,32,31.3,28,57,49.12,14,20,70,11,30,41,19,10,5,17,18
833,LAL,0,240,39,89,43.8,7,26,26.9,32,63,50.79,22,29,75.9,12,24,36,22,5,8,15,23
834,PHX,0,240,42,80,52.5,8,22,36.4,34,58,58.62,26,30,86.7,8,35,43,26,3,3,14,19
835,WAS,1,240,42,82,51.2,9,24,37.5,33,58,56.9,13,16,81.3,6,38,44,22,9,6,20,23
836,OKC,1,240,40,92,43.5,12,32,37.5,28,60,46.67,20,26,76.9,7,40,47,14,8,6,13,18
837,BOS,1,240,52,93,55.9,16,34,47.1,36,59,61.02,19,29,65.5,14,34,48,31,10,5,12,26
838,MIL,1,240,45,77,58.4,11,26,42.3,34,51,66.67,10,23,43.5,3,45,48,34,7,5,23,15
839,SAC,0,265,44,106,41.5,13,51,25.5,31,55,56.36,12,15,80,16,33,49,27,11,3,15,21
840,MEM,0,240,46,103,44.7,9,33,27.3,37,70,52.86,15,21,71.4,15,36,51,26,8,3,14,19
841,BKN,0,240,39,81,48.1,11,29,37.9,28,52,53.85,22,34,64.7,13,34,47,22,7,2,22,23
842,TOR,1,240,38,92,41.3,13,42,31,25,50,50,33,43,76.7,12,33,45,25,13,3,14,25
843,SAS,1,240,36,85,42.4,12,33,36.4,24,52,46.15,23,24,95.8,9,34,43,27,5,4,11,18
844,DEN,0,240,41,88,46.6,3,23,13,38,65,58.46,22,32,68.8,12,32,44,22,10,4,9,19
845,IND,1,240,43,86,50,13,29,44.8,30,57,52.63,16,19,84.2,11,27,38,31,1,4,15,25
846,MIA,0,240,37,86,43,10,34,29.4,27,52,51.92,18,20,90,10,37,47,23,8,3,10,19
847,LAL,1,240,45,93,48.4,11,33,33.3,34,60,56.67,23,32,71.9,15,34,49,25,13,9,17,27
848,GSW,1,240,43,94,45.7,12,40,30,31,54,57.41,11,11,100,7,37,44,25,9,2,11,13
849,BKN,0,240,33,99,33.3,15,49,30.6,18,50,36,16,17,94.1,12,35,47,23,11,7,17,19
850,ATL,0,240,40,93,43,10,34,29.4,30,59,50.85,13,15,86.7,10,22,32,18,9,6,20,20
851,POR,0,240,39,91,42.9,12,32,37.5,27,59,45.76,16,21,76.2,12,28,40,11,7,7,12,28
852,NYK,0,240,35,88,39.8,6,25,24,29,63,46.03,11,18,61.1,12,36,48,20,4,5,14,18
853,UTA,1,240,43,85,50.6,14,42,33.3,29,43,67.44,23,24,95.8,10,37,47,24,7,4,10,14
854,DET,1,240,51,86,59.3,15,32,46.9,36,54,66.67,19,25,76,11,30,41,31,12,8,18,18
855,BOS,0,240,42,96,43.8,15,42,35.7,27,54,50,20,22,90.9,4,35,39,26,11,6,11,24
856,MIN,0,240,38,94,40.4,14,50,28,24,44,54.55,22,27,81.5,12,37,49,34,8,5,17,18
857,OKC,1,240,43,83,51.8,7,22,31.8,36,61,59.02,26,36,72.2,12,36,48,25,5,4,13,20
858,CHI,1,240,48,87,55.2,9,25,36,39,62,62.9,13,17,76.5,4,22,26,25,18,4,12,24
859,HOU,0,240,40,90,44.4,12,37,32.4,28,53,52.83,23,29,79.3,11,35,46,20,8,4,20,26
860,CLE,0,240,40,73,54.8,15,29,51.7,25,44,56.82,21,23,91.3,7,29,36,27,5,5,27,18
861,LAC,1,240,46,93,49.5,10,31,32.3,36,62,58.06,31,39,79.5,10,26,36,22,12,2,12,29
862,PHX,1,240,42,89,47.2,13,31,41.9,29,58,50,26,30,86.7,10,42,52,27,6,6,15,16
863,NOP,0,240,46,86,53.5,15,41,36.6,31,45,68.89,23,36,63.9,12,36,48,32,7,4,21,26
864,ORL,0,240,39,86,45.3,9,31,29,30,55,54.55,8,13,61.5,9,37,46,21,7,5,15,12
865,TOR,1,240,47,91,51.6,13,35,37.1,34,56,60.71,15,17,88.2,7,35,42,25,13,9,14,23
866,MIL,1,240,45,89,50.6,17,37,45.9,28,52,53.85,10,16,62.5,5,49,54,30,8,6,20,16
867,SAC,0,240,42,86,48.8,10,26,38.5,32,60,53.33,7,12,58.3,7,30,37,20,3,3,10,23
868,PHI,1,240,34,78,43.6,10,32,31.3,24,46,52.17,12,19,63.2,5,36,41,26,8,6,14,19
869,DAL,1,240,39,89,43.8,20,47,42.6,19,42,45.24,22,28,78.6,13,30,43,19,6,4,13,17
870,SAS,0,240,45,98,45.9,8,29,27.6,37,69,53.62,22,23,95.7,14,34,48,28,12,6,15,27
871,TOR,1,240,52,91,57.1,22,43,51.2,30,48,62.5,14,16,87.5,7,34,41,35,16,2,19,24
872,MEM,1,240,45,89,50.6,9,28,32.1,36,61,59.02,14,20,70,7,37,44,32,11,8,12,19
873,OKC,0,240,37,84,44,18,46,39.1,19,38,50,16,18,88.9,6,29,35,29,4,5,10,20
874,CLE,0,240,41,92,44.6,9,36,25,32,56,57.14,18,26,69.2,16,34,50,18,6,2,15,19
875,WAS,0,240,40,89,44.9,15,35,42.9,25,54,46.3,16,23,69.6,13,30,43,19,9,3,28,16
876,MIN,0,240,40,88,45.5,17,39,43.6,23,49,46.94,17,21,81,7,29,36,22,4,1,13,19
877,CHI,0,240,35,81,43.2,8,35,22.9,27,46,58.7,11,15,73.3,6,31,37,21,8,3,17,14
878,ATL,1,240,41,82,50,19,40,47.5,22,42,52.38,20,27,74.1,8,35,43,21,10,6,19,18
879,POR,0,240,44,85,51.8,9,30,30,35,55,63.64,15,22,68.2,8,32,40,25,6,5,12,22
880,PHI,1,240,40,82,48.8,9,29,31,31,53,58.49,11,11,100,9,35,44,30,9,7,13,12
881,MIA,1,240,41,84,48.8,14,36,38.9,27,48,56.25,19,24,79.2,6,39,45,26,4,3,11,23
882,IND,1,240,46,82,56.1,8,24,33.3,38,58,65.52,16,20,80,4,37,41,24,4,8,13,20
883,MIL,1,240,43,87,49.4,16,31,51.6,27,56,48.21,26,37,70.3,7,43,50,21,6,6,10,22
884,UTA,0,265,46,100,46,15,39,38.5,31,61,50.82,25,32,78.1,11,32,43,23,9,6,13,29
885,LAC,1,240,47,95,49.5,14,32,43.8,33,63,52.38,14,20,70,10,49,59,29,4,4,10,17
886,DEN,1,265,47,100,47,17,35,48.6,30,65,46.15,23,26,88.5,15,41,56,31,11,6,21,23
887,NYK,0,240,37,90,41.1,8,26,30.8,29,64,45.31,16,24,66.7,10,30,40,21,12,3,18,21
888,BOS,0,240,43,98,43.9,15,49,30.6,28,49,57.14,22,27,81.5,10,33,43,16,4,7,8,25
889,PHX,1,240,47,92,51.1,12,30,40,35,62,56.45,15,18,83.3,14,39,53,31,11,4,19,22
890,ORL,0,240,36,92,39.1,14,42,33.3,22,50,44,9,16,56.3,6,36,42,24,4,4,9,21
891,NOP,1,265,51,93,54.8,11,26,42.3,40,67,59.7,25,35,71.4,9,36,45,29,8,9,13,27
892,GSW,0,265,42,95,44.2,20,45,44.4,22,50,44,27,31,87.1,10,32,42,36,12,6,19,20
893,POR,1,240,41,95,43.2,11,36,30.6,30,59,50.85,24,29,82.8,12,46,58,22,6,4,8,19
894,LAL,0,240,48,97,49.5,15,38,39.5,33,59,55.93,7,11,63.6,13,35,48,34,7,6,16,20
895,ORL,1,240,43,94,45.7,10,26,38.5,33,68,48.53,23,29,79.3,13,35,48,22,10,2,13,15
896,IND,1,240,44,85,51.8,7,23,30.4,37,62,59.68,9,12,75,7,38,45,27,7,3,15,15
897,DAL,1,240,47,92,51.1,13,40,32.5,34,52,65.38,20,24,83.3,13,34,47,24,4,2,11,18
898,MIN,0,240,38,88,43.2,11,28,39.3,27,60,45,12,16,75,10,35,45,26,6,7,15,14
899,BKN,0,240,38,87,43.7,12,25,48,26,62,41.94,18,30,60,11,33,44,20,9,1,15,22
900,HOU,0,240,38,96,39.6,16,49,32.7,22,47,46.81,15,23,65.2,12,38,50,24,4,4,12,22
901,CHI,1,240,43,85,50.6,14,38,36.8,29,47,61.7,15,22,68.2,8,33,41,26,11,5,15,19
902,BOS,0,240,41,83,49.4,9,28,32.1,32,55,58.18,12,20,60,13,31,44,21,7,2,15,17
903,SAC,0,240,50,96,52.1,12,33,36.4,38,63,60.32,11,20,55,11,31,42,28,5,0,8,22
904,DEN,1,240,38,79,48.1,9,28,32.1,29,51,56.86,15,25,60,3,37,40,28,8,7,13,18
905,OKC,0,240,43,85,50.6,16,42,38.1,27,43,62.79,19,20,95,4,27,31,32,14,3,20,17
906,MIA,1,240,41,88,46.6,17,40,42.5,24,48,50,7,13,53.8,8,41,49,26,4,5,10,14
907,TOR,1,240,52,85,61.2,15,27,55.6,37,58,63.79,11,15,73.3,5,31,36,33,13,1,19,23
908,CHA,0,240,33,81,40.7,12,35,34.3,21,46,45.65,8,14,57.1,9,33,42,28,4,6,15,24
909,SAS,0,240,39,89,43.8,10,33,30.3,29,56,51.79,12,15,80,6,35,41,22,8,4,8,17
910,DET,1,240,47,78,60.3,12,32,37.5,35,46,76.09,10,19,52.6,3,31,34,30,8,4,13,19
911,PHI,1,240,45,88,51.1,11,30,36.7,34,58,58.62,16,25,64,13,36,49,25,7,11,12,23
912,WAS,0,240,37,79,46.8,11,27,40.7,26,52,50,21,26,80.8,7,31,38,25,8,6,17,17
913,GSW,0,240,39,87,44.8,9,32,28.1,30,55,54.55,10,13,76.9,7,29,36,27,4,1,14,16
914,MIL,1,240,45,92,48.9,15,36,41.7,30,56,53.57,23,28,82.1,8,51,59,27,4,8,14,22
915,NYK,0,240,36,102,35.3,11,37,29.7,25,65,38.46,19,26,73.1,12,37,49,26,7,3,11,21
916,PHX,0,240,40,87,46,4,20,20,36,67,53.73,26,32,81.3,10,30,40,20,9,6,12,19
917,UTA,1,240,46,92,50,13,36,36.1,33,56,58.93,13,15,86.7,7,34,41,19,8,3,9,15
918,CLE,0,240,38,91,41.8,14,37,37.8,24,54,44.44,13,15,86.7,8,32,40,25,5,6,13,21
919,BKN,0,240,45,90,50,8,26,30.8,37,64,57.81,9,15,60,11,32,43,22,4,4,12,13
920,LAC,1,240,49,94,52.1,15,38,39.5,34,56,60.71,15,21,71.4,14,39,53,29,7,8,11,12
921,DAL,1,240,49,96,51,13,37,35.1,36,59,61.02,13,21,61.9,15,38,53,23,5,2,8,17
922,ATL,1,240,46,93,49.5,14,31,45.2,32,62,51.61,17,20,85,12,34,46,25,3,10,17,25
923,MEM,1,240,46,91,50.5,13,37,35.1,33,54,61.11,16,19,84.2,7,35,42,29,6,9,9,19
924,HOU,0,240,37,86,43,14,45,31.1,23,41,56.1,22,24,91.7,9,32,41,18,4,2,16,23
925,POR,1,240,42,83,50.6,16,37,43.2,26,46,56.52,15,19,78.9,9,38,47,26,4,5,13,21
926,CHA,0,240,40,90,44.4,18,38,47.4,22,52,42.31,14,18,77.8,10,32,42,24,7,3,8,20
927,NOP,1,265,43,103,41.7,9,26,34.6,34,77,44.16,22,27,81.5,17,44,61,23,6,5,19,19
928,PHI,0,240,37,89,41.6,6,33,18.2,31,56,55.36,15,19,78.9,12,40,52,17,6,4,13,21
929,DET,0,265,40,99,40.4,11,32,34.4,29,67,43.28,19,24,79.2,5,38,43,27,11,8,9,25
930,CLE,0,240,38,85,44.7,7,25,28,31,60,51.67,16,24,66.7,10,30,40,21,4,1,20,22
931,IND,1,240,33,86,38.4,10,26,38.5,23,60,38.33,25,31,80.6,13,37,50,24,6,6,9,14
932,OKC,1,240,41,82,50,12,30,40,29,52,55.77,23,26,88.5,7,44,51,25,4,6,15,16
933,LAL,1,240,48,88,54.5,11,30,36.7,37,58,63.79,21,28,75,11,34,45,33,8,3,9,25
934,CHI,0,240,37,81,45.7,6,25,24,31,56,55.36,21,26,80.8,7,31,38,16,5,5,14,22
935,ORL,1,240,40,92,43.5,9,29,31,31,63,49.21,25,30,83.3,12,34,46,17,6,5,8,12
936,MIN,0,240,38,91,41.8,12,35,34.3,26,56,46.43,16,21,76.2,9,28,37,23,10,6,10,21
937,SAC,0,240,45,87,51.7,12,31,38.7,33,56,58.93,10,11,90.9,4,40,44,25,6,4,12,21
938,BOS,1,240,39,83,47,9,23,39.1,30,60,50,26,29,89.7,10,33,43,28,7,6,12,19
939,PHX,1,240,41,82,50,7,21,33.3,34,61,55.74,11,18,61.1,12,39,51,22,8,5,18,19
940,GSW,0,240,35,92,38,17,34,50,18,58,31.03,15,21,71.4,12,35,47,23,11,6,22,18
941,CHA,0,240,36,86,41.9,8,35,22.9,28,51,54.9,12,18,66.7,8,29,37,25,10,3,16,19
942,UTA,1,240,48,90,53.3,10,30,33.3,38,60,63.33,21,25,84,12,32,44,24,6,2,11,18
943,LAC,0,240,38,84,45.2,8,33,24.2,30,51,58.82,20,26,76.9,10,32,42,21,8,5,14,26
944,SAS,1,240,38,87,43.7,7,32,21.9,31,55,56.36,22,30,73.3,9,42,51,24,6,5,11,11
945,ATL,0,240,32,97,33,12,48,25,20,49,40.82,10,11,90.9,4,29,33,23,16,4,12,23
946,WAS,0,240,47,93,50.5,7,22,31.8,40,71,56.34,15,17,88.2,9,28,37,28,5,4,10,18
947,TOR,0,240,39,96,40.6,17,48,35.4,22,48,45.83,9,11,81.8,8,37,45,30,7,3,12,23
948,DEN,1,240,37,77,48.1,11,25,44,26,52,50,29,37,78.4,9,35,44,24,7,4,14,26
949,MEM,1,240,45,100,45,11,35,31.4,34,65,52.31,21,25,84,18,42,60,33,17,7,17,16
950,MIA,0,240,42,78,53.8,14,35,40,28,43,65.12,23,28,82.1,8,31,39,24,1,5,15,24
951,BKN,1,240,41,77,53.2,10,26,38.5,31,51,60.78,16,29,55.2,7,55,62,25,8,2,26,20
952,NYK,1,240,46,90,51.1,9,31,29,37,59,62.71,23,28,82.1,10,29,39,24,11,3,6,23
953,POR,0,240,37,95,38.9,10,36,27.8,27,59,45.76,17,21,81,8,40,48,17,6,4,13,20
954,DAL,1,240,40,79,50.6,11,27,40.7,29,52,55.77,18,27,66.7,11,43,54,22,4,8,16,20
955,MIL,1,240,47,103,45.6,14,38,36.8,33,65,50.77,14,20,70,10,50,60,21,6,5,10,16
956,BOS,1,240,55,100,55,14,29,48.3,41,71,57.75,16,18,88.9,10,43,53,29,14,3,11,23
957,DEN,0,240,41,95,43.2,8,39,20.5,33,56,58.93,13,18,72.2,11,31,42,23,9,4,5,13
958,LAL,1,240,51,99,51.5,15,32,46.9,36,67,53.73,8,10,80,12,42,54,21,3,4,12,17
959,OKC,0,240,43,92,46.7,9,31,29,34,61,55.74,15,17,88.2,5,32,37,23,6,6,7,13
960,CHI,1,240,42,83,50.6,11,35,31.4,31,48,64.58,13,14,92.9,9,29,38,24,11,6,15,21
961,MIN,0,240,36,95,37.9,13,48,27.1,23,47,48.94,24,36,66.7,13,31,44,28,12,4,18,18
962,CLE,1,240,44,89,49.4,12,37,32.4,32,52,61.54,11,13,84.6,12,43,55,22,5,1,15,19
963,NOP,0,240,40,100,40,14,45,31.1,26,55,47.27,11,18,61.1,15,28,43,29,4,6,16,19
964,HOU,1,240,49,95,51.6,18,45,40,31,50,62,23,29,79.3,12,46,58,29,9,6,22,24
965,PHI,0,240,37,98,37.8,9,37,24.3,28,61,45.9,8,12,66.7,14,29,43,22,11,5,4,20
966,DET,0,240,36,78,46.2,9,28,32.1,27,50,54,18,27,66.7,12,30,42,22,7,4,19,20
967,BKN,1,240,45,93,48.4,15,44,34.1,30,49,61.22,12,19,63.2,14,37,51,31,5,4,10,15
968,MEM,1,240,52,100,52,16,38,42.1,36,62,58.06,14,16,87.5,11,38,49,39,5,6,8,20
969,NYK,0,240,46,100,46,5,27,18.5,41,73,56.16,14,20,70,14,32,46,26,13,1,13,16
970,GSW,0,240,37,96,38.5,8,39,20.5,29,57,50.88,18,25,72,13,33,46,28,9,1,10,22
971,MIA,0,240,44,85,51.8,7,29,24.1,37,56,66.07,18,21,85.7,4,36,40,26,6,3,8,20
972,PHX,1,240,33,79,41.8,9,28,32.1,24,51,47.06,23,26,88.5,9,35,44,19,10,8,15,21
973,UTA,1,240,40,79,50.6,18,42,42.9,22,37,59.46,11,14,78.6,9,31,40,28,9,6,16,20
974,CHI,0,240,37,80,46.3,18,41,43.9,19,39,48.72,13,16,81.3,6,30,36,16,6,3,16,15
975,ORL,0,240,33,89,37.1,9,33,27.3,24,56,42.86,19,24,79.2,14,35,49,15,9,6,16,23
976,NOP,1,240,48,86,55.8,18,38,47.4,30,48,62.5,9,17,52.9,6,37,43,35,8,6,20,16
977,CHA,0,240,35,75,46.7,8,26,30.8,27,49,55.1,14,19,73.7,7,30,37,20,6,3,21,16
978,LAL,1,240,47,89,52.8,10,24,41.7,37,65,56.92,25,32,78.1,12,37,49,18,6,5,7,27
979,SAS,0,240,42,87,48.3,17,40,42.5,25,47,53.19,20,23,87,5,32,37,29,3,6,11,17
980,MIL,1,240,47,95,49.5,10,39,25.6,37,56,66.07,23,30,76.7,7,45,52,29,11,4,11,12
981,SAC,0,240,44,96,45.8,10,35,28.6,34,61,55.74,8,10,80,6,39,45,26,8,3,16,24
982,LAC,1,240,41,84,48.8,11,39,28.2,30,45,66.67,16,22,72.7,9,45,54,27,5,7,19,24
983,ATL,0,240,41,89,46.1,7,29,24.1,34,60,56.67,12,24,50,9,47,56,19,5,9,18,26
984,WAS,1,240,42,112,37.5,10,29,34.5,32,83,38.55,17,28,60.7,19,38,57,26,11,1,9,22
985,IND,1,240,48,84,57.1,11,30,36.7,37,54,68.52,9,14,64.3,8,38,46,31,9,5,14,16
986,DAL,0,240,39,96,40.6,11,38,28.9,28,58,48.28,25,37,67.6,17,30,47,19,4,3,9,20
987,CLE,1,265,48,91,52.7,5,20,25,43,71,60.56,14,20,70,10,29,39,24,9,5,15,18
988,BOS,0,240,38,88,43.2,14,36,38.9,24,52,46.15,8,8,100,8,30,38,17,8,1,15,16
989,OKC,1,240,43,87,49.4,11,32,34.4,32,55,58.18,16,20,80,9,43,52,22,8,2,13,13
990,HOU,0,240,34,89,38.2,11,40,27.5,23,49,46.94,13,14,92.9,8,31,39,16,4,3,14,21
991,MIN,1,240,44,89,49.4,13,32,40.6,31,57,54.39,15,21,71.4,15,41,56,25,7,9,15,28
992,PHI,1,240,43,88,48.9,11,27,40.7,32,61,52.46,12,17,70.6,13,35,48,24,6,5,13,11
993,DET,0,265,48,98,49,6,20,30,42,78,53.85,10,16,62.5,19,27,46,20,8,9,16,25
994,POR,0,240,35,96,36.5,11,37,29.7,24,59,40.68,21,31,67.7,14,27,41,14,9,6,12,21
995,DEN,1,240,41,85,48.2,9,24,37.5,32,61,52.46,16,20,80,9,29,38,27,7,5,13,22
996,GSW,0,240,33,87,37.9,15,38,39.5,18,49,36.73,17,20,85,12,40,52,29,7,4,19,30
997,CHA,0,265,38,86,44.2,15,37,40.5,23,49,46.94,19,26,73.1,13,37,50,30,6,6,20,21
998,DAL,0,240,39,77,50.6,12,35,34.3,27,42,64.29,16,24,66.7,6,32,38,27,8,6,13,18
999,WAS,0,240,36,84,42.9,6,23,26.1,30,61,49.18,11,19,57.9,10,30,40,24,8,5,23,22
1000,BOS,0,240,37,89,41.6,13,38,34.2,24,51,47.06,27,30,90,8,31,39,26,7,2,15,20
1001,IND,0,240,40,84,47.6,9,27,33.3,31,57,54.39,19,25,76,6,31,37,25,5,3,12,18
1002,MIL,1,240,35,87,40.2,9,41,22,26,46,56.52,28,32,87.5,5,42,47,22,11,3,10,19
1003,SAS,1,240,48,87,55.2,9,29,31,39,58,67.24,24,26,92.3,8,41,49,28,9,6,15,25
1004,CHI,0,240,41,92,44.6,14,35,40,27,57,47.37,12,21,57.1,10,29,39,22,12,2,12,23
1005,HOU,1,240,39,92,42.4,13,45,28.9,26,47,55.32,31,41,75.6,16,43,59,22,7,7,13,21
1006,ORL,1,240,43,87,49.4,10,27,37,33,60,55,27,34,79.4,13,38,51,24,18,3,17,21
1007,ATL,0,240,39,106,36.8,13,44,29.5,26,62,41.94,24,27,88.9,16,38,54,20,6,8,11,29
1008,UTA,1,240,49,90,54.4,16,43,37.2,33,47,70.21,14,23,60.9,12,38,50,29,6,6,7,15
1009,TOR,1,265,42,94,44.7,14,36,38.9,28,58,48.28,14,20,70,14,32,46,34,7,5,13,23
1010,NYK,0,240,42,97,43.3,9,25,36,33,72,45.83,11,11,100,14,27,41,18,3,1,9,17
1011,NOP,1,240,41,87,47.1,15,44,34.1,26,43,60.47,26,32,81.3,12,38,50,31,7,8,15,16
1012,MIA,1,240,43,81,53.1,16,38,42.1,27,43,62.79,20,25,80,3,38,41,28,8,4,11,22
1013,TOR,0,240,35,96,36.5,15,42,35.7,20,54,37.04,14,19,73.7,17,40,57,21,5,7,13,21
1014,POR,1,240,38,88,43.2,13,35,37.1,25,53,47.17,12,14,85.7,7,38,45,23,6,11,11,15
1015,LAL,1,240,41,82,50,17,36,47.2,24,46,52.17,18,21,85.7,6,42,48,27,11,11,19,19
1016,BKN,0,265,40,98,40.8,11,37,29.7,29,61,47.54,12,16,75,11,41,52,19,5,5,17,25
1017,DET,1,240,42,91,46.2,13,33,39.4,29,58,50,18,21,85.7,10,30,40,26,8,3,9,15
1018,MEM,1,240,46,89,51.7,8,28,28.6,38,61,62.3,19,21,90.5,9,35,44,22,12,6,15,18
1019,NYK,0,240,37,95,38.9,4,20,20,33,75,44,9,16,56.3,15,32,47,15,10,3,16,20
1020,OKC,1,265,38,92,41.3,11,37,29.7,27,55,49.09,24,29,82.8,8,43,51,19,11,3,17,15
1021,MIN,0,240,40,90,44.4,15,47,31.9,25,43,58.14,17,21,81,10,30,40,23,10,1,20,23
1022,CLE,0,240,42,85,49.4,14,31,45.2,28,54,51.85,15,16,93.8,11,35,46,29,7,4,17,19
1023,SAC,1,240,37,84,44,15,36,41.7,22,48,45.83,25,28,89.3,8,33,41,18,8,1,16,22
1024,PHX,0,240,37,77,48.1,11,35,31.4,26,42,61.9,18,22,81.8,6,35,41,24,4,2,19,25
1025,DEN,1,240,47,92,51.1,9,27,33.3,38,65,58.46,20,27,74.1,7,34,41,27,4,6,4,23
1026,PHI,1,240,46,90,51.1,13,26,50,33,64,51.56,15,18,83.3,9,33,42,31,4,0,10,28
1027,NOP,0,240,45,94,47.9,12,31,38.7,33,63,52.38,24,30,80,13,35,48,23,4,5,6,20
1028,MIL,0,240,38,95,40,15,45,33.3,23,50,46,13,14,92.9,10,28,38,24,5,5,8,15
1029,CHA,0,240,37,81,45.7,10,30,33.3,27,51,52.94,20,22,90.9,8,30,38,21,3,3,12,14
1030,WAS,1,240,39,84,46.4,7,21,33.3,32,63,50.79,14,23,60.9,7,40,47,18,8,9,14,22
1031,UTA,1,240,46,90,51.1,16,33,48.5,30,57,52.63,20,24,83.3,7,36,43,19,3,3,8,25
1032,SAC,1,240,39,81,48.1,15,30,50,24,51,47.06,18,23,78.3,6,37,43,27,10,3,23,23
1033,ORL,1,240,35,81,43.2,8,26,30.8,27,55,49.09,23,31,74.2,11,49,60,21,8,3,20,19
1034,OKC,0,240,40,89,44.9,12,29,41.4,28,60,46.67,21,31,67.7,14,33,47,17,3,3,13,22
1035,BOS,0,240,33,95,34.7,8,37,21.6,25,58,43.1,20,26,76.9,16,39,55,17,7,8,17,20
1036,GSW,0,240,34,86,39.5,5,26,19.2,29,60,48.33,25,32,78.1,10,34,44,19,13,4,19,18
1037,SAS,1,240,45,88,51.1,19,35,54.3,26,53,49.06,17,19,89.5,10,44,54,23,4,2,13,16
1038,ATL,0,240,35,77,45.5,18,39,46.2,17,38,44.74,27,32,84.4,4,30,34,24,3,5,10,22
1039,DAL,1,240,44,84,52.4,16,41,39,28,43,65.12,14,19,73.7,11,32,43,25,5,6,15,12
1040,IND,1,240,47,89,52.8,10,26,38.5,37,63,58.73,11,14,78.6,12,31,43,31,8,5,11,23
1041,BKN,0,240,32,96,33.3,10,47,21.3,22,49,44.9,15,19,78.9,12,34,46,20,11,1,13,19
1042,CHI,0,240,46,98,46.9,9,31,29,37,67,55.22,9,11,81.8,17,28,45,25,10,6,9,21
1043,LAC,1,240,45,83,54.2,18,32,56.3,27,51,52.94,27,33,81.8,10,32,42,25,4,3,19,27
1044,DET,0,240,29,78,37.2,11,26,42.3,18,52,34.62,30,35,85.7,6,37,43,21,8,6,16,22
1045,PHX,0,240,43,95,45.3,6,26,23.1,37,69,53.62,22,26,84.6,12,34,46,25,7,4,10,19
1046,MIN,1,240,47,95,49.5,14,38,36.8,33,57,57.89,10,13,76.9,14,29,43,32,16,8,17,19
1047,MIA,1,240,47,90,52.2,18,44,40.9,29,46,63.04,10,16,62.5,11,36,47,34,4,5,11,17
1048,MEM,1,240,45,83,54.2,18,42,42.9,27,41,65.85,13,17,76.5,3,39,42,31,4,8,17,22
1049,NYK,0,240,48,84,57.1,12,23,52.2,36,61,59.02,24,37,64.9,8,29,37,22,11,4,16,26
1050,POR,0,240,40,87,46,13,37,35.1,27,50,54,18,20,90,8,32,40,21,5,4,10,15
1051,LAL,1,240,42,92,45.7,6,20,30,36,72,50,16,23,69.6,11,39,50,23,8,20,13,22
1052,CLE,0,240,40,84,47.6,8,25,32,32,59,54.24,15,19,78.9,12,32,44,15,6,2,20,13
1053,GSW,0,240,33,82,40.2,11,21,52.4,22,61,36.07,27,32,84.4,11,31,42,26,13,3,14,19
1054,DAL,0,265,47,100,47,15,50,30,32,50,64,11,13,84.6,14,27,41,28,7,4,10,25
1055,UTA,1,240,42,93,45.2,16,40,40,26,53,49.06,9,14,64.3,14,37,51,22,3,3,8,10
1056,TOR,1,240,44,97,45.4,13,32,40.6,31,65,47.69,20,28,71.4,15,28,43,21,10,4,8,25
1057,SAC,0,240,38,85,44.7,12,21,57.1,26,64,40.62,27,36,75,14,37,51,20,9,3,21,24
1058,MIL,1,240,43,87,49.4,17,45,37.8,26,42,61.9,24,33,72.7,7,42,49,23,4,10,9,22
1059,BKN,0,240,32,67,47.8,13,35,37.1,19,32,59.38,25,34,73.5,6,32,38,24,4,11,24,24
1060,OKC,1,240,43,96,44.8,14,37,37.8,29,59,49.15,21,26,80.8,18,34,52,24,6,4,12,16
1061,NOP,1,240,38,87,43.7,16,45,35.6,22,42,52.38,25,33,75.8,9,35,44,28,11,3,15,25
1062,ORL,0,240,38,85,44.7,11,37,29.7,27,48,56.25,9,12,75,9,37,46,21,6,5,10,12
1063,DET,1,240,43,83,51.8,11,27,40.7,32,56,57.14,14,16,87.5,9,37,46,24,13,5,21,25
1064,LAC,0,240,45,101,44.6,7,30,23.3,38,71,53.52,17,22,77.3,14,35,49,20,3,1,13,22
1065,CHI,0,240,34,80,42.5,13,34,38.2,21,46,45.65,23,31,74.2,11,26,37,23,15,5,16,22
1066,BOS,1,240,43,82,52.4,8,19,42.1,35,63,55.56,17,21,81,13,31,44,22,10,5,20,22
1067,WAS,1,240,50,91,54.9,6,16,37.5,44,75,58.67,22,27,81.5,14,35,49,20,5,6,11,28
1068,ATL,1,240,42,82,51.2,10,32,31.3,32,50,64,22,24,91.7,4,36,40,22,8,4,14,28
1069,IND,0,240,36,87,41.4,10,27,37,26,60,43.33,29,35,82.9,13,26,39,24,8,4,11,24
1070,CHA,1,265,42,85,49.4,11,25,44,31,60,51.67,28,31,90.3,16,37,53,27,5,5,18,22
1071,DEN,0,240,40,87,46,6,29,20.7,34,58,58.62,28,34,82.4,9,24,33,18,6,2,12,23
1072,SAS,0,240,38,92,41.3,11,32,34.4,27,60,45,31,34,91.2,11,39,50,20,7,0,8,20
1073,MEM,1,240,49,96,51,18,39,46.2,31,57,54.39,24,28,85.7,11,43,54,36,8,10,9,23
1074,CLE,0,240,39,85,45.9,14,30,46.7,25,55,45.45,14,17,82.4,9,33,42,19,4,0,15,26
1075,PHX,1,240,42,90,46.7,10,28,35.7,32,62,51.61,26,33,78.8,9,39,48,28,7,3,10,25
1076,HOU,1,240,41,86,47.7,12,32,37.5,29,54,53.7,24,32,75,8,38,46,22,6,3,14,24
1077,NOP,0,240,48,102,47.1,11,37,29.7,37,65,56.92,6,7,85.7,9,31,40,24,4,10,12,20
1078,BOS,1,240,41,93,44.1,6,25,24,35,68,51.47,21,29,72.4,12,42,54,23,9,7,13,16
1079,MIA,0,240,30,80,37.5,7,37,18.9,23,43,53.49,18,23,78.3,10,39,49,16,7,2,18,20
1080,WAS,0,240,38,90,42.2,11,33,33.3,27,57,47.37,16,25,64,14,27,41,19,5,4,13,28
1081,POR,1,240,45,88,51.1,6,25,24,39,63,61.9,26,33,78.8,11,30,41,16,6,7,7,21
1082,ORL,1,240,33,81,40.7,13,35,37.1,20,46,43.48,26,29,89.7,7,37,44,25,11,4,11,17
1083,ATL,0,240,39,93,41.9,16,45,35.6,23,48,47.92,12,15,80,6,36,42,26,6,5,14,24
1084,LAL,1,240,43,86,50,14,29,48.3,29,57,50.88,23,28,82.1,8,39,47,29,9,4,14,14
1085,PHI,0,240,42,92,45.7,6,27,22.2,36,65,55.38,18,25,72,10,34,44,32,7,6,11,22
1086,NYK,0,240,41,92,44.6,10,37,27,31,55,56.36,20,30,66.7,13,39,52,19,7,7,15,26
1087,DET,0,240,40,94,42.6,7,33,21.2,33,61,54.1,25,35,71.4,12,33,45,20,10,1,11,23
1088,OKC,1,240,43,89,48.3,9,25,36,34,64,53.12,14,20,70,8,35,43,19,7,6,4,14
1089,DEN,1,240,46,87,52.9,8,27,29.6,38,60,63.33,24,27,88.9,15,32,47,27,7,2,10,21
1090,DAL,1,240,45,89,50.6,18,38,47.4,27,51,52.94,15,17,88.2,12,34,46,22,4,8,14,21
1091,BKN,0,240,42,91,46.2,12,37,32.4,30,54,55.56,15,17,88.2,12,32,44,29,5,1,12,21
1092,MIN,1,240,38,95,40,13,43,30.2,25,52,48.08,10,17,58.8,17,35,52,22,7,7,15,20
1093,TOR,0,240,28,89,31.5,6,42,14.3,22,47,46.81,14,17,82.4,13,35,48,20,4,6,11,12
1094,CLE,0,240,41,81,50.6,13,35,37.1,28,46,60.87,11,14,78.6,7,35,42,26,6,3,15,22
1095,MEM,0,240,45,93,48.4,13,34,38.2,32,59,54.24,20,21,95.2,8,34,42,31,4,0,17,25
1096,CHI,0,240,37,94,39.4,11,36,30.6,26,58,44.83,13,17,76.5,15,30,45,22,8,5,11,15
1097,MIA,1,240,33,81,40.7,12,37,32.4,21,44,47.73,6,11,54.5,9,41,50,23,6,4,16,13
1098,LAC,1,240,50,92,54.3,11,28,39.3,39,64,60.94,15,21,71.4,11,40,51,29,6,11,15,22
1099,UTA,1,240,37,76,48.7,11,30,36.7,26,46,56.52,17,22,77.3,7,35,42,24,5,6,17,17
1100,GSW,0,240,33,77,42.9,3,20,15,30,57,52.63,15,21,71.4,7,36,43,20,9,1,17,20
1101,CHA,1,240,37,83,44.6,15,38,39.5,22,45,48.89,20,24,83.3,10,29,39,25,5,0,11,15
1102,IND,0,240,43,82,52.4,12,26,46.2,31,56,55.36,18,25,72,9,25,34,32,7,3,9,21
1103,SAS,0,240,40,92,43.5,13,31,41.9,27,61,44.26,10,12,83.3,14,31,45,22,1,8,9,22
1104,SAC,1,240,44,90,48.9,14,34,41.2,30,56,53.57,26,31,83.9,7,34,41,26,9,8,13,24
1105,LAL,1,240,43,90,47.8,7,28,25,36,62,58.06,24,34,70.6,13,32,45,25,9,5,13,17
1106,POR,0,240,37,94,39.4,10,32,31.3,27,62,43.55,9,15,60,10,37,47,17,4,5,9,11
1107,PHX,0,240,42,86,48.8,6,23,26.1,36,63,57.14,17,23,73.9,11,36,47,32,7,3,15,28
1108,MIN,0,240,34,91,37.4,15,46,32.6,19,45,42.22,21,28,75,6,42,48,18,7,8,12,25
1109,ORL,1,240,45,95,47.4,12,32,37.5,33,63,52.38,20,27,74.1,11,41,52,25,11,6,9,21
1110,NYK,1,240,47,98,48,14,36,38.9,33,62,53.23,9,14,64.3,9,46,55,29,3,6,7,14
1111,WAS,0,240,33,87,37.9,9,31,29,24,56,42.86,26,31,83.9,9,37,46,18,5,4,13,23
1112,MIL,1,240,40,94,42.6,9,36,25,31,58,53.45,17,26,65.4,12,48,60,24,4,12,17,22
1113,CLE,0,240,37,87,42.5,10,38,26.3,27,49,55.1,13,16,81.3,8,33,41,21,5,4,15,19
1114,OKC,1,240,39,91,42.9,6,27,22.2,33,64,51.56,22,28,78.6,18,38,56,18,7,5,12,21
1115,IND,1,240,42,86,48.8,11,25,44,31,61,50.82,20,26,76.9,5,33,38,35,3,6,6,16
1116,SAC,0,240,33,80,41.3,8,28,28.6,25,52,48.08,13,19,68.4,11,30,41,20,8,5,16,23
1117,HOU,1,240,46,87,52.9,16,34,47.1,30,53,56.6,22,31,71,13,30,43,20,6,7,15,17
1118,CHA,0,240,34,86,39.5,12,34,35.3,22,52,42.31,12,16,75,8,33,41,25,7,4,17,16
1119,LAC,1,240,36,88,40.9,12,36,33.3,24,52,46.15,21,22,95.5,14,37,51,21,9,2,12,17
1120,GSW,0,265,44,96,45.8,12,27,44.4,32,69,46.38,13,18,72.2,9,35,44,31,5,6,9,14
1121,DAL,0,240,33,93,35.5,15,51,29.4,18,42,42.86,20,27,74.1,17,32,49,19,5,4,11,24
1122,DEN,0,240,45,97,46.4,8,25,32,37,72,51.39,6,9,66.7,14,25,39,25,7,5,16,22
1123,SAS,1,265,45,96,46.9,14,31,45.2,31,65,47.69,13,17,76.5,10,43,53,30,6,6,10,18
1124,BOS,1,240,44,97,45.4,14,38,36.8,30,59,50.85,7,10,70,15,39,54,25,12,9,13,16
1125,TOR,1,240,40,84,47.6,17,39,43.6,23,45,51.11,20,25,80,10,35,45,29,5,7,12,15
1126,PHI,0,240,37,91,40.7,6,29,20.7,31,62,50,17,20,85,14,33,47,24,4,6,15,22
1127,ATL,1,240,39,81,48.1,9,29,31,30,52,57.69,14,17,82.4,11,41,52,21,8,4,21,20
1128,MIA,0,240,33,73,45.2,10,28,35.7,23,45,51.11,29,39,74.4,10,34,44,18,5,1,19,22
1129,BKN,0,265,40,99,40.4,15,41,36.6,25,58,43.1,20,27,74.1,7,51,58,22,4,6,17,25
1130,UTA,1,240,39,83,47,10,26,38.5,29,57,50.88,16,20,80,9,37,46,20,7,6,15,21
1131,POR,0,240,44,96,45.8,14,34,41.2,30,62,48.39,14,18,77.8,10,32,42,24,5,4,9,19
1132,MIL,1,240,46,84,54.8,11,32,34.4,35,52,67.31,20,24,83.3,10,49,59,29,6,9,18,17
1133,PHX,1,240,44,92,47.8,13,23,56.5,31,69,44.93,21,22,95.5,10,34,44,29,6,4,11,17
1134,WAS,1,240,43,84,51.2,17,37,45.9,26,47,55.32,20,30,66.7,9,31,40,26,13,6,10,27
1135,DET,0,240,30,79,38,4,14,28.6,26,65,40,17,23,73.9,10,33,43,14,10,5,17,20
1136,CHI,0,240,40,107,37.4,17,44,38.6,23,63,36.51,5,8,62.5,14,29,43,26,10,2,10,20
1137,ORL,0,240,37,89,41.6,5,25,20,32,64,50,14,24,58.3,11,29,40,22,9,6,9,17
1138,MIN,1,265,42,104,40.4,17,44,38.6,25,60,41.67,21,29,72.4,11,49,60,20,12,8,14,22
1139,DAL,0,240,32,89,36,13,43,30.2,19,46,41.3,18,20,90,13,32,45,17,11,4,19,23
1140,OKC,1,240,34,78,43.6,10,33,30.3,24,45,53.33,20,23,87,8,35,43,15,8,6,17,14
1141,MEM,1,240,45,93,48.4,10,35,28.6,35,58,60.34,17,17,100,14,37,51,30,5,5,14,20
1142,DEN,1,240,42,81,51.9,8,29,27.6,34,52,65.38,28,31,90.3,10,27,37,23,6,4,12,18
1143,TOR,0,240,35,83,42.2,15,40,37.5,20,43,46.51,12,12,100,8,34,42,21,7,2,17,20
1144,HOU,0,240,42,81,51.9,15,39,38.5,27,42,64.29,13,20,65,8,33,41,29,5,3,17,16
1145,SAC,0,240,45,85,52.9,13,34,38.2,32,51,62.75,12,17,70.6,9,26,35,32,5,4,14,26
1146,CHA,0,240,37,86,43,9,31,29,28,55,50.91,21,32,65.6,11,31,42,23,8,4,14,19
1147,LAL,1,240,38,78,48.7,9,23,39.1,29,55,52.73,23,28,82.1,6,33,39,28,12,7,16,23
1148,NOP,1,240,50,102,49,18,44,40.9,32,58,55.17,9,13,69.2,14,32,46,32,9,4,9,17
1149,ORL,0,240,35,87,40.2,14,35,40,21,52,40.38,16,19,84.2,5,29,34,21,16,7,11,17
1150,CLE,1,240,32,77,41.6,4,20,20,28,57,49.12,26,36,72.2,14,46,60,13,9,4,29,21
1151,UTA,1,240,45,86,52.3,17,35,48.6,28,51,54.9,13,17,76.5,6,41,47,25,4,2,13,20
1152,BOS,0,240,31,78,39.7,7,32,21.9,24,46,52.17,28,36,77.8,7,24,31,18,11,4,15,17
1153,NYK,1,240,38,85,44.7,11,31,35.5,27,54,50,20,26,76.9,11,45,56,25,5,5,22,25
1154,GSW,0,240,45,93,48.4,18,39,46.2,27,54,50,13,17,76.5,9,33,42,28,4,3,13,19
1155,PHI,0,265,42,89,47.2,10,30,33.3,32,59,54.24,22,29,75.9,8,39,47,24,5,4,11,24
1156,ATL,0,240,32,86,37.2,9,34,26.5,23,52,44.23,8,11,72.7,9,30,39,24,8,5,21,16
1157,DET,0,240,40,90,44.4,12,36,33.3,28,54,51.85,17,30,56.7,10,30,40,20,9,5,11,15
1158,MEM,0,240,41,84,48.8,9,30,30,32,54,59.26,19,25,76,11,34,45,32,5,5,17,24
1159,MIL,1,240,43,84,51.2,13,37,35.1,30,47,63.83,12,18,66.7,14,44,58,30,6,5,25,13
1160,MIA,1,265,42,94,44.7,10,28,35.7,32,66,48.48,23,29,79.3,8,35,43,26,6,4,8,21
1161,HOU,1,240,44,101,43.6,13,42,31,31,59,52.54,7,16,43.8,16,38,54,16,7,6,14,15
1162,TOR,1,240,44,84,52.4,14,34,41.2,30,50,60,11,17,64.7,15,38,53,27,8,3,22,32
1163,SAS,1,240,53,93,57,18,35,51.4,35,58,60.34,12,15,80,7,44,51,30,8,7,11,20
1164,LAC,0,240,35,95,36.8,12,40,30,23,55,41.82,25,27,92.6,16,30,46,22,9,4,8,18
1165,LAL,1,240,47,91,51.6,11,32,34.4,36,59,61.02,23,28,82.1,11,33,44,32,6,7,11,25
1166,WAS,0,240,33,96,34.4,10,25,40,23,71,32.39,24,31,77.4,14,35,49,16,15,3,12,22
1167,DEN,1,240,45,93,48.4,9,29,31,36,64,56.25,20,27,74.1,10,33,43,28,9,4,10,20
1168,CHI,1,240,43,87,49.4,15,31,48.4,28,56,50,15,19,78.9,13,38,51,22,13,5,17,15
1169,PHX,1,240,45,86,52.3,9,26,34.6,36,60,60,13,15,86.7,7,33,40,30,10,2,14,21
1170,MIN,0,240,33,93,35.5,8,37,21.6,25,56,44.64,14,19,73.7,14,26,40,17,17,8,18,29
1171,DAL,1,240,48,92,52.2,24,51,47.1,24,41,58.54,21,21,100,9,37,46,35,11,7,13,17
1172,IND,0,240,33,85,38.8,6,28,21.4,27,57,47.37,26,29,89.7,12,34,46,17,6,2,18,16
1173,POR,0,240,41,86,47.7,15,35,42.9,26,51,50.98,23,27,85.2,9,30,39,18,4,8,16,22
1174,BKN,0,240,37,92,40.2,11,39,28.2,26,53,49.06,13,21,61.9,9,38,47,24,7,5,15,15
1175,SAC,0,240,41,84,48.8,12,31,38.7,29,53,54.72,16,24,66.7,7,29,36,19,3,4,12,16
1176,NOP,1,240,43,93,46.2,18,42,42.9,25,51,49.02,16,20,80,11,38,49,25,9,2,13,18
1177,PHX,0,240,35,75,46.7,7,33,21.2,28,42,66.67,19,24,79.2,11,38,49,22,6,1,27,21
1178,CLE,0,240,44,85,51.8,9,23,39.1,35,62,56.45,20,29,69,6,32,38,22,7,3,11,17
1179,ORL,1,240,37,88,42,10,30,33.3,27,58,46.55,14,23,60.9,10,38,48,26,4,5,16,21
1180,GSW,1,240,38,92,41.3,9,27,33.3,29,65,44.62,20,25,80,11,30,41,22,10,5,11,17
1181,PHI,0,240,35,87,40.2,10,29,34.5,25,58,43.1,17,21,81,7,38,45,23,10,3,16,22
1182,OKC,1,265,40,89,44.9,5,31,16.1,35,58,60.34,19,31,61.3,10,39,49,19,8,4,14,23
1183,MIL,1,240,46,91,50.5,11,28,39.3,35,63,55.56,9,13,69.2,6,50,56,29,9,8,18,13
1184,ATL,0,240,33,91,36.3,12,41,29.3,21,50,42,8,14,57.1,8,38,46,20,10,8,18,18
1185,CHA,0,265,42,101,41.6,7,39,17.9,35,62,56.45,11,18,61.1,17,37,54,26,8,4,15,27
1186,MIA,1,240,40,89,44.9,16,38,42.1,24,51,47.06,17,19,89.5,14,42,56,29,3,2,13,12
1187,IND,0,240,44,90,48.9,14,31,45.2,30,59,50.85,10,12,83.3,2,32,34,27,8,4,4,16
1188,BOS,1,240,49,95,51.6,14,40,35,35,55,63.64,17,19,89.5,12,31,43,28,4,10,11,23
1189,MEM,1,240,46,84,54.8,10,25,40,36,59,61.02,8,11,72.7,8,42,50,26,6,8,16,14
1190,MIN,1,290,36,104,34.6,10,46,21.7,26,58,44.83,23,29,79.3,14,51,65,23,7,5,15,20
1191,SAS,0,240,40,83,48.2,8,29,27.6,32,54,59.26,10,15,66.7,5,40,45,18,9,7,13,16
1192,SAC,0,290,37,107,34.6,9,39,23.1,28,68,41.18,21,25,84,16,51,67,20,8,8,12,23
1193,POR,0,240,43,89,48.3,15,34,44.1,28,55,50.91,14,19,73.7,11,32,43,14,4,1,12,21
1194,UTA,1,240,46,81,56.8,14,36,38.9,32,45,71.11,15,22,68.2,7,34,41,22,3,1,11,18
1195,OKC,0,240,38,92,41.3,10,35,28.6,28,57,49.12,11,13,84.6,7,27,34,23,11,4,9,14
1196,NYK,1,240,37,92,40.2,9,29,31,28,63,44.44,11,15,73.3,13,47,60,16,6,2,14,27
1197,BKN,0,240,21,78,26.9,13,50,26,8,28,28.57,27,36,75,9,41,50,17,3,3,13,19
1198,DAL,1,240,38,90,42.2,16,40,40,22,50,44,10,15,66.7,13,39,52,22,7,3,14,11
1199,DET,1,240,46,86,53.5,19,48,39.6,27,38,71.05,21,26,80.8,11,37,48,32,5,5,15,23
1200,WAS,0,240,38,92,41.3,7,24,29.2,31,68,45.59,19,27,70.4,18,26,44,18,7,5,12,25
1201,DEN,0,240,37,92,40.2,12,37,32.4,25,55,45.45,14,18,77.8,13,27,40,24,10,4,12,15
1202,PHI,1,240,44,101,43.6,21,44,47.7,23,57,40.35,12,15,80,14,35,49,29,9,7,8,12
1203,LAL,0,240,39,96,40.6,12,45,26.7,27,51,52.94,16,21,76.2,12,30,42,24,11,10,13,23
1204,NOP,1,240,41,90,45.6,18,43,41.9,23,47,48.94,12,12,100,14,38,52,23,9,5,19,14
1205,BOS,1,240,46,92,50,14,33,42.4,32,59,54.24,12,14,85.7,13,32,45,26,7,3,19,22
1206,HOU,0,240,37,100,37,16,51,31.4,21,49,42.86,14,16,87.5,14,35,49,19,8,3,12,25
1207,TOR,0,240,38,80,47.5,8,23,34.8,30,57,52.63,18,22,81.8,7,27,34,17,13,7,17,13
1208,MIL,0,240,45,95,47.4,13,33,39.4,32,62,51.61,6,8,75,8,39,47,23,6,6,10,15
1209,LAC,1,240,39,85,45.9,9,25,36,30,60,50,24,32,75,13,37,50,24,6,6,16,17
1210,GSW,1,240,41,87,47.1,9,28,32.1,32,59,54.24,25,28,89.3,11,43,54,27,7,8,16,18
1211,NOP,1,240,38,93,40.9,15,35,42.9,23,58,39.66,11,16,68.8,13,42,55,23,6,6,13,19
1212,ORL,1,240,39,81,48.1,10,26,38.5,29,55,52.73,15,23,65.2,6,40,46,23,10,13,13,15
1213,TOR,0,265,43,94,45.7,11,40,27.5,32,54,59.26,18,24,75,12,38,50,30,6,8,16,22
1214,UTA,0,240,39,90,43.3,12,36,33.3,27,54,50,14,18,77.8,10,35,45,17,10,6,12,21
1215,MIN,0,240,35,87,40.2,11,34,32.4,24,53,45.28,23,29,79.3,9,31,40,16,10,7,16,18
1216,DEN,1,240,43,78,55.1,15,28,53.6,28,50,56,12,15,80,6,33,39,31,10,1,21,24
1217,GSW,1,240,38,87,43.7,12,30,40,26,57,45.61,25,30,83.3,13,42,55,27,11,6,20,27
1218,PHX,0,240,42,87,48.3,13,37,35.1,29,50,58,14,18,77.8,9,29,38,29,10,0,17,19
1219,CHI,0,240,35,88,39.8,13,37,35.1,22,51,43.14,12,15,80,11,36,47,20,7,5,17,17
1220,SAC,0,240,41,87,47.1,7,30,23.3,34,57,59.65,15,23,65.2,11,38,49,20,4,4,19,24
1221,HOU,1,240,39,87,44.8,15,39,38.5,24,48,50,20,23,87,6,33,39,18,10,3,11,22
1222,PHI,1,240,52,95,54.7,12,30,40,40,65,61.54,9,11,81.8,17,31,48,33,8,8,12,21
1223,DET,0,240,43,84,51.2,10,30,33.3,33,54,61.11,13,18,72.2,6,24,30,27,9,1,14,14
1224,WAS,1,240,47,100,47,10,30,33.3,37,70,52.86,17,30,56.7,16,32,48,27,12,7,9,12
1225,MIA,1,240,37,90,41.1,9,25,36,28,65,43.08,24,27,88.9,13,43,56,16,8,3,14,16
1226,SAS,1,240,60,89,67.4,15,24,62.5,45,65,69.23,10,14,71.4,4,42,46,36,9,4,12,14
1227,ATL,0,240,45,95,47.4,15,42,35.7,30,53,56.6,13,17,76.5,5,32,37,23,11,7,16,20
1228,MEM,0,240,45,96,46.9,15,37,40.5,30,59,50.85,10,16,62.5,11,24,35,28,7,0,13,19
1229,CLE,1,240,50,96,52.1,11,29,37.9,39,67,58.21,10,12,83.3,7,36,43,19,8,6,23,16
1230,NYK,0,240,44,93,47.3,15,36,41.7,29,57,50.88,12,15,80,11,33,44,29,4,10,14,25
1231,IND,1,265,45,95,47.4,18,42,42.9,27,53,50.94,12,20,60,13,32,45,34,7,8,14,22
1232,POR,0,240,37,91,40.7,4,29,13.8,33,62,53.23,16,18,88.9,8,40,48,17,6,6,11,17
1233,DAL,0,240,35,90,38.9,15,46,32.6,20,44,45.45,22,27,81.5,14,39,53,27,6,4,17,22
1234,BOS,1,240,46,88,52.3,14,32,43.8,32,56,57.14,13,16,81.3,10,47,57,25,2,9,13,24
1235,TOR,1,240,37,94,39.4,10,34,29.4,27,60,45,26,31,83.9,14,37,51,21,12,5,12,21
1236,MIL,1,240,44,104,42.3,15,44,34.1,29,60,48.33,14,17,82.4,16,45,61,31,10,9,10,7
1237,LAC,0,240,40,86,46.5,11,27,40.7,29,59,49.15,21,24,87.5,10,32,42,22,7,2,17,23
1238,IND,0,240,37,100,37,12,40,30,25,60,41.67,3,5,60,10,38,48,27,7,5,13,15
1239,LAL,0,240,39,83,47,10,29,34.5,29,54,53.7,16,22,72.7,18,27,45,18,7,9,19,25
1240,OKC,1,240,46,97,47.4,9,27,33.3,37,70,52.86,17,20,85,16,33,49,24,10,4,12,20
1241,DEN,1,240,45,92,48.9,11,32,34.4,34,60,56.67,27,30,90,17,27,44,31,13,2,10,19
1242,CHA,0,240,33,82,40.2,10,34,29.4,23,48,47.92,17,23,73.9,2,25,27,26,3,5,6,17
1243,MEM,1,240,40,83,48.2,15,35,42.9,25,48,52.08,24,29,82.8,8,36,44,32,8,6,14,16
1244,PHI,1,240,49,94,52.1,14,33,42.4,35,61,57.38,13,21,61.9,16,37,53,28,7,4,14,26
1245,LAC,1,240,54,99,54.5,12,36,33.3,42,63,66.67,14,19,73.7,13,30,43,32,11,2,12,19
1246,MIN,0,240,38,87,43.7,15,37,40.5,23,50,46,15,16,93.8,7,32,39,16,8,8,17,18
1247,BKN,1,240,46,100,46,11,30,36.7,35,70,50,19,28,67.9,12,49,61,23,8,4,16,18
1248,MIL,1,240,41,85,48.2,18,43,41.9,23,42,54.76,23,35,65.7,8,44,52,26,9,14,19,16
1249,UTA,1,240,39,75,52,17,34,50,22,41,53.66,19,20,95,8,34,42,27,7,4,21,27
1250,ATL,0,240,39,105,37.1,11,48,22.9,28,57,49.12,23,27,85.2,14,38,52,17,7,5,10,22
1251,SAS,0,240,42,82,51.2,10,28,35.7,32,54,59.26,15,19,78.9,4,32,36,24,5,8,18,20
1252,WAS,0,240,36,88,40.9,7,31,22.6,29,57,50.88,29,34,85.3,7,31,38,18,7,3,11,21
1253,DET,0,240,40,87,46,16,35,45.7,24,52,46.15,11,12,91.7,6,23,29,30,14,4,16,20
1254,NYK,0,240,39,97,40.2,9,30,30,30,67,44.78,15,21,71.4,9,38,47,23,10,6,15,27
1255,CHI,1,240,40,77,51.9,18,35,51.4,22,42,52.38,21,25,84,11,35,46,21,8,4,21,13
1256,POR,1,240,40,94,42.6,13,35,37.1,27,59,45.76,20,25,80,12,33,45,19,9,13,15,21
1257,SAC,0,240,43,100,43,11,36,30.6,32,64,50,18,24,75,18,33,51,22,10,3,13,23
1258,HOU,1,240,51,87,58.6,19,41,46.3,32,46,69.57,18,23,78.3,5,32,37,23,4,5,10,23
1259,CHA,0,240,39,85,45.9,12,29,41.4,27,56,48.21,17,22,77.3,11,25,36,20,13,4,14,25
1260,PHX,0,240,47,91,51.6,8,28,28.6,39,63,61.9,23,30,76.7,10,31,41,26,5,1,10,18
1261,MIN,0,240,36,87,41.4,10,42,23.8,26,45,57.78,18,27,66.7,16,30,46,20,8,8,14,15
1262,NYK,0,240,41,94,43.6,10,34,29.4,31,60,51.67,22,33,66.7,13,28,41,23,11,2,8,25
1263,OKC,1,240,49,87,56.3,10,24,41.7,39,63,61.9,18,21,85.7,8,33,41,23,7,7,15,23
1264,NOP,0,240,39,93,41.9,9,34,26.5,30,59,50.85,15,23,65.2,13,35,48,23,8,5,18,19
1265,MIA,1,240,43,77,55.8,18,38,47.4,25,39,64.1,25,34,73.5,9,42,51,34,6,3,18,22
1266,CLE,1,240,40,92,43.5,17,37,45.9,23,55,41.82,17,23,73.9,16,44,60,26,4,10,16,12
1267,DEN,1,240,44,89,49.4,10,28,35.7,34,61,55.74,11,12,91.7,10,34,44,27,9,5,16,22
1268,PHX,0,240,38,87,43.7,11,32,34.4,27,55,49.09,21,23,91.3,12,25,37,26,9,4,16,29
1269,ORL,0,240,39,106,36.8,7,28,25,32,78,41.03,18,26,69.2,18,30,48,21,14,5,10,16
1270,GSW,1,240,36,83,43.4,10,33,30.3,26,50,52,24,25,96,10,37,47,25,10,4,18,24
1271,POR,1,240,42,84,50,17,36,47.2,25,48,52.08,17,19,89.5,11,43,54,16,4,11,21,24
1272,IND,1,240,45,86,52.3,14,31,45.2,31,55,56.36,15,18,83.3,7,32,39,34,5,7,9,15
1273,DAL,1,240,43,83,51.8,14,33,42.4,29,50,58,17,22,77.3,8,41,49,23,10,4,16,17
1274,DET,0,240,34,85,40,11,31,35.5,23,54,42.59,14,19,73.7,11,25,36,21,13,2,25,16
1275,BOS,1,240,45,86,52.3,9,27,33.3,36,59,61.02,15,21,71.4,13,38,51,24,13,9,20,19
1276,TOR,1,240,38,78,48.7,12,30,40,26,48,54.17,34,44,77.3,6,36,42,26,6,3,17,25
1277,MEM,0,240,44,102,43.1,14,41,34.1,30,61,49.18,5,7,71.4,10,36,46,31,9,8,7,17
1278,SAC,0,240,41,91,45.1,10,32,31.3,31,59,52.54,13,15,86.7,13,28,41,25,4,6,12,15
1279,PHI,0,240,38,90,42.2,10,34,29.4,28,56,50,12,18,66.7,11,35,46,25,9,2,15,16
1280,WAS,0,240,40,87,46,14,39,35.9,26,48,54.17,24,32,75,8,31,39,24,6,1,15,28
1281,ATL,0,240,39,90,43.3,11,29,37.9,28,61,45.9,17,19,89.5,6,34,40,24,8,1,16,27
1282,LAC,0,240,43,86,50,16,37,43.2,27,49,55.1,15,19,78.9,7,31,38,23,10,7,18,24
1283,BKN,0,240,35,83,42.2,7,36,19.4,28,47,59.57,28,30,93.3,6,41,47,16,9,3,18,21
1284,LAL,0,240,37,80,46.3,12,35,34.3,25,45,55.56,18,23,78.3,7,31,38,24,4,6,19,24
1285,UTA,1,240,39,83,47,6,24,25,33,59,55.93,27,38,71.1,13,40,53,18,8,6,19,17
1286,SAS,1,240,43,96,44.8,13,33,39.4,30,63,47.62,19,23,82.6,13,34,47,26,10,8,11,19
1287,HOU,1,240,43,86,50,14,37,37.8,29,49,59.18,22,29,75.9,10,33,43,23,9,4,18,20
1288,MIL,1,240,36,77,46.8,16,39,41,20,38,52.63,23,32,71.9,8,32,40,22,14,7,14,25
1289,CHA,0,240,37,91,40.7,13,37,35.1,24,54,44.44,11,18,61.1,15,20,35,25,12,3,9,20
1290,MEM,0,240,50,99,50.5,10,26,38.5,40,73,54.79,12,15,80,15,32,47,27,5,2,15,25
1291,DAL,0,240,34,87,39.1,15,43,34.9,19,44,43.18,20,25,80,10,32,42,23,7,10,8,20
1292,BOS,1,240,35,86,40.7,12,38,31.6,23,48,47.92,27,30,90,14,40,54,13,3,4,16,21
1293,CLE,1,240,40,74,54.1,7,26,26.9,33,48,68.75,13,17,76.5,10,38,48,25,7,3,25,21
1294,DEN,1,240,40,84,47.6,11,27,40.7,29,57,50.88,22,25,88,14,38,52,28,8,3,19,17
1295,CHI,1,265,39,97,40.2,11,37,29.7,28,60,46.67,21,24,87.5,11,42,53,25,10,6,15,24
1296,WAS,0,265,34,95,35.8,14,45,31.1,20,50,40,27,32,84.4,14,41,55,21,8,7,16,20
1297,GSW,0,240,41,103,39.8,16,38,42.1,25,65,38.46,14,23,60.9,17,33,50,24,7,7,8,23
1298,NOP,1,240,38,86,44.2,14,33,42.4,24,53,45.28,17,21,81,11,44,55,23,6,4,19,19
1299,MIA,1,240,40,85,47.1,12,31,38.7,28,54,51.85,16,20,80,11,36,47,26,6,4,16,14
1300,ORL,0,240,37,87,42.5,11,29,37.9,26,58,44.83,19,21,90.5,8,27,35,25,9,5,13,19
1301,OKC,1,240,46,84,54.8,7,24,29.2,39,60,65,27,34,79.4,6,29,35,25,6,6,12,16
1302,MIN,0,240,36,95,37.9,10,39,25.6,26,56,46.43,17,27,63,12,31,43,20,9,3,11,18
1303,PHI,0,240,38,90,42.2,12,39,30.8,26,51,50.98,16,18,88.9,15,26,41,24,9,5,13,17
1304,TOR,1,240,39,91,42.9,13,35,37.1,26,56,46.43,21,24,87.5,12,35,47,27,9,6,12,20
1305,POR,1,240,44,97,45.4,9,31,29,35,66,53.03,25,28,89.3,14,43,57,19,6,8,11,22
1306,DET,0,240,39,87,44.8,6,35,17.1,33,52,63.46,15,22,68.2,10,38,48,19,7,6,15,17
1307,IND,1,240,41,85,48.2,10,25,40,31,60,51.67,13,20,65,13,30,43,22,9,6,13,21
1308,LAC,1,240,45,89,50.6,14,32,43.8,31,57,54.39,16,22,72.7,6,38,44,23,14,4,16,15
1309,BKN,1,265,40,96,41.7,11,39,28.2,29,57,50.88,17,23,73.9,6,48,54,25,3,10,13,22
1310,ATL,0,240,45,99,45.5,15,43,34.9,30,56,53.57,15,20,75,9,27,36,20,7,3,11,21
1311,NYK,1,240,53,95,55.8,13,28,46.4,40,67,59.7,24,31,77.4,13,42,55,30,7,6,12,21
1312,ORL,0,240,42,93,45.2,7,35,20,35,58,60.34,11,15,73.3,4,37,41,21,6,5,3,18
1313,UTA,1,240,42,90,46.7,15,36,41.7,27,54,50,10,16,62.5,10,48,58,27,3,3,14,16
1314,LAL,0,240,43,91,47.3,8,31,25.8,35,60,58.33,8,17,47.1,14,28,42,28,5,6,13,19
1315,CHA,1,240,39,81,48.1,13,30,43.3,26,51,50.98,19,27,70.4,16,35,51,26,5,8,19,18
1316,PHX,0,240,41,102,40.2,10,35,28.6,31,67,46.27,7,10,70,16,34,50,30,11,3,20,23
1317,NOP,0,265,37,107,34.6,11,40,27.5,26,67,38.81,16,24,66.7,16,42,58,20,3,9,9,19
1318,SAC,0,240,38,91,41.8,14,39,35.9,24,52,46.15,12,13,92.3,10,23,33,23,10,5,10,22
1319,DET,0,240,41,86,47.7,13,39,33.3,28,47,59.57,24,34,70.6,12,24,36,29,6,4,14,19
1320,SAS,0,240,39,91,42.9,12,33,36.4,27,58,46.55,17,20,85,8,45,53,23,5,4,18,22
1321,WAS,1,240,49,88,55.7,18,34,52.9,31,54,57.41,17,21,81,7,28,35,31,6,5,16,27
1322,POR,1,240,40,84,47.6,14,34,41.2,26,50,52,17,20,85,9,32,41,21,9,9,20,27
1323,CLE,0,240,44,90,48.9,12,35,34.3,32,55,58.18,13,17,76.5,9,30,39,30,6,1,11,15
1324,CHI,0,240,43,87,49.4,9,31,29,34,56,60.71,11,13,84.6,5,26,31,27,17,6,14,21
1325,DAL,1,240,41,88,46.6,16,41,39,25,47,53.19,22,27,81.5,8,44,52,27,5,6,14,23
1326,TOR,1,240,52,89,58.4,16,32,50,36,57,63.16,13,17,76.5,6,35,41,31,7,2,7,19
1327,MEM,1,240,42,86,48.8,13,36,36.1,29,50,58,21,30,70,16,29,45,28,4,6,17,20
1328,OKC,1,240,35,69,50.7,16,34,47.1,19,35,54.29,23,28,82.1,9,33,42,21,8,6,26,15
1329,HOU,1,240,40,98,40.8,11,43,25.6,29,55,52.73,18,27,66.7,14,44,58,20,9,6,13,19
1330,MIA,0,240,37,81,45.7,11,24,45.8,26,57,45.61,26,31,83.9,7,28,35,22,9,7,14,26
1331,MIL,0,240,44,105,41.9,11,41,26.8,33,64,51.56,17,24,70.8,15,37,52,29,8,4,9,23
1332,PHX,0,240,41,90,45.6,12,34,35.3,29,56,51.79,16,19,84.2,11,33,44,31,11,5,21,21
1333,GSW,0,240,30,76,39.5,6,25,24,24,51,47.06,13,18,72.2,7,18,25,24,14,1,21,17
1334,PHI,0,240,37,86,43,5,26,19.2,32,60,53.33,10,17,58.8,7,31,38,19,9,13,16,20
1335,BKN,1,240,43,94,45.7,9,24,37.5,34,70,48.57,14,18,77.8,12,39,51,22,9,1,16,23
1336,ATL,0,240,31,86,36,12,42,28.6,19,44,43.18,22,25,88,8,34,42,18,8,5,20,27
1337,NOP,0,240,47,88,53.4,19,43,44.2,28,45,62.22,6,12,50,11,29,40,34,6,7,17,21
1338,ORL,1,240,46,89,51.7,17,34,50,29,55,52.73,21,26,80.8,8,31,39,32,8,2,10,15
1339,IND,1,240,40,88,45.5,10,35,28.6,30,53,56.6,17,20,85,8,43,51,30,6,9,9,25
1340,LAL,1,240,36,84,42.9,5,31,16.1,31,53,58.49,24,33,72.7,13,43,56,21,14,9,22,24
1341,SAC,1,240,38,63,60.3,10,22,45.5,28,41,68.29,14,16,87.5,4,34,38,27,9,3,29,20
1342,DEN,1,240,44,94,46.8,10,28,35.7,34,66,51.52,13,19,68.4,17,31,48,27,5,6,9,9
1343,NYK,0,240,44,94,46.8,8,32,25,36,62,58.06,9,10,90,14,33,47,20,9,2,11,19
1344,CHA,0,240,28,91,30.8,5,32,15.6,23,59,38.98,24,35,68.6,17,39,56,18,4,5,12,21
1345,MIL,1,240,46,85,54.1,14,37,37.8,32,48,66.67,19,26,73.1,8,33,41,26,12,6,12,17
1346,MEM,1,240,48,84,57.1,11,27,40.7,37,57,64.91,21,24,87.5,9,37,46,32,11,7,24,24
1347,TOR,1,240,38,98,38.8,14,40,35,24,58,41.38,20,25,80,10,41,51,21,10,10,11,23
1348,OKC,0,240,38,81,46.9,6,23,26.1,32,58,55.17,20,23,87,7,30,37,22,7,3,15,23
1349,DEN,1,240,43,85,50.6,7,27,25.9,36,58,62.07,17,23,73.9,10,34,44,30,6,3,16,23
1350,HOU,0,240,41,102,40.2,13,45,28.9,28,57,49.12,12,18,66.7,11,35,46,18,9,8,11,19
1351,SAS,1,265,44,106,41.5,8,30,26.7,36,76,47.37,25,34,73.5,10,52,62,23,6,9,11,22
1352,CHI,1,240,40,85,47.1,14,31,45.2,26,54,48.15,15,18,83.3,12,38,50,21,12,9,18,25
1353,DET,1,240,41,92,44.6,12,37,32.4,29,55,52.73,21,25,84,11,44,55,27,6,6,14,15
1354,PHX,0,265,45,103,43.7,10,40,25,35,63,55.56,19,26,73.1,6,53,59,29,5,5,10,24
1355,WAS,0,240,36,85,42.4,14,38,36.8,22,47,46.81,25,32,78.1,11,23,34,22,12,4,18,22
1356,LAC,0,240,35,80,43.8,10,22,45.5,25,58,43.1,26,36,72.2,8,32,40,20,9,4,15,17
1357,MIA,1,265,39,91,42.9,16,40,40,23,51,45.1,28,34,82.4,5,44,49,27,8,3,10,18
1358,CLE,0,240,41,90,45.6,15,35,42.9,26,55,47.27,11,15,73.3,12,33,45,27,10,3,18,19
1359,BKN,0,240,39,101,38.6,12,46,26.1,27,55,49.09,12,17,70.6,13,46,59,24,4,7,20,20
1360,DAL,0,265,45,101,44.6,17,44,38.6,28,57,49.12,11,17,64.7,8,40,48,30,4,3,11,27
1361,PHI,1,240,43,87,49.4,7,20,35,36,67,53.73,23,34,67.6,9,38,47,24,7,8,11,24
1362,HOU,1,240,48,86,55.8,22,39,56.4,26,47,55.32,12,13,92.3,7,35,42,21,5,7,9,20
1363,MIA,0,240,39,85,45.9,10,33,30.3,29,52,55.77,22,28,78.6,5,29,34,24,8,2,8,21
1364,NOP,0,240,38,88,43.2,9,24,37.5,29,64,45.31,24,35,68.6,12,33,45,24,5,2,9,29
1365,CHA,1,240,30,79,38,6,31,19.4,24,48,50,17,21,81,11,49,60,21,9,5,21,16
1366,MEM,0,240,38,98,38.8,20,49,40.8,18,49,36.73,18,23,78.3,11,34,45,27,9,5,13,26
1367,UTA,1,240,37,79,46.8,16,38,42.1,21,41,51.22,24,31,77.4,7,36,43,22,5,3,13,20
1368,SAC,0,240,39,83,47,17,39,43.6,22,44,50,6,8,75,8,33,41,19,0,3,14,18
1369,IND,1,240,46,92,50,7,22,31.8,39,70,55.71,11,15,73.3,6,40,46,28,7,0,15,21
1370,LAC,1,240,39,79,49.4,11,25,44,28,54,51.85,35,39,89.7,8,37,45,16,5,2,19,30
1371,ORL,0,240,40,91,44,15,37,40.5,25,54,46.3,12,16,75,13,24,37,24,3,6,7,15
1372,GSW,0,240,41,91,45.1,9,29,31,32,62,51.61,15,22,68.2,14,34,48,19,9,7,12,26
1373,ATL,0,240,39,94,41.5,6,28,21.4,33,66,50,16,23,69.6,12,38,50,24,6,4,15,20
1374,NYK,1,240,44,95,46.3,9,30,30,35,65,53.85,6,10,60,14,34,48,24,7,3,9,18
1375,MIL,1,240,44,87,50.6,11,30,36.7,33,57,57.89,28,33,84.8,9,46,55,22,4,3,17,21
1376,MIN,0,240,38,85,44.7,10,41,24.4,28,44,63.64,31,37,83.8,7,32,39,17,9,3,18,26
1377,LAL,1,240,43,87,49.4,12,37,32.4,31,50,62,15,23,65.2,14,36,50,26,5,9,19,23
1378,CHI,0,240,27,90,30,7,34,20.6,20,56,35.71,12,14,85.7,11,34,45,20,11,7,14,20
1379,DET,0,240,40,89,44.9,15,42,35.7,25,47,53.19,16,23,69.6,5,29,34,23,8,2,8,16
1380,SAS,0,265,42,86,48.8,5,16,31.3,37,70,52.86,20,25,80,2,34,36,19,11,7,12,21
1381,PHI,1,240,41,82,50,14,28,50,27,54,50,19,23,82.6,8,37,45,27,4,8,12,19
1382,POR,0,240,41,86,47.7,9,30,30,32,56,57.14,8,11,72.7,7,28,35,22,4,7,9,16
1383,DAL,1,240,45,88,51.1,16,44,36.4,29,44,65.91,16,23,69.6,11,41,52,25,4,5,11,21
1384,DEN,1,240,42,88,47.7,18,36,50,24,52,46.15,12,19,63.2,15,33,48,25,6,2,11,13
1385,CLE,1,265,44,96,45.8,15,45,33.3,29,51,56.86,14,20,70,11,39,50,22,6,3,19,22
1386,BOS,0,240,42,91,46.2,11,31,35.5,31,60,51.67,14,17,82.4,9,24,33,24,4,7,6,25
1387,BKN,0,240,38,88,43.2,10,38,26.3,28,50,56,22,33,66.7,17,35,52,20,5,3,12,21
1388,LAC,1,240,38,86,44.2,12,40,30,26,46,56.52,24,27,88.9,12,38,50,29,8,5,18,21
1389,SAC,1,240,39,88,44.3,10,31,32.3,29,57,50.88,6,10,60,6,35,41,12,8,3,16,21
1390,MIN,0,240,40,91,44,15,41,36.6,25,50,50,21,26,80.8,15,27,42,18,9,3,12,19
1391,IND,1,240,41,85,48.2,10,25,40,31,60,51.67,30,36,83.3,5,31,36,27,11,4,10,18
1392,ORL,0,240,34,81,42,8,26,30.8,26,55,47.27,11,17,64.7,8,33,41,20,10,5,15,17
1393,HOU,1,240,43,87,49.4,17,42,40.5,26,45,57.78,13,13,100,11,25,36,18,10,6,13,14
1394,NOP,0,240,39,88,44.3,16,45,35.6,23,43,53.49,18,22,81.8,7,35,42,29,8,5,21,17
1395,MEM,1,240,42,87,48.3,10,24,41.7,32,63,50.79,21,26,80.8,7,48,55,23,8,4,18,28
1396,UTA,1,240,47,83,56.6,16,35,45.7,31,48,64.58,17,22,77.3,11,34,45,23,4,7,16,22
1397,OKC,0,240,34,79,43,13,33,39.4,21,46,45.65,12,18,66.7,7,36,43,24,8,8,18,16
1398,TOR,0,240,31,88,35.2,8,36,22.2,23,52,44.23,22,25,88,15,32,47,21,10,8,18,24
1399,CLE,0,240,46,89,51.7,13,32,40.6,33,57,57.89,5,8,62.5,9,27,36,29,8,4,17,15
1400,MIL,1,240,50,93,53.8,19,39,48.7,31,54,57.41,8,9,88.9,5,38,43,27,13,2,15,17
1401,BOS,0,240,43,87,49.4,14,36,38.9,29,51,56.86,17,22,77.3,8,36,44,25,6,4,15,27
1402,CHI,1,240,54,94,57.4,11,24,45.8,43,70,61.43,17,19,89.5,7,35,42,32,15,7,13,25
1403,CHA,1,240,36,88,40.9,15,35,42.9,21,53,39.62,26,32,81.3,15,32,47,20,2,6,8,23
1404,PHX,0,240,37,93,39.8,9,34,26.5,28,59,47.46,25,30,83.3,8,36,44,29,6,4,12,20
1405,ATL,0,240,35,83,42.2,13,38,34.2,22,45,48.89,19,26,73.1,10,31,41,26,7,5,23,20
1406,GSW,0,265,45,104,43.3,10,37,27,35,67,52.24,22,30,73.3,14,32,46,27,10,6,8,25
1407,NYK,1,265,43,90,47.8,12,29,41.4,31,61,50.82,26,34,76.5,12,46,58,25,5,7,19,24
1408,LAL,1,240,37,87,42.5,12,31,38.7,25,56,44.64,10,19,52.6,12,37,49,20,10,4,14,17
1409,ATL,0,265,45,95,47.4,20,54,37,25,41,60.98,11,18,61.1,4,33,37,30,4,6,12,23
1410,NYK,0,240,32,91,35.2,7,38,18.4,25,53,47.17,16,26,61.5,11,36,47,16,5,3,11,18
1411,POR,1,240,39,90,43.3,17,41,41.5,22,49,44.9,20,24,83.3,11,47,58,20,6,7,12,21
1412,WAS,0,240,38,90,42.2,11,35,31.4,27,55,49.09,20,25,80,13,32,45,27,7,7,10,24
1413,CHA,1,240,38,85,44.7,16,41,39,22,44,50,22,28,78.6,11,37,48,22,4,4,13,26
1414,MIA,1,265,53,103,51.5,14,41,34.1,39,62,62.9,15,22,68.2,9,44,53,35,5,3,12,17
1415,PHI,1,240,37,89,41.6,12,36,33.3,25,53,47.17,11,16,68.8,12,37,49,24,9,3,17,15
1416,DEN,0,240,37,85,43.5,7,27,25.9,30,58,51.72,11,12,91.7,5,33,38,29,12,9,14,14
1417,ORL,0,240,35,92,38,10,31,32.3,25,61,40.98,21,26,80.8,9,35,44,24,8,10,12,18
1418,SAC,1,240,40,88,45.5,20,45,44.4,20,43,46.51,19,22,86.4,9,28,37,24,14,5,10,17
1419,OKC,1,240,40,85,47.1,8,28,28.6,32,57,56.14,16,19,84.2,2,44,46,21,9,7,11,20
1420,MIN,0,240,40,85,47.1,6,22,27.3,34,63,53.97,23,29,79.3,11,34,45,14,6,7,17,23
1421,BOS,1,240,45,78,57.7,15,27,55.6,30,51,58.82,5,8,62.5,5,34,39,22,8,9,18,19
1422,LAC,1,240,40,97,41.2,10,32,31.3,30,65,46.15,20,27,74.1,11,45,56,19,7,7,11,16
1423,PHX,1,240,47,95,49.5,16,40,40,31,55,56.36,15,19,78.9,12,30,42,31,5,5,9,23
1424,IND,0,240,34,97,35.1,10,35,28.6,24,62,38.71,21,28,75,14,42,56,16,7,3,13,21
1425,CLE,0,240,36,91,39.6,7,31,22.6,29,60,48.33,9,19,47.4,18,27,45,18,8,2,18,11
1426,CHI,0,240,35,89,39.3,12,46,26.1,23,43,53.49,10,14,71.4,9,36,45,30,6,4,17,20
1427,HOU,0,240,41,84,48.8,17,50,34,24,34,70.59,19,23,82.6,11,40,51,25,4,6,19,20
1428,DET,1,240,36,85,42.4,11,35,31.4,25,50,50,22,27,81.5,10,36,46,15,6,3,19,20
1429,MIL,1,240,43,92,46.7,16,41,39,27,51,52.94,8,15,53.3,10,44,54,30,7,4,15,19
1430,TOR,1,240,34,90,37.8,7,29,24.1,27,61,44.26,18,26,69.2,14,40,54,19,8,9,17,12
1431,NOP,0,240,40,91,44,8,38,21.1,32,53,60.38,15,22,68.2,10,35,45,24,6,1,15,22
1432,UTA,0,240,36,89,40.4,8,31,25.8,28,58,48.28,10,12,83.3,7,41,48,19,7,0,15,16
1433,GSW,0,240,35,93,37.6,11,27,40.7,24,66,36.36,21,25,84,10,36,46,23,10,6,16,21
1434,MEM,1,240,41,82,50,15,40,37.5,26,42,61.9,13,17,76.5,1,41,42,29,13,6,20,20
1435,ATL,1,240,44,91,48.4,18,45,40,26,46,56.52,16,17,94.1,11,37,48,28,8,8,14,24
1436,MIA,1,265,32,77,41.6,11,35,31.4,21,42,50,35,44,79.5,10,33,43,20,9,2,17,23
1437,POR,0,240,36,100,36,9,33,27.3,27,67,40.3,15,18,83.3,18,33,51,16,7,8,8,26
1438,SAC,1,240,44,85,51.8,13,34,38.2,31,51,60.78,9,11,81.8,7,28,35,24,7,1,11,16
1439,TOR,0,240,38,88,43.2,11,33,33.3,27,55,49.09,17,20,85,13,29,42,21,13,4,18,22
1440,WAS,0,240,40,88,45.5,14,33,42.4,26,55,47.27,25,30,83.3,8,30,38,28,5,3,14,22
1441,LAC,1,240,50,96,52.1,15,40,37.5,35,56,62.5,20,27,74.1,9,36,45,27,8,4,12,26
1442,LAL,1,240,55,94,58.5,14,31,45.2,41,63,65.08,18,20,90,10,31,41,32,9,1,11,19
1443,BKN,1,240,40,87,46,7,28,25,33,59,55.93,18,23,78.3,10,38,48,25,5,1,13,15
1444,CHA,0,240,36,90,40,11,31,35.5,25,59,42.37,24,29,82.8,13,31,44,22,8,3,11,17
1445,DEN,0,240,36,89,40.4,18,42,42.9,18,47,38.3,12,14,85.7,7,30,37,25,4,5,13,23
1446,PHI,1,240,40,79,50.6,14,32,43.8,26,47,55.32,16,21,76.2,6,34,40,31,7,5,21,18
1447,DAL,0,240,41,86,47.7,17,44,38.6,24,42,57.14,7,8,87.5,10,30,40,24,3,1,13,11
1448,MIN,0,240,44,84,52.4,15,37,40.5,29,47,61.7,22,26,84.6,6,25,31,27,5,6,16,18
1449,OKC,1,240,35,85,41.2,11,32,34.4,24,53,45.28,27,34,79.4,13,41,54,12,7,2,10,22
1450,CHI,0,265,35,80,43.8,13,36,36.1,22,44,50,22,27,81.5,6,33,39,20,8,1,15,31
1451,NYK,0,240,39,96,40.6,10,31,32.3,29,65,44.62,15,21,71.4,15,37,52,24,11,6,11,14
1452,PHI,1,240,57,90,63.3,11,26,42.3,46,64,71.88,16,23,69.6,10,41,51,43,13,8,8,16
1453,HOU,1,240,41,91,45.1,11,40,27.5,30,51,58.82,22,30,73.3,10,41,51,21,10,7,16,28
1454,DAL,1,240,46,86,53.5,13,38,34.2,33,48,68.75,25,31,80.6,8,47,55,25,8,4,13,17
1455,MEM,0,240,43,81,53.1,10,35,28.6,33,46,71.74,16,25,64,5,23,28,23,15,3,14,19
1456,CLE,0,240,36,96,37.5,9,35,25.7,27,61,44.26,13,17,76.5,11,24,35,20,4,0,18,17
1457,IND,1,240,41,85,48.2,12,28,42.9,29,57,50.88,10,13,76.9,5,37,42,26,7,9,17,17
1458,PHX,0,240,40,96,41.7,11,35,31.4,29,61,47.54,18,28,64.3,13,38,51,29,4,3,16,25
1459,UTA,1,240,45,80,56.3,19,34,55.9,26,46,56.52,17,18,94.4,9,32,41,32,8,0,22,25
1460,NOP,0,240,32,89,36,3,32,9.4,29,57,50.88,17,21,81,8,26,34,17,4,2,15,23
1461,MIA,1,240,42,86,48.8,10,28,35.7,32,58,55.17,18,24,75,11,39,50,28,6,7,14,13
1462,CHI,0,240,39,88,44.3,17,41,41.5,22,47,46.81,3,5,60,10,27,37,21,11,2,15,20
1463,WAS,0,240,39,91,42.9,12,39,30.8,27,52,51.92,13,14,92.9,9,30,39,29,6,4,11,20
1464,POR,0,240,39,86,45.3,10,34,29.4,29,52,55.77,25,29,86.2,4,30,34,20,9,4,15,25
1465,BOS,1,240,44,82,53.7,13,35,37.1,31,47,65.96,7,8,87.5,4,33,37,21,5,5,16,23
1466,CHA,0,240,36,83,43.4,17,40,42.5,19,43,44.19,15,17,88.2,10,24,34,23,6,6,19,16
1467,SAC,0,265,40,102,39.2,9,34,26.5,31,68,45.59,15,18,83.3,16,36,52,19,10,3,15,20
1468,DET,1,240,39,87,44.8,11,25,44,28,62,45.16,19,26,73.1,14,37,51,21,7,5,18,17
1469,LAC,0,240,33,94,35.1,8,32,25,25,62,40.32,17,19,89.5,12,36,48,18,9,4,21,19
1470,GSW,1,240,38,71,53.5,9,24,37.5,29,47,61.7,15,22,68.2,6,33,39,24,9,4,20,19
1471,MIN,0,265,50,96,52.1,13,38,34.2,37,58,63.79,14,20,70,10,26,36,25,8,2,13,29
1472,LAL,1,240,46,85,54.1,17,36,47.2,29,49,59.18,27,33,81.8,3,42,45,26,10,8,19,23
1473,SAS,1,265,41,96,42.7,11,32,34.4,30,64,46.88,12,17,70.6,13,39,52,25,10,5,16,16
1474,OKC,1,265,49,88,55.7,5,18,27.8,44,70,62.86,36,40,90,9,30,39,19,8,9,10,20
1475,DEN,0,240,39,94,41.5,5,30,16.7,34,64,53.12,12,15,80,12,29,41,18,5,4,14,15
1476,CLE,0,240,35,83,42.2,10,34,29.4,25,49,51.02,7,10,70,10,35,45,22,9,7,18,19
1477,MIL,1,240,44,94,46.8,14,36,38.9,30,58,51.72,17,21,81,13,40,53,29,11,6,16,23
1478,BKN,1,240,42,88,47.7,15,38,39.5,27,50,54,12,15,80,15,34,49,35,12,5,18,21
1479,IND,0,240,38,83,45.8,9,24,37.5,29,59,49.15,16,20,80,5,28,33,24,8,9,12,18
1480,ORL,1,240,32,82,39,9,26,34.6,23,56,41.07,20,23,87,10,33,43,19,10,9,17,13
1481,NYK,0,240,34,83,41,9,34,26.5,25,49,51.02,15,23,65.2,5,28,33,23,9,7,14,16
1482,PHX,1,265,50,106,47.2,14,36,38.9,36,70,51.43,25,27,92.6,19,32,51,30,16,6,18,29
1483,TOR,0,240,38,88,43.2,12,39,30.8,26,49,53.06,21,24,87.5,12,33,45,27,14,5,18,21
1484,NOP,0,265,44,87,50.6,17,41,41.5,27,46,58.7,27,35,77.1,6,34,40,27,13,9,24,29
1485,DEN,1,240,49,87,56.3,21,39,53.8,28,48,58.33,10,18,55.6,9,39,48,38,8,5,14,19
1486,HOU,1,240,40,98,40.8,22,55,40,18,43,41.86,17,19,89.5,20,34,54,29,11,2,23,24
1487,PHI,0,240,41,77,53.2,13,28,46.4,28,49,57.14,18,24,75,8,36,44,25,7,6,21,24
1488,WAS,1,240,41,90,45.6,11,27,40.7,30,63,47.62,26,32,81.3,13,28,41,25,9,1,12,20
1489,BKN,1,240,50,101,49.5,14,31,45.2,36,70,51.43,16,18,88.9,18,35,53,26,8,6,15,20
1490,MIN,0,240,37,89,41.6,17,38,44.7,20,51,39.22,23,26,88.5,15,29,44,23,5,7,13,21
1491,ORL,1,240,49,85,57.6,14,25,56,35,60,58.33,16,20,80,11,34,45,27,9,7,19,19
1492,CHI,1,240,33,77,42.9,13,33,39.4,20,44,45.45,27,37,73,10,40,50,22,5,13,21,22
1493,UTA,0,240,34,83,41,14,31,45.2,20,52,38.46,14,19,73.7,8,32,40,20,3,3,20,24
1494,MEM,0,240,37,96,38.5,7,30,23.3,30,66,45.45,18,21,85.7,11,35,46,24,14,6,14,28
1495,OKC,0,240,41,84,48.8,9,26,34.6,32,58,55.17,9,10,90,8,29,37,25,3,5,13,19
1496,DAL,1,240,46,92,50,11,37,29.7,35,55,63.64,18,23,78.3,13,32,45,24,5,5,9,16
1497,ATL,0,240,48,90,53.3,9,26,34.6,39,64,60.94,13,21,61.9,9,26,35,24,8,9,16,19
1498,CHA,1,240,40,87,46,21,48,43.8,19,39,48.72,5,8,62.5,11,33,44,30,11,7,15,20
1499,DET,0,240,39,93,41.9,11,36,30.6,28,57,49.12,14,22,63.6,9,31,40,25,5,3,12,19
1500,LAL,1,240,46,90,51.1,14,29,48.3,32,61,52.46,15,25,60,8,38,46,27,13,12,8,17
1501,GSW,0,240,36,78,46.2,9,23,39.1,27,55,49.09,10,15,66.7,6,31,37,18,7,3,16,12
1502,BOS,1,240,35,79,44.3,16,41,39,19,38,50,26,32,81.3,10,36,46,21,8,8,11,20
1503,SAC,0,240,44,95,46.3,11,34,32.4,33,61,54.1,17,23,73.9,13,31,44,26,7,7,10,17
1504,PHX,0,240,43,88,48.9,15,33,45.5,28,55,50.91,13,20,65,8,21,29,36,10,0,13,20
1505,MIL,1,240,44,90,48.9,14,35,40,30,55,54.55,25,27,92.6,10,45,55,25,7,8,16,18
1506,POR,1,240,47,84,56,16,32,50,31,52,59.62,17,21,81,6,37,43,28,6,10,12,18
1507,MIA,0,240,34,77,44.2,14,38,36.8,20,39,51.28,11,17,64.7,8,32,40,20,7,2,19,25
1508,IND,1,240,42,87,48.3,9,24,37.5,33,63,52.38,14,17,82.4,11,28,39,19,5,1,9,21
1509,DAL,1,240,38,88,43.2,19,45,42.2,19,43,44.19,23,27,85.2,10,41,51,22,5,8,12,14
1510,LAL,1,240,39,84,46.4,7,24,29.2,32,60,53.33,20,30,66.7,14,42,56,24,8,5,16,23
1511,MIA,1,265,45,99,45.5,15,38,39.5,30,61,49.18,16,21,76.2,10,45,55,29,4,7,14,27
1512,LAC,1,240,43,94,45.7,17,34,50,26,60,43.33,14,25,56,11,38,49,25,7,3,11,15
1513,CLE,0,240,38,90,42.2,8,27,29.6,30,63,47.62,10,14,71.4,12,28,40,16,6,6,14,11
1514,NOP,0,240,38,94,40.4,11,41,26.8,27,53,50.94,10,15,66.7,9,38,47,20,4,4,11,19
1515,POR,0,240,39,91,42.9,7,27,25.9,32,64,50,12,15,80,12,37,49,20,5,6,13,23
1516,WAS,0,240,45,89,50.6,12,35,34.3,33,54,61.11,18,23,78.3,5,33,38,22,9,3,10,23
1517,DEN,0,240,37,91,40.7,6,29,20.7,31,62,50,16,17,94.1,7,28,35,26,9,4,11,25
1518,SAS,1,290,50,106,47.2,13,30,43.3,37,76,48.68,22,32,68.8,12,44,56,35,10,8,21,27
1519,DET,1,240,51,94,54.3,18,35,51.4,33,59,55.93,7,11,63.6,10,36,46,33,11,7,11,16
1520,TOR,0,265,35,91,38.5,11,43,25.6,24,48,50,29,36,80.6,9,39,48,25,5,4,12,20
1521,ORL,1,240,46,90,51.1,15,31,48.4,31,59,52.54,20,27,74.1,8,40,48,26,3,4,13,18
1522,HOU,0,290,42,111,37.8,15,51,29.4,27,60,45,34,36,94.4,18,42,60,22,11,7,17,30
1523,ATL,1,240,41,89,46.1,8,29,27.6,33,60,55,14,15,93.3,11,27,38,21,13,4,15,12
1524,MEM,0,240,38,89,42.7,10,38,26.3,28,51,54.9,18,19,94.7,8,30,38,23,5,6,12,20
1525,IND,1,240,44,88,50,16,38,42.1,28,50,56,13,15,86.7,8,36,44,31,4,2,15,22
1526,UTA,0,240,38,81,46.9,5,22,22.7,33,59,55.93,13,20,65,5,37,42,23,6,8,20,26
1527,CHA,0,240,38,84,45.2,7,25,28,31,59,52.54,21,26,80.8,14,39,53,27,4,7,19,23
1528,PHX,1,240,39,88,44.3,9,42,21.4,30,46,65.22,22,30,73.3,9,28,37,30,12,7,8,21
1529,PHI,1,240,37,91,40.7,13,26,50,24,65,36.92,16,23,69.6,8,39,47,24,12,3,15,22
1530,MIL,1,240,48,86,55.8,16,35,45.7,32,51,62.75,20,32,62.5,10,47,57,30,7,4,14,23
1531,SAC,0,240,40,83,48.2,9,33,27.3,31,50,62,17,20,85,10,31,41,22,7,5,18,26
1532,GSW,0,240,33,83,39.8,3,17,17.6,30,66,45.45,10,12,83.3,18,28,46,17,11,8,25,20
1533,CHI,1,240,36,75,48,16,37,43.2,20,38,52.63,25,29,86.2,3,29,32,20,9,0,18,20
1534,NYK,0,240,28,91,30.8,10,39,25.6,18,52,34.62,22,33,66.7,14,28,42,13,4,7,10,21
1535,WAS,0,240,47,102,46.1,11,30,36.7,36,72,50,20,27,74.1,12,31,43,32,10,1,14,29
1536,GSW,0,240,36,91,39.6,6,23,26.1,30,68,44.12,18,23,78.3,15,31,46,21,6,5,12,17
1537,OKC,1,240,38,81,46.9,11,33,33.3,27,48,56.25,20,26,76.9,5,42,47,19,5,3,11,14
1538,NOP,0,240,39,87,44.8,17,38,44.7,22,49,44.9,9,10,90,3,38,41,22,6,7,11,22
1539,MIN,0,240,33,85,38.8,11,36,30.6,22,49,44.9,30,35,85.7,10,43,53,22,7,6,16,21
1540,BOS,1,240,41,93,44.1,15,41,36.6,26,52,50,16,22,72.7,16,28,44,25,5,7,14,28
1541,MIA,1,240,37,95,38.9,12,37,32.4,25,58,43.1,23,28,82.1,16,35,51,16,3,2,9,17
1542,BKN,0,240,40,91,44,14,42,33.3,26,49,53.06,12,16,75,9,39,48,24,3,5,12,21
1543,ORL,1,240,37,87,42.5,11,33,33.3,26,54,48.15,15,22,68.2,12,36,48,21,7,8,15,20
1544,NYK,0,240,35,76,46.1,8,26,30.8,27,50,54,26,37,70.3,8,31,39,15,7,6,16,25
1545,MEM,1,240,41,100,41,16,40,40,25,60,41.67,17,21,81,12,38,50,27,8,3,11,26
1546,TOR,1,240,47,90,52.2,19,36,52.8,28,54,51.85,17,21,81,7,36,43,36,14,8,14,24
1547,LAC,1,240,52,94,55.3,14,32,43.8,38,62,61.29,32,40,80,10,42,52,22,8,5,17,25
1548,DAL,1,240,42,97,43.3,17,49,34.7,25,48,52.08,13,18,72.2,16,35,51,24,11,1,13,20
1549,UTA,0,240,38,90,42.2,13,35,37.1,25,55,45.45,21,29,72.4,15,36,51,21,5,3,18,17
1550,SAS,0,240,36,88,40.9,7,26,26.9,29,62,46.77,19,22,86.4,7,24,31,20,11,6,8,15
1551,DET,1,240,52,88,59.1,15,31,48.4,37,57,64.91,13,18,72.2,11,39,50,33,5,5,17,14
1552,LAL,0,240,40,87,46,7,27,25.9,33,60,55,13,16,81.3,9,36,45,25,9,3,17,14
1553,SAC,1,265,37,96,38.5,8,33,24.2,29,63,46.03,18,21,85.7,13,37,50,22,12,4,16,23
1554,MIL,1,240,54,96,56.3,20,44,45.5,34,52,65.38,9,15,60,7,46,53,41,7,3,7,13
1555,HOU,1,240,52,89,58.4,25,51,49,27,38,71.05,29,34,85.3,13,39,52,30,9,2,15,23
1556,CHA,0,240,37,101,36.6,15,45,33.3,22,56,39.29,7,8,87.5,15,38,53,21,4,1,12,18
1557,ATL,0,240,38,89,42.7,15,46,32.6,23,43,53.49,20,25,80,8,21,29,26,5,2,14,23
1558,IND,0,240,42,76,55.3,11,22,50,31,54,57.41,21,25,84,3,28,31,22,7,3,20,24
1559,PHI,1,240,38,77,49.4,11,23,47.8,27,54,50,32,36,88.9,4,28,32,27,12,5,14,16
1560,DEN,0,265,36,87,41.4,11,32,34.4,25,55,45.45,14,21,66.7,9,39,48,23,11,5,17,21
1561,CLE,0,240,44,88,50,17,34,50,27,54,50,5,10,50,8,33,41,32,7,1,15,22
1562,POR,1,240,38,84,45.2,10,30,33.3,28,54,51.85,21,28,75,8,41,49,20,6,11,13,21
1563,MIA,1,240,44,82,53.7,13,25,52,31,57,54.39,21,28,75,10,39,49,23,7,3,16,30
1564,MEM,0,240,37,94,39.4,10,34,29.4,27,60,45,10,17,58.8,15,40,55,22,1,8,12,17
1565,BKN,1,240,43,93,46.2,17,41,41.5,26,52,50,9,13,69.2,13,36,49,30,9,6,20,24
1566,ATL,0,265,39,90,43.3,9,32,28.1,30,58,51.72,17,18,94.4,10,38,48,14,10,3,24,27
1567,ORL,0,240,27,78,34.6,7,29,24.1,20,49,40.82,22,27,81.5,13,39,52,17,10,11,24,19
1568,GSW,0,240,30,77,39,10,28,35.7,20,49,40.82,35,40,87.5,5,26,31,19,4,3,9,23
1569,SAS,1,240,40,93,43,14,36,38.9,26,57,45.61,13,14,92.9,8,40,48,28,8,8,11,15
1570,OKC,1,240,43,90,47.8,13,34,38.2,30,56,53.57,10,16,62.5,6,36,42,27,6,8,11,17
1571,PHI,1,240,31,72,43.1,7,26,26.9,24,46,52.17,32,40,80,8,38,46,22,5,10,16,23
1572,TOR,1,240,31,84,36.9,11,38,28.9,20,46,43.48,17,28,60.7,11,35,46,21,16,4,14,20
1573,PHX,0,240,41,93,44.1,13,38,34.2,28,55,50.91,18,25,72,11,36,47,29,3,3,10,29
1574,BOS,0,240,41,93,44.1,9,28,32.1,32,65,49.23,16,21,76.2,16,32,48,16,11,7,19,14
1575,DAL,1,240,35,85,41.2,17,47,36.2,18,38,47.37,33,38,86.8,9,38,47,20,7,3,8,24
1576,UTA,1,240,38,95,40,12,35,34.3,26,60,43.33,15,19,78.9,11,41,52,18,8,2,7,15
1577,LAC,0,240,36,92,39.1,12,33,36.4,24,59,40.68,13,13,100,9,39,48,23,6,5,15,17
1578,MIL,1,240,45,88,51.1,12,34,35.3,33,54,61.11,17,23,73.9,11,36,47,28,7,4,13,15
1579,CHI,0,240,36,94,38.3,14,38,36.8,22,56,39.29,17,25,68,11,36,47,24,8,2,11,22
1580,IND,1,265,39,92,42.4,6,26,23.1,33,66,50,21,28,75,9,33,42,19,12,6,16,20
1581,CHA,1,240,40,83,48.2,19,38,50,21,45,46.67,11,15,73.3,11,26,37,26,8,6,10,17
1582,NOP,0,240,39,87,44.8,11,38,28.9,28,49,57.14,15,21,71.4,7,37,44,19,8,3,14,12
1583,LAL,1,240,45,87,51.7,14,32,43.8,31,55,56.36,21,28,75,7,40,47,29,9,8,19,20
1584,NYK,0,240,34,78,43.6,8,20,40,26,58,44.83,19,33,57.6,9,28,37,14,5,4,14,33
1585,WAS,0,240,38,96,39.6,10,37,27,28,59,47.46,17,19,89.5,13,32,45,25,10,2,19,23
1586,DET,0,240,41,83,49.4,15,35,42.9,26,48,54.17,10,20,50,14,31,45,27,5,4,14,16
1587,LAL,1,240,44,85,51.8,8,24,33.3,36,61,59.02,18,25,72,7,30,37,25,9,6,16,24
1588,POR,1,240,49,94,52.1,14,30,46.7,35,64,54.69,24,24,100,10,44,54,23,3,1,9,32
1589,MIL,1,240,42,88,47.7,10,34,29.4,32,54,59.26,17,27,63,10,37,47,25,6,11,14,23
1590,LAC,1,240,44,95,46.3,14,41,34.1,30,54,55.56,19,25,76,13,30,43,30,11,6,16,24
1591,BKN,0,240,40,90,44.4,21,56,37.5,19,34,55.88,9,19,47.4,11,27,38,32,5,6,17,22
1592,CLE,0,240,37,81,45.7,11,34,32.4,26,47,55.32,19,22,86.4,12,37,49,20,5,0,25,15
1593,ORL,1,240,45,93,48.4,12,33,36.4,33,60,55,14,17,82.4,6,28,34,23,13,6,11,22
1594,DET,0,240,41,88,46.6,10,32,31.3,31,56,55.36,9,15,60,9,37,46,23,2,2,9,18
1595,GSW,1,240,37,81,45.7,11,29,37.9,26,52,50,19,26,73.1,13,41,54,31,12,9,21,17
1596,MIN,1,240,37,85,43.5,18,40,45,19,45,42.22,21,27,77.8,7,46,53,28,4,6,11,19
1597,SAS,0,240,41,97,42.3,5,29,17.2,36,68,52.94,14,17,82.4,8,38,46,25,4,8,6,18
1598,CHA,1,240,39,88,44.3,7,30,23.3,32,58,55.17,17,20,85,10,31,41,27,3,7,4,18
1599,NOP,0,240,34,84,40.5,17,40,42.5,17,44,38.64,25,30,83.3,13,29,42,20,7,4,20,23
1600,UTA,0,240,36,83,43.4,10,32,31.3,26,51,50.98,20,25,80,10,30,40,19,7,2,16,21
1601,ATL,0,240,38,94,40.4,11,34,32.4,27,60,45,15,22,68.2,14,35,49,22,4,5,19,25
1602,PHI,1,240,36,77,46.8,5,26,19.2,31,51,60.78,20,24,83.3,7,42,49,20,8,10,17,12
1603,BOS,1,240,43,97,44.3,13,34,38.2,30,63,47.62,22,24,91.7,19,36,55,23,10,5,14,17
1604,IND,1,240,50,96,52.1,8,22,36.4,42,74,56.76,13,16,81.3,11,31,42,23,8,4,12,19
1605,PHX,0,240,48,93,51.6,15,38,39.5,33,55,60,21,24,87.5,12,28,40,29,7,6,15,21
1606,OKC,0,240,39,88,44.3,11,35,31.4,28,53,52.83,30,38,78.9,8,30,38,19,4,2,6,21
1607,TOR,1,240,46,94,48.9,21,41,51.2,25,53,47.17,13,17,76.5,17,35,52,26,6,4,12,18
1608,HOU,1,240,38,83,45.8,15,44,34.1,23,39,58.97,26,33,78.8,9,34,43,19,11,2,15,22
1609,SAC,0,240,39,95,41.1,9,34,26.5,30,61,49.18,4,9,44.4,8,34,42,22,9,3,11,19
1610,CHI,0,240,34,89,38.2,10,29,34.5,24,60,40,12,18,66.7,14,28,42,20,14,4,18,20
1611,MEM,0,240,43,92,46.7,11,28,39.3,32,64,50,22,26,84.6,13,35,48,26,9,3,20,22
1612,MIA,0,240,37,80,46.3,14,37,37.8,23,43,53.49,20,27,74.1,8,33,41,22,8,3,19,24
1613,WAS,1,240,51,89,57.3,19,35,54.3,32,54,59.26,19,20,95,4,30,34,32,9,5,16,20
1614,NYK,0,240,33,88,37.5,12,41,29.3,21,47,44.68,20,24,83.3,15,30,45,19,6,4,18,17
1615,WAS,0,240,40,95,42.1,10,40,25,30,55,54.55,14,21,66.7,5,31,36,26,9,3,12,22
1616,DEN,1,240,47,90,52.2,6,24,25,41,66,62.12,17,23,73.9,10,48,58,31,8,6,21,20
1617,DAL,0,240,30,79,38,11,38,28.9,19,41,46.34,28,35,80,9,37,46,16,12,2,20,21
1618,LAC,1,240,41,97,42.3,11,33,33.3,30,64,46.88,21,30,70,17,39,56,22,12,3,14,27
1619,CLE,0,240,40,94,42.6,13,32,40.6,27,62,43.55,13,20,65,12,33,45,24,5,4,12,14
1620,DET,1,240,34,79,43,14,38,36.8,20,41,48.78,21,25,84,9,40,49,23,6,5,15,20
1621,MIN,1,240,41,90,45.6,15,35,42.9,26,55,47.27,28,36,77.8,14,33,47,27,10,6,14,25
1622,ATL,0,240,41,94,43.6,10,32,31.3,31,62,50,21,26,80.8,9,33,42,26,6,4,18,25
1623,POR,1,240,46,89,51.7,8,27,29.6,38,62,61.29,17,22,77.3,13,42,55,23,8,5,15,20
1624,ORL,0,240,32,84,38.1,8,25,32,24,59,40.68,16,22,72.7,8,33,41,15,8,7,10,21
1625,GSW,0,240,37,89,41.6,9,20,45,28,69,40.58,14,16,87.5,9,32,41,27,10,7,13,17
1626,TOR,1,240,38,84,45.2,11,34,32.4,27,50,54,14,22,63.6,8,32,40,27,5,5,10,18
1627,BOS,1,240,38,85,44.7,7,30,23.3,31,55,56.36,20,23,87,11,27,38,20,10,4,12,16
1628,LAL,1,240,44,89,49.4,14,33,42.4,30,56,53.57,12,18,66.7,10,30,40,28,7,6,9,18
1629,CHI,0,240,36,86,41.9,9,39,23.1,27,47,57.45,13,20,65,8,29,37,24,8,4,17,20
1630,IND,1,240,51,94,54.3,18,33,54.5,33,61,54.1,6,10,60,10,37,47,29,6,6,13,11
1631,MIA,1,240,40,77,51.9,13,31,41.9,27,46,58.7,24,28,85.7,8,41,49,29,9,3,19,23
1632,OKC,1,240,40,85,47.1,11,32,34.4,29,53,54.72,9,11,81.8,9,34,43,26,5,13,16,16
1633,BKN,1,240,44,94,46.8,11,34,32.4,33,60,55,9,11,81.8,12,36,48,29,8,10,10,21
1634,SAC,0,240,37,79,46.8,18,47,38.3,19,32,59.38,10,15,66.7,8,28,36,28,3,8,17,18
1635,SAS,0,240,41,88,46.6,10,25,40,31,63,49.21,12,15,80,9,32,41,23,4,5,13,22
1636,CHA,0,240,36,87,41.4,9,33,27.3,27,54,50,19,25,76,10,25,35,25,11,0,14,24
1637,MIL,1,240,43,97,44.3,13,41,31.7,30,56,53.57,23,29,79.3,15,34,49,21,6,6,9,15
1638,PHI,0,240,36,88,40.9,15,40,37.5,21,48,43.75,9,16,56.3,14,37,51,25,7,3,16,20
1639,MEM,0,240,46,96,47.9,13,29,44.8,33,67,49.25,9,13,69.2,8,32,40,30,6,5,9,16
1640,UTA,0,240,43,85,50.6,21,45,46.7,22,40,55,11,12,91.7,4,36,40,29,4,6,17,23
1641,NYK,0,240,37,80,46.3,18,35,51.4,19,45,42.22,9,16,56.3,9,34,43,22,6,4,19,29
1642,LAC,1,240,46,98,46.9,16,43,37.2,30,55,54.55,26,33,78.8,16,40,56,27,4,5,8,21
1643,SAC,1,240,39,81,48.1,11,31,35.5,28,50,56,24,28,85.7,6,33,39,22,9,5,14,17
1644,DAL,1,240,49,102,48,17,44,38.6,32,58,55.17,22,28,78.6,12,34,46,28,9,5,12,22
1645,HOU,0,240,45,98,45.9,10,44,22.7,35,54,64.81,23,31,74.2,15,39,54,26,5,2,11,26
1646,BKN,1,240,31,77,40.3,14,38,36.8,17,39,43.59,27,34,79.4,7,28,35,18,6,1,12,16
1647,WAS,0,240,42,92,45.7,13,34,38.2,29,58,50,9,12,75,12,33,45,29,5,2,17,23
1648,DEN,1,240,43,91,47.3,14,31,45.2,29,60,48.33,16,23,69.6,19,33,52,24,4,2,11,16
1649,PHX,0,240,41,82,50,12,35,34.3,29,47,61.7,10,12,83.3,7,29,36,25,4,2,12,18
1650,NOP,0,240,43,98,43.9,13,41,31.7,30,57,52.63,10,18,55.6,12,33,45,26,1,6,9,26
1651,NOP,0,240,42,101,41.6,17,41,41.5,25,60,41.67,19,20,95,9,29,38,21,7,6,10,24
1652,LAL,1,240,38,84,45.2,13,39,33.3,25,45,55.56,20,29,69,11,29,40,19,12,7,16,14
1653,ATL,0,240,47,90,52.2,14,34,41.2,33,56,58.93,8,11,72.7,8,30,38,32,9,7,15,27
1654,CHA,0,240,44,80,55,12,28,42.9,32,52,61.54,15,22,68.2,10,33,43,26,5,7,20,17
1655,MIL,1,240,41,84,48.8,13,37,35.1,28,47,59.57,9,18,50,9,40,49,25,10,8,21,14
1656,SAS,1,240,40,75,53.3,12,23,52.2,28,52,53.85,19,28,67.9,9,38,47,26,7,3,22,17
1657,ORL,0,240,43,92,46.7,13,31,41.9,30,61,49.18,7,9,77.8,7,26,33,24,11,5,14,16
1658,DET,0,240,37,91,40.7,10,35,28.6,27,56,48.21,6,10,60,6,34,40,22,7,3,16,18
1659,IND,1,240,43,79,54.4,10,24,41.7,33,55,60,15,16,93.8,7,35,42,26,6,6,19,14
1660,MEM,0,240,43,89,48.3,14,30,46.7,29,59,49.15,8,13,61.5,12,35,47,28,12,3,22,19
1661,PHX,1,240,33,96,34.4,10,35,28.6,23,61,37.7,24,26,92.3,12,44,56,22,9,3,7,17
1662,MIA,0,240,30,75,40,6,24,25,24,51,47.06,20,27,74.1,9,29,38,12,6,4,18,16
1663,CLE,1,240,37,87,42.5,10,31,32.3,27,56,48.21,26,32,81.3,9,43,52,19,9,2,13,14
1664,POR,0,240,39,87,44.8,14,40,35,25,47,53.19,12,16,75,6,32,38,21,6,6,10,20
1665,MIN,0,240,38,91,41.8,12,42,28.6,26,49,53.06,10,17,58.8,9,48,57,26,2,10,14,23
1666,NYK,0,240,40,93,43,15,40,37.5,25,53,47.17,9,15,60,10,27,37,30,12,3,11,22
1667,PHI,1,240,42,83,50.6,14,29,48.3,28,54,51.85,15,17,88.2,8,36,44,28,11,2,15,27
1668,TOR,1,240,40,88,45.5,13,37,35.1,27,51,52.94,26,30,86.7,12,30,42,22,5,5,17,16
1669,CHI,1,240,43,95,45.3,22,47,46.8,21,48,43.75,8,12,66.7,13,26,39,27,12,3,13,20
1670,UTA,1,240,42,82,51.2,15,36,41.7,27,46,58.7,29,33,87.9,7,42,49,29,2,4,18,21
1671,BOS,0,240,33,81,40.7,7,27,25.9,26,54,48.15,19,23,82.6,5,35,40,21,12,6,13,19
1672,LAL,1,240,45,88,51.1,17,31,54.8,28,57,49.12,23,29,79.3,11,34,45,32,7,6,16,20
1673,SAS,0,240,43,85,50.6,6,18,33.3,37,67,55.22,12,16,75,3,29,32,21,6,3,11,15
1674,DAL,1,240,58,100,58,20,37,54.1,38,63,60.32,7,9,77.8,10,39,49,31,8,7,5,18
1675,CLE,0,240,37,86,43,12,29,41.4,25,57,43.86,15,17,88.2,8,26,34,23,3,3,10,15
1676,BKN,1,240,41,81,50.6,12,34,35.3,29,47,61.7,22,31,71,13,35,48,22,9,3,18,18
1677,CHI,0,240,41,90,45.6,10,30,33.3,31,60,51.67,16,20,80,14,27,41,23,11,3,13,24
1678,GSW,0,240,43,94,45.7,12,28,42.9,31,66,46.97,11,12,91.7,6,31,37,28,11,3,9,18
1679,ATL,0,240,38,88,43.2,10,37,27,28,51,54.9,17,17,100,10,24,34,26,12,2,20,18
1680,UTA,1,240,43,85,50.6,14,32,43.8,29,53,54.72,13,16,81.3,8,40,48,23,4,10,21,14
1681,CHA,0,240,48,93,51.6,14,34,41.2,34,59,57.63,8,8,100,7,37,44,24,9,5,16,18
1682,PHI,1,240,46,89,51.7,10,26,38.5,36,63,57.14,13,19,68.4,13,38,51,32,8,4,15,21
1683,DEN,1,240,39,88,44.3,7,28,25,32,60,53.33,11,13,84.6,11,37,48,24,7,5,18,17
1684,HOU,0,240,39,84,46.4,15,43,34.9,24,41,58.54,26,38,68.4,11,32,43,22,11,2,15,27
1685,OKC,0,240,49,93,52.7,11,31,35.5,38,62,61.29,18,20,90,6,31,37,28,8,3,12,23
1686,SAC,0,240,39,86,45.3,4,26,15.4,35,60,58.33,15,19,78.9,7,26,33,26,8,2,16,25
1687,LAC,1,240,45,87,51.7,13,33,39.4,32,54,59.26,19,24,79.2,10,37,47,27,9,4,19,32
1688,WAS,1,240,48,91,52.7,14,34,41.2,34,57,59.65,15,20,75,6,35,41,34,10,3,11,13
1689,DET,1,240,49,82,59.8,17,34,50,32,48,66.67,13,20,65,12,30,42,30,13,10,19,17
1690,MIA,1,240,39,79,49.4,14,38,36.8,25,41,60.98,24,28,85.7,9,35,44,33,10,3,19,17
1691,PHX,0,240,40,86,46.5,13,31,41.9,27,55,49.09,28,32,87.5,9,29,38,28,10,3,14,19
1692,POR,0,240,50,103,48.5,17,39,43.6,33,64,51.56,12,14,85.7,9,32,41,32,6,11,8,27
1693,NOP,1,240,47,88,53.4,16,35,45.7,31,53,58.49,14,22,63.6,8,36,44,28,8,6,18,25
1694,MIL,1,240,50,106,47.2,16,43,37.2,34,63,53.97,21,26,80.8,18,40,58,32,7,3,12,20
1695,MIN,0,240,35,89,39.3,14,45,31.1,21,44,47.73,11,21,52.4,12,39,51,13,5,9,14,20
1696,CHA,0,240,30,81,37,11,33,33.3,19,48,39.58,20,26,76.9,8,33,41,17,8,3,16,23
1697,ORL,0,240,35,91,38.5,9,32,28.1,26,59,44.07,18,28,64.3,16,27,43,26,9,8,14,16
1698,MIL,1,240,46,87,52.9,17,43,39.5,29,44,65.91,26,34,76.5,8,38,46,25,6,8,19,25
1699,BOS,0,265,41,104,39.4,12,45,26.7,29,59,49.15,10,14,71.4,18,35,53,26,11,2,18,22
1700,BKN,1,240,36,90,40,10,39,25.6,26,51,50.98,19,23,82.6,13,40,53,19,11,1,17,21
1701,DET,0,240,28,83,33.7,8,33,24.2,20,50,40,25,32,78.1,12,34,46,23,6,8,17,20
1702,SAS,0,240,49,93,52.7,12,32,37.5,37,61,60.66,22,29,75.9,12,29,41,32,8,8,12,13
1703,MIA,1,240,41,78,52.6,19,37,51.4,22,41,53.66,23,31,74.2,12,32,44,25,8,5,24,20
1704,WAS,1,240,54,92,58.7,18,30,60,36,62,58.06,12,15,80,6,32,38,37,4,3,17,20
1705,DAL,1,240,51,90,56.7,22,38,57.9,29,52,55.77,18,23,78.3,8,42,50,33,7,7,12,21
1706,ATL,0,240,44,96,45.8,14,31,45.2,30,65,46.15,25,31,80.6,9,34,43,27,8,2,13,26
1707,PHI,1,240,39,89,43.8,13,32,40.6,26,57,45.61,18,26,69.2,10,34,44,30,5,5,10,14
1708,CLE,0,240,37,87,42.5,12,38,31.6,25,49,51.02,14,16,87.5,10,24,34,19,13,2,19,23
1709,NYK,0,240,40,84,47.6,13,25,52,27,59,45.76,11,15,73.3,7,35,42,17,8,6,14,25
1710,HOU,0,240,32,76,42.1,12,38,31.6,20,38,52.63,19,25,76,9,34,43,19,9,2,21,22
1711,LAC,1,265,39,93,41.9,17,45,37.8,22,48,45.83,12,16,75,14,39,53,26,12,9,23,18
1712,TOR,1,240,45,87,51.7,9,27,33.3,36,60,60,14,19,73.7,10,37,47,26,5,5,13,21
1713,DEN,1,240,44,94,46.8,9,27,33.3,35,67,52.24,8,15,53.3,15,33,48,29,13,4,15,21
1714,GSW,0,240,35,90,38.9,8,27,29.6,27,63,42.86,16,25,64,9,25,34,18,7,5,10,16
1715,CHI,1,240,39,91,42.9,14,27,51.9,25,64,39.06,17,26,65.4,12,43,55,25,9,7,15,24
1716,UTA,1,240,35,86,40.7,14,33,42.4,21,53,39.62,19,27,70.4,13,38,51,22,7,6,11,21
1717,NOP,1,240,41,93,44.1,13,36,36.1,28,57,49.12,20,24,83.3,16,37,53,24,10,5,13,15
1718,MEM,0,240,36,88,40.9,9,25,36,27,63,42.86,14,19,73.7,7,30,37,26,6,4,14,23
1719,PHX,0,240,38,89,42.7,12,36,33.3,26,53,49.06,28,34,82.4,14,25,39,24,11,4,12,20
1720,OKC,0,240,38,80,47.5,9,28,32.1,29,52,55.77,22,25,88,8,31,39,22,10,2,16,22
1721,LAL,1,240,43,89,48.3,14,31,45.2,29,58,50,12,19,63.2,14,32,46,29,9,8,16,20
1722,POR,0,240,40,92,43.5,16,29,55.2,24,63,38.1,8,13,61.5,11,37,48,20,5,4,17,23
1723,GSW,1,240,43,90,47.8,9,29,31,34,61,55.74,19,22,86.4,11,40,51,33,5,10,15,24
1724,SAC,1,240,42,79,53.2,13,31,41.9,29,48,60.42,23,25,92,8,35,43,28,7,7,19,26
1725,HOU,1,240,47,100,47,17,45,37.8,30,55,54.55,21,26,80.8,17,41,58,24,9,10,16,21
1726,CHI,0,240,39,97,40.2,12,34,35.3,27,63,42.86,11,14,78.6,13,37,50,25,6,6,15,25
1727,POR,0,240,40,96,41.7,11,36,30.6,29,60,48.33,17,23,73.9,12,32,44,28,7,5,17,21
1728,IND,1,240,44,101,43.6,14,33,42.4,30,68,44.12,13,17,76.5,15,48,63,26,5,8,10,22
1729,DAL,1,240,42,84,50,17,41,41.5,25,43,58.14,16,23,69.6,9,32,41,28,4,3,13,19
1730,PHX,0,240,33,82,40.2,10,36,27.8,23,46,50,9,12,75,8,37,45,22,7,6,19,17
1731,SAS,0,240,44,96,45.8,8,24,33.3,36,72,50,14,16,87.5,17,31,48,18,6,2,10,18
1732,MIL,1,240,38,82,46.3,15,41,36.6,23,41,56.1,24,35,68.6,8,40,48,24,12,9,15,16
1733,BOS,1,240,37,89,41.6,12,41,29.3,25,48,52.08,13,17,76.5,11,41,52,22,12,5,17,21
1734,TOR,1,240,50,97,51.5,20,43,46.5,30,54,55.56,12,15,80,16,37,53,40,13,2,11,25
1735,LAC,1,240,35,87,40.2,10,36,27.8,25,51,49.02,10,14,71.4,13,36,49,23,7,5,17,25
1736,CHA,0,240,33,78,42.3,15,45,33.3,18,33,54.55,15,24,62.5,9,28,37,26,3,8,20,19
1737,CLE,0,240,36,76,47.4,17,36,47.2,19,40,47.5,16,30,53.3,10,31,41,18,2,1,20,26
1738,BKN,0,240,30,84,35.7,11,34,32.4,19,50,38,15,24,62.5,4,36,40,18,2,7,10,19
1739,OKC,0,240,28,75,37.3,7,27,25.9,21,48,43.75,25,28,89.3,9,36,45,17,12,4,17,19
1740,UTA,0,240,35,96,36.5,12,31,38.7,23,65,35.38,20,26,76.9,12,41,53,20,5,5,14,23
1741,MIN,1,240,41,89,46.1,14,38,36.8,27,51,52.94,16,19,84.2,5,46,51,22,6,10,15,25
1742,NYK,1,240,44,98,44.9,8,23,34.8,36,75,48,27,35,77.1,19,28,47,17,8,10,7,24
1743,PHI,1,240,46,84,54.8,9,23,39.1,37,61,60.66,13,17,76.5,4,40,44,33,6,11,14,22
1744,NOP,1,240,37,89,41.6,18,46,39.1,19,43,44.19,16,20,80,11,37,48,24,3,5,15,21
1745,GSW,0,240,37,91,40.7,7,25,28,30,66,45.45,19,23,82.6,9,34,43,23,7,3,12,19
1746,MEM,0,240,39,84,46.4,16,36,44.4,23,48,47.92,20,24,83.3,9,36,45,29,4,3,16,17
1747,ORL,1,240,43,87,49.4,15,38,39.5,28,49,57.14,24,26,92.3,11,41,52,25,5,3,14,15
1748,LAL,1,240,47,89,52.8,15,35,42.9,32,54,59.26,13,16,81.3,10,32,42,26,10,14,17,19
1749,CLE,0,240,34,90,37.8,6,25,24,28,65,43.08,21,24,87.5,11,31,42,14,9,5,15,21
1750,ATL,0,240,37,86,43,8,28,28.6,29,58,50,19,25,76,9,28,37,16,11,2,20,19
1751,SAC,1,240,38,89,42.7,14,35,40,24,54,44.44,10,12,83.3,10,35,45,22,8,7,12,24
1752,BOS,0,240,34,82,41.5,10,30,33.3,24,52,46.15,21,24,87.5,10,36,46,26,7,3,15,14
1753,DEN,1,240,49,89,55.1,18,32,56.3,31,57,54.39,15,23,65.2,6,33,39,36,10,10,12,24
1754,WAS,0,240,46,97,47.4,19,41,46.3,27,56,48.21,10,12,83.3,9,29,38,31,7,2,9,21
1755,POR,1,240,42,93,45.2,13,39,33.3,29,54,53.7,24,26,92.3,9,39,48,21,2,4,12,20
1756,MIN,0,240,38,84,45.2,12,38,31.6,26,46,56.52,17,23,73.9,13,33,46,23,7,5,19,20
1757,NYK,0,240,39,86,45.3,6,20,30,33,66,50,18,23,78.3,13,35,48,22,5,1,11,21
1758,LAC,1,240,50,93,53.8,17,33,51.5,33,60,55,33,35,94.3,12,41,53,30,10,12,21,28
1759,IND,0,240,32,100,32,12,34,35.3,20,66,30.3,7,9,77.8,14,40,54,19,8,7,15,10
1760,HOU,1,240,43,94,45.7,19,49,38.8,24,45,53.33,20,22,90.9,14,28,42,15,7,3,12,18
1761,BKN,1,240,40,88,45.5,10,43,23.3,30,45,66.67,27,31,87.1,5,35,40,30,10,9,15,30
1762,CHA,1,240,36,87,41.4,17,48,35.4,19,39,48.72,14,19,73.7,12,30,42,22,5,3,10,18
1763,ATL,0,240,34,90,37.8,6,24,25,28,66,42.42,27,37,73,14,24,38,19,11,10,19,27
1764,TOR,0,240,37,89,41.6,17,41,41.5,20,48,41.67,11,15,73.3,7,35,42,21,7,2,15,20
1765,MIL,1,240,43,96,44.8,11,39,28.2,32,57,56.14,5,7,71.4,8,47,55,23,6,8,15,13
1766,DAL,1,240,37,88,42,9,39,23.1,28,49,57.14,27,33,81.8,12,43,55,24,7,4,13,15
1767,SAS,0,240,41,88,46.6,5,18,27.8,36,70,51.43,29,34,85.3,7,36,43,25,8,7,10,17
1768,MIA,1,240,44,81,54.3,9,24,37.5,35,57,61.4,12,13,92.3,9,36,45,25,13,3,21,6
1769,NOP,0,240,37,82,45.1,16,35,45.7,21,47,44.68,4,6,66.7,7,24,31,23,10,2,18,16
1770,CHI,0,240,32,91,35.2,9,39,23.1,23,52,44.23,38,41,92.7,17,39,56,15,8,2,20,30
1771,GSW,0,240,34,82,41.5,5,28,17.9,29,54,53.7,27,34,79.4,12,43,55,17,8,4,20,19
1772,DET,0,240,40,81,49.4,15,35,42.9,25,46,54.35,11,11,100,7,35,42,25,3,3,21,19
1773,LAL,1,240,34,81,42,11,37,29.7,23,44,52.27,20,22,90.9,10,31,41,22,11,6,13,18
1774,MIN,0,240,42,89,47.2,11,37,29.7,31,52,59.62,21,29,72.4,9,34,43,26,6,5,20,20
1775,MEM,1,240,43,96,44.8,10,35,28.6,33,61,54.1,11,13,84.6,9,37,46,25,6,5,11,23
1776,WAS,1,240,54,100,54,10,28,35.7,44,72,61.11,19,25,76,13,38,51,38,10,5,14,22
1777,OKC,1,265,41,76,53.9,10,24,41.7,31,52,59.62,35,41,85.4,6,30,36,22,7,3,13,23
1778,IND,0,240,37,82,45.1,8,33,24.2,29,49,59.18,20,26,76.9,8,34,42,24,2,2,17,25
1779,SAC,0,240,36,82,43.9,16,39,41,20,43,46.51,9,9,100,10,33,43,24,7,0,18,22
1780,HOU,1,240,36,89,40.4,14,46,30.4,22,43,51.16,25,29,86.2,10,34,44,12,11,3,8,23
1781,ORL,1,240,36,87,41.4,12,29,41.4,24,58,41.38,27,34,79.4,14,34,48,22,6,5,10,13
1782,BOS,1,240,37,91,40.7,13,33,39.4,24,58,41.38,18,23,78.3,11,36,47,24,13,5,14,24
1783,PHI,0,265,45,90,50,14,32,43.8,31,58,53.45,15,22,68.2,13,30,43,24,6,0,16,32
1784,CHA,1,240,43,96,44.8,13,35,37.1,30,61,49.18,10,16,62.5,14,27,41,22,10,3,11,17
1785,UTA,0,240,35,87,40.2,9,34,26.5,26,53,49.06,27,32,84.4,9,36,45,17,5,6,15,16
1786,SAS,0,240,45,89,50.6,13,26,50,32,63,50.79,6,10,60,8,33,41,23,8,8,11,25
1787,NYK,1,240,42,94,44.7,13,30,43.3,29,64,45.31,9,11,81.8,15,38,53,20,6,2,15,27
1788,ATL,0,240,40,91,44,8,31,25.8,32,60,53.33,24,30,80,15,34,49,25,15,5,22,31
1789,MIL,1,240,42,88,47.7,6,33,18.2,36,55,65.45,34,47,72.3,17,41,58,24,9,4,22,22
1790,MIA,1,240,43,79,54.4,12,30,40,31,49,63.27,10,11,90.9,4,37,41,31,10,7,19,21
1791,PHX,1,240,41,85,48.2,15,39,38.5,26,46,56.52,31,38,81.6,7,32,39,32,6,2,20,24
1792,CLE,0,240,36,85,42.4,8,32,25,28,53,52.83,17,21,81,11,30,41,18,14,2,18,16
1793,DEN,1,240,43,101,42.6,10,33,30.3,33,68,48.53,5,10,50,14,48,62,26,4,3,7,14
1794,DAL,0,240,36,84,42.9,8,36,22.2,28,48,58.33,23,31,74.2,12,32,44,21,8,7,12,16
1795,BKN,0,240,36,95,37.9,8,38,21.1,28,57,49.12,13,16,81.3,7,44,51,19,3,2,7,14
1796,NOP,1,240,47,98,48,18,34,52.9,29,64,45.31,20,29,69,18,33,51,26,11,5,14,25
1797,LAC,0,240,46,84,54.8,11,24,45.8,35,60,58.33,24,31,77.4,6,31,37,28,6,6,16,22
1798,CHI,0,240,38,93,40.9,18,43,41.9,20,50,40,21,25,84,10,35,45,25,14,1,20,29
1799,SAS,0,240,44,90,48.9,3,17,17.6,41,73,56.16,23,29,79.3,10,34,44,24,4,4,12,23
1800,PHI,0,240,40,91,44,8,30,26.7,32,61,52.46,9,13,69.2,8,39,47,25,5,5,15,27
1801,BOS,1,240,49,96,51,16,36,44.4,33,60,55,26,29,89.7,10,34,44,32,5,5,12,26
1802,CHA,0,240,43,87,49.4,16,36,44.4,27,51,52.94,15,19,78.9,7,27,34,27,8,5,15,12
1803,MIN,1,240,45,91,49.5,11,34,32.4,34,57,59.65,28,34,82.4,13,37,50,25,11,4,10,25
1804,WAS,0,240,50,96,52.1,11,29,37.9,39,67,58.21,22,27,81.5,9,27,36,28,5,4,9,23
1805,GSW,0,240,36,89,40.4,9,35,25.7,27,54,50,13,17,76.5,10,23,33,29,8,7,17,14
1806,TOR,1,240,42,92,45.7,14,32,43.8,28,60,46.67,16,17,94.1,14,36,50,20,4,9,14,20
1807,ORL,1,240,38,86,44.2,10,32,31.3,28,54,51.85,26,34,76.5,9,39,48,27,6,2,13,22
1808,HOU,1,240,33,86,38.4,14,42,33.3,19,44,43.18,22,27,81.5,9,44,53,12,7,6,10,17
1809,LAC,0,240,38,98,38.8,10,33,30.3,28,65,43.08,7,14,50,11,42,53,17,3,3,13,21
1810,POR,0,240,38,96,39.6,17,48,35.4,21,48,43.75,13,16,81.3,11,32,43,24,3,7,12,16
1811,MEM,1,240,48,89,53.9,17,35,48.6,31,54,57.41,6,9,66.7,11,34,45,32,9,5,24,21
1812,LAL,1,240,48,89,53.9,9,20,45,39,69,56.52,15,18,83.3,13,38,51,31,8,6,19,18
1813,SAC,1,240,38,86,44.2,11,32,34.4,27,54,50,20,26,76.9,11,35,46,24,9,5,14,25
1814,POR,0,240,34,77,44.2,8,30,26.7,26,47,55.32,23,30,76.7,7,33,40,15,4,5,17,19
1815,DEN,0,240,46,104,44.2,11,41,26.8,35,63,55.56,18,22,81.8,15,25,40,31,7,5,3,24
1816,LAL,1,240,51,95,53.7,10,25,40,41,70,58.57,11,21,52.4,8,36,44,39,4,4,10,21
1817,ATL,1,240,44,83,53,15,34,44.1,29,49,59.18,22,34,64.7,10,35,45,30,1,5,15,21
1818,BKN,0,240,41,90,45.6,11,37,29.7,30,53,56.6,21,25,84,10,33,43,19,5,8,17,29
1819,PHI,1,240,40,89,44.9,8,38,21.1,32,51,62.75,10,13,76.9,11,35,46,24,8,8,14,20
1820,CLE,0,240,38,86,44.2,5,21,23.8,33,65,50.77,16,20,80,9,36,45,13,10,0,14,13
1821,PHX,0,240,43,91,47.3,16,38,42.1,27,53,50.94,13,17,76.5,6,33,39,32,3,4,11,22
1822,OKC,0,240,29,82,35.4,6,25,24,23,57,40.35,21,24,87.5,9,31,40,19,9,4,15,16
1823,NYK,0,240,36,88,40.9,10,32,31.3,26,56,46.43,20,31,64.5,13,25,38,27,12,1,18,28
1824,DET,0,240,34,78,43.6,15,41,36.6,19,37,51.35,25,37,67.6,8,24,32,27,9,9,16,28
1825,UTA,1,240,43,92,46.7,6,26,23.1,37,66,56.06,27,35,77.1,11,35,46,16,7,4,11,18
1826,MIA,1,240,41,77,53.2,14,32,43.8,27,45,60,21,27,77.8,8,34,42,34,6,1,20,30
1827,CHI,1,240,41,81,50.6,14,33,42.4,27,48,56.25,24,31,77.4,9,37,46,22,9,2,20,25
1828,IND,1,240,46,94,48.9,7,23,30.4,39,71,54.93,12,13,92.3,11,39,50,21,6,4,15,20
1829,DAL,0,240,37,89,41.6,11,42,26.2,26,47,55.32,21,28,75,13,33,46,22,2,5,8,26
1830,LAC,1,240,34,92,37,8,36,22.2,26,56,46.43,22,30,73.3,20,46,66,25,9,7,22,21
1831,MEM,1,240,44,87,50.6,11,28,39.3,33,59,55.93,14,20,70,9,38,47,32,7,5,11,20
1832,DET,0,240,39,87,44.8,16,32,50,23,55,41.82,20,25,80,12,27,39,25,9,5,17,22
1833,TOR,0,240,34,85,40,11,30,36.7,23,55,41.82,9,15,60,5,33,38,25,9,8,15,24
1834,BOS,1,240,41,86,47.7,15,35,42.9,26,51,50.98,19,25,76,10,36,46,25,4,5,9,27
1835,NOP,0,240,41,95,43.2,14,45,31.1,27,50,54,20,27,74.1,12,34,46,26,8,3,17,23
1836,GSW,0,240,45,94,47.9,10,31,32.3,35,63,55.56,8,14,57.1,8,36,44,23,8,2,10,24
1837,HOU,1,240,44,85,51.8,12,41,29.3,32,44,72.73,22,32,68.8,7,40,47,16,9,6,19,22
1838,UTA,1,240,40,81,49.4,16,35,45.7,24,46,52.17,26,32,81.3,5,38,43,30,3,3,12,16
1839,MIN,1,240,45,89,50.6,15,34,44.1,30,55,54.55,15,19,78.9,11,34,45,25,7,6,17,23
1840,SAS,0,240,42,90,46.7,12,30,40,30,60,50,13,17,76.5,7,35,42,29,4,4,14,17
1841,BKN,0,240,44,91,48.4,8,34,23.5,36,57,63.16,16,17,94.1,5,38,43,27,4,2,17,24
1842,PHX,1,240,52,99,52.5,19,42,45.2,33,57,57.89,15,19,78.9,5,37,42,37,8,7,7,17
1843,ORL,0,240,41,89,46.1,15,36,41.7,26,53,49.06,5,6,83.3,7,30,37,27,5,11,11,10
1844,OKC,0,240,45,91,49.5,17,42,40.5,28,49,57.14,12,17,70.6,5,30,35,31,11,4,15,20
1845,NYK,0,240,31,86,36,9,31,29,22,55,40,16,25,64,17,35,52,19,11,8,21,26
1846,ATL,0,265,42,104,40.4,11,41,26.8,31,63,49.21,18,25,72,11,37,48,21,11,8,16,26
1847,MIL,1,240,47,83,56.6,11,28,39.3,36,55,65.45,16,18,88.9,5,43,48,27,9,4,22,21
1848,MIN,0,265,34,97,35.1,6,45,13.3,28,52,53.85,24,33,72.7,15,38,53,22,9,10,13,23
1849,TOR,1,240,43,89,48.3,12,36,33.3,31,53,58.49,15,22,68.2,7,36,43,26,6,8,15,17
1850,CHA,0,240,38,84,45.2,14,33,42.4,24,51,47.06,16,22,72.7,6,25,31,22,9,1,13,19
1851,IND,1,240,48,91,52.7,9,20,45,39,71,54.93,4,5,80,10,33,43,31,6,3,9,13
1852,PHI,1,240,46,84,54.8,10,28,35.7,36,56,64.29,12,16,75,10,39,49,29,9,5,21,16
1853,LAL,0,240,41,94,43.6,10,30,33.3,31,64,48.44,12,19,63.2,13,38,51,31,6,7,12,20
1854,DEN,1,265,39,101,38.6,11,28,39.3,28,73,38.36,11,17,64.7,14,43,57,26,6,4,20,30
1855,POR,1,265,45,104,43.3,12,36,33.3,33,68,48.53,22,28,78.6,16,45,61,19,10,9,17,22
1856,CLE,1,240,36,82,43.9,8,28,28.6,28,54,51.85,28,31,90.3,9,36,45,20,11,2,14,19
1857,CHI,0,240,37,98,37.8,4,32,12.5,33,66,50,16,18,88.9,11,35,46,21,14,5,15,22
1858,HOU,1,240,39,83,47,19,44,43.2,20,39,51.28,20,28,71.4,9,46,55,18,12,7,24,21
1859,OKC,1,240,43,79,54.4,14,30,46.7,29,49,59.18,14,17,82.4,7,35,42,30,7,5,19,17
1860,CHA,0,240,36,88,40.9,12,35,34.3,24,53,45.28,26,34,76.5,13,29,42,27,10,2,22,27
1861,DAL,1,240,52,97,53.6,18,42,42.9,34,55,61.82,16,20,80,12,35,47,27,8,5,15,14
1862,SAS,0,240,39,99,39.4,14,30,46.7,25,69,36.23,23,30,76.7,21,36,57,24,1,8,15,22
1863,MEM,0,240,50,95,52.6,12,36,33.3,38,59,64.41,10,14,71.4,10,29,39,31,10,6,16,22
1864,GSW,0,240,42,85,49.4,7,22,31.8,35,63,55.56,17,17,100,6,28,34,22,9,6,15,18
1865,NOP,1,240,40,75,53.3,14,33,42.4,26,42,61.9,21,30,70,9,36,45,25,13,6,26,28
1866,BOS,1,240,48,94,51.1,14,37,37.8,34,57,59.65,25,28,89.3,7,36,43,28,11,11,9,25
1867,GSW,0,265,43,103,41.7,10,35,28.6,33,68,48.53,23,24,95.8,13,36,49,18,12,9,20,26
1868,DAL,0,240,37,90,41.1,14,44,31.8,23,46,50,14,17,82.4,7,40,47,18,4,6,13,21
1869,ATL,0,240,46,87,52.9,9,28,32.1,37,59,62.71,8,14,57.1,11,23,34,23,8,6,13,19
1870,NYK,1,240,37,89,41.6,14,28,50,23,61,37.7,18,31,58.1,14,42,56,19,9,3,12,20
1871,SAC,1,240,42,76,55.3,18,31,58.1,24,45,53.33,19,22,86.4,9,27,36,27,7,7,15,19
1872,PHI,0,240,38,86,44.2,13,26,50,25,60,41.67,8,17,47.1,11,38,49,28,8,8,18,19
1873,NOP,0,240,40,99,40.4,10,41,24.4,30,58,51.72,14,21,66.7,14,39,53,21,7,6,18,23
1874,DEN,1,240,39,87,44.8,9,22,40.9,30,65,46.15,13,17,76.5,7,34,41,28,10,11,10,16
1875,BKN,1,240,41,99,41.4,16,37,43.2,25,62,40.32,21,30,70,16,35,51,18,6,9,9,25
1876,MIA,0,240,28,80,35,6,35,17.1,22,45,48.89,18,24,75,8,29,37,18,9,2,13,12
1877,LAL,1,240,40,89,44.9,8,32,25,32,57,56.14,7,8,87.5,10,38,48,30,6,5,18,24
1878,ORL,1,240,44,93,47.3,7,28,25,37,65,56.92,23,27,85.2,12,45,57,24,10,10,9,17
1879,MIL,0,240,34,95,35.8,10,36,27.8,24,59,40.68,22,30,73.3,16,38,54,14,8,4,13,26
1880,CLE,1,240,41,90,45.6,6,27,22.2,35,63,55.56,25,29,86.2,17,31,48,18,10,5,13,17
1881,UTA,1,240,34,84,40.5,15,36,41.7,19,48,39.58,20,29,69,11,45,56,15,3,1,20,27
1882,WAS,0,240,45,96,46.9,7,31,22.6,38,65,58.46,3,6,50,17,30,47,26,5,5,19,24
1883,TOR,1,240,41,93,44.1,19,43,44.2,22,50,44,21,24,87.5,10,43,53,27,9,3,17,24
1884,POR,0,240,40,97,41.2,11,30,36.7,29,67,43.28,24,25,96,13,35,48,11,3,9,11,24
1885,MEM,0,240,32,86,37.2,11,29,37.9,21,57,36.84,11,13,84.6,4,32,36,23,3,5,18,22
1886,MIN,1,265,48,111,43.2,9,36,25,39,75,52,20,29,69,20,39,59,20,10,10,19,23
1887,IND,1,240,43,83,51.8,4,15,26.7,39,68,57.35,22,25,88,10,34,44,23,6,8,13,16
1888,DET,0,240,39,86,45.3,13,33,39.4,26,53,49.06,15,18,83.3,10,30,40,27,6,4,17,26
1889,CHA,0,240,33,86,38.4,6,31,19.4,27,55,49.09,15,21,71.4,9,40,49,21,7,9,21,19
1890,SAS,1,240,51,94,54.3,9,20,45,42,74,56.76,10,11,90.9,12,35,47,32,5,3,13,21
1891,OKC,0,240,42,80,52.5,10,21,47.6,32,59,54.24,18,24,75,4,27,31,26,7,2,13,14
1892,BOS,1,240,40,93,43,10,33,30.3,30,60,50,18,23,78.3,11,41,52,29,13,5,13,19
1893,MIA,1,240,45,82,54.9,15,28,53.6,30,54,55.56,19,24,79.2,5,36,41,22,9,5,15,28
1894,PHX,0,240,37,84,44,11,32,34.4,26,52,50,23,31,74.2,10,30,40,22,4,3,15,21
1895,POR,0,240,39,104,37.5,11,39,28.2,28,65,43.08,12,16,75,17,34,51,18,7,4,14,27
1896,LAC,1,240,39,89,43.8,4,23,17.4,35,66,53.03,25,30,83.3,13,44,57,20,6,12,17,14
1897,SAC,0,240,42,95,44.2,20,44,45.5,22,51,43.14,16,21,76.2,12,31,43,23,8,7,14,23
1898,IND,1,240,44,94,46.8,12,30,40,32,64,50,21,26,80.8,13,35,48,35,8,3,13,25
1899,MEM,1,240,50,88,56.8,12,23,52.2,38,65,58.46,25,30,83.3,8,41,49,34,4,3,17,22
1900,ATL,0,240,30,74,40.5,6,30,20,24,44,54.55,27,35,77.1,6,35,41,18,7,3,24,26
1901,WAS,0,240,37,95,38.9,13,40,32.5,24,55,43.64,19,19,100,16,32,48,24,3,3,17,26
1902,MIL,1,240,42,98,42.9,18,49,36.7,24,49,48.98,27,34,79.4,14,40,54,18,7,11,15,28
1903,PHI,0,240,33,80,41.3,8,25,32,25,55,45.45,30,34,88.2,7,35,42,20,9,3,16,20
1904,UTA,1,240,41,89,46.1,8,22,36.4,33,67,49.25,16,24,66.7,14,36,50,21,9,4,13,21
1905,GSW,0,240,38,96,39.6,13,33,39.4,25,63,39.68,23,28,82.1,16,35,51,22,7,1,11,12
1906,MIN,0,240,43,96,44.8,16,45,35.6,27,51,52.94,19,26,73.1,10,26,36,29,9,7,11,22
1907,DET,1,240,44,79,55.7,15,30,50,29,49,59.18,19,24,79.2,8,35,43,37,7,1,17,17
1908,HOU,1,240,48,97,49.5,21,45,46.7,27,52,51.92,12,19,63.2,11,39,50,31,7,9,13,20
1909,TOR,1,240,43,78,55.1,14,29,48.3,29,49,59.18,24,29,82.8,2,35,37,28,10,4,14,20
1910,LAC,0,240,41,98,41.8,13,31,41.9,28,67,41.79,29,36,80.6,14,40,54,21,4,3,19,28
1911,DAL,1,240,36,84,42.9,11,31,35.5,25,53,47.17,24,30,80,12,31,43,20,4,1,17,23
1912,NYK,0,240,39,80,48.8,11,25,44,28,55,50.91,13,21,61.9,5,25,30,24,9,4,14,20
1913,CHI,1,240,41,82,50,13,33,39.4,28,49,57.14,18,27,66.7,7,36,43,26,11,9,20,30
1914,ORL,0,240,39,80,48.8,6,24,25,33,56,58.93,22,28,78.6,10,34,44,25,14,10,18,30
1915,SAS,0,240,38,91,41.8,8,33,24.2,30,58,51.72,16,23,69.6,11,30,41,18,9,8,15,17
1916,CHA,1,265,42,88,47.7,10,31,32.3,32,57,56.14,28,42,66.7,10,27,37,22,7,4,13,17
1917,ORL,0,240,32,82,39,3,22,13.6,29,60,48.33,27,31,87.1,16,37,53,15,5,8,14,24
1918,DEN,1,240,45,86,52.3,9,23,39.1,36,63,57.14,10,16,62.5,9,38,47,35,10,3,20,21
1919,IND,0,265,51,94,54.3,12,30,40,39,64,60.94,6,7,85.7,7,36,43,27,5,7,18,34
1920,OKC,1,240,37,86,43,12,33,36.4,25,53,47.17,16,20,80,7,31,38,21,9,5,9,23
1921,CHI,0,240,43,85,50.6,14,32,43.8,29,53,54.72,12,23,52.2,7,35,42,22,11,4,16,21
1922,LAL,1,240,45,92,48.9,11,33,33.3,34,59,57.63,17,24,70.8,12,37,49,26,10,10,16,18
1923,ATL,1,240,43,90,47.8,11,30,36.7,32,60,53.33,11,16,68.8,9,39,48,22,9,5,18,20
1924,MIA,0,240,32,88,36.4,9,29,31,23,59,38.98,16,25,64,13,31,44,23,12,5,15,21
1925,CLE,0,240,40,95,42.1,13,33,39.4,27,62,43.55,20,22,90.9,11,32,43,22,3,6,9,18
1926,BOS,1,240,48,85,56.5,12,30,40,36,55,65.45,11,15,73.3,4,41,45,24,5,12,14,23
1927,WAS,1,240,43,93,46.2,8,29,27.6,35,64,54.69,21,25,84,13,28,41,27,9,7,12,23
1928,NOP,0,240,48,97,49.5,13,32,40.6,35,65,53.85,16,21,76.2,10,29,39,18,16,5,21,26
1929,HOU,1,240,35,93,37.6,17,50,34,18,43,41.86,20,29,69,14,37,51,20,6,5,18,21
1930,GSW,1,240,42,86,48.8,10,26,38.5,32,60,53.33,33,36,91.7,8,39,47,28,4,4,10,17
1931,MIL,1,240,50,93,53.8,14,39,35.9,36,54,66.67,20,30,66.7,11,46,57,24,8,6,17,20
1932,BKN,1,240,49,92,53.3,16,41,39,33,51,64.71,21,28,75,12,33,45,32,13,3,23,18
1933,PHX,1,240,41,77,53.2,11,28,39.3,30,49,61.22,21,27,77.8,5,35,40,24,6,5,20,24
1934,DET,0,240,34,82,41.5,13,27,48.1,21,55,38.18,18,23,78.3,13,29,42,21,4,9,21,20
1935,PHI,0,240,42,89,47.2,13,29,44.8,29,60,48.33,12,20,60,9,29,38,21,11,2,20,29
1936,POR,0,240,47,105,44.8,13,40,32.5,34,65,52.31,11,14,78.6,16,28,44,16,5,6,6,23
1937,MIN,0,240,37,103,35.9,13,43,30.2,24,60,40,19,22,86.4,13,34,47,20,12,4,16,23
1938,MEM,0,240,40,94,42.6,3,25,12,37,69,53.62,17,21,81,13,38,51,19,13,7,15,21
1939,MIA,1,240,47,89,52.8,18,41,43.9,29,48,60.42,17,22,77.3,5,41,46,38,14,7,18,21
1940,LAC,1,240,36,92,39.1,7,32,21.9,29,60,48.33,26,34,76.5,18,36,54,15,7,6,9,25
1941,CLE,0,240,39,96,40.6,18,48,37.5,21,48,43.75,15,22,68.2,12,29,41,24,9,4,9,14
1942,SAS,0,240,33,83,39.8,6,25,24,27,58,46.55,24,29,82.8,8,39,47,23,11,4,18,18
1943,DAL,1,240,50,94,53.2,20,41,48.8,30,53,56.6,11,13,84.6,11,40,51,34,5,6,14,21
1944,SAC,1,240,41,85,48.2,15,39,38.5,26,46,56.52,16,25,64,10,40,50,25,7,5,14,29
1945,NYK,0,240,32,80,40,8,31,25.8,24,49,48.98,20,31,64.5,9,29,38,18,6,5,13,23
1946,UTA,0,240,31,78,39.7,10,31,32.3,21,47,44.68,22,31,71,6,31,37,16,4,6,15,30
1947,HOU,0,240,31,79,39.2,14,48,29.2,17,31,54.84,24,31,77.4,4,34,38,19,6,5,22,24
1948,IND,1,240,40,85,47.1,8,26,30.8,32,59,54.24,20,27,74.1,10,39,49,28,6,10,18,24
1949,CHI,0,240,36,84,42.9,9,29,31,27,55,49.09,14,25,56,6,36,42,27,8,2,18,21
1950,LAL,1,240,42,87,48.3,6,24,25,36,63,57.14,13,19,68.4,7,39,46,21,8,10,18,22
1951,TOR,0,240,34,84,40.5,15,36,41.7,19,48,39.58,22,25,88,7,35,42,24,5,6,14,22
1952,MIN,1,240,51,94,54.3,17,39,43.6,34,55,61.82,12,17,70.6,3,44,47,33,9,10,22,23
1953,ORL,0,240,37,86,43,6,29,20.7,31,57,54.39,7,11,63.6,10,37,47,22,8,7,16,25
1954,MEM,0,240,42,86,48.8,9,28,32.1,33,58,56.9,12,19,63.2,13,33,46,26,9,8,20,23
1955,DEN,1,240,27,73,37,9,28,32.1,18,45,40,28,39,71.8,7,34,41,15,8,3,14,14
1956,CHA,1,240,36,85,42.4,5,29,17.2,31,56,55.36,16,23,69.6,16,32,48,18,6,1,13,15
1957,OKC,1,240,41,90,45.6,15,37,40.5,26,53,49.06,18,23,78.3,8,36,44,20,8,11,12,20
1958,PHI,1,240,54,107,50.5,11,33,33.3,43,74,58.11,10,12,83.3,13,33,46,36,11,8,11,23
1959,MIL,1,240,41,89,46.1,13,38,34.2,28,51,54.9,20,25,80,10,41,51,30,4,7,12,22
1960,GSW,0,240,34,77,44.2,9,28,32.1,25,49,51.02,10,13,76.9,5,35,40,23,5,5,18,22
1961,POR,0,240,45,78,57.7,19,34,55.9,26,44,59.09,19,25,76,4,32,36,21,7,4,18,21
1962,WAS,0,240,37,95,38.9,12,35,34.3,25,60,41.67,23,27,85.2,8,31,39,21,11,4,17,18
1963,BKN,0,240,43,93,46.2,10,32,31.3,33,61,54.1,13,17,76.5,10,38,48,24,4,4,15,24
1964,DET,1,240,41,91,45.1,8,27,29.6,33,64,51.56,23,29,79.3,5,36,41,21,8,7,8,18
1965,PHX,1,240,44,88,50,14,34,41.2,30,54,55.56,12,16,75,4,28,32,26,9,2,17,20
1966,NOP,0,240,40,94,42.6,11,32,34.4,29,62,46.77,13,22,59.1,17,39,56,25,7,5,16,25
1967,CHI,1,240,39,89,43.8,16,40,40,23,49,46.94,18,23,78.3,11,31,42,29,6,1,17,18
1968,UTA,0,240,35,73,47.9,11,28,39.3,24,45,53.33,20,27,74.1,6,30,36,18,12,5,17,18
1969,SAS,1,240,44,93,47.3,13,35,37.1,31,58,53.45,26,30,86.7,16,36,52,23,4,2,11,19
1970,IND,1,240,39,96,40.6,5,27,18.5,34,69,49.28,19,21,90.5,13,45,58,20,8,10,14,24
1971,CLE,0,240,32,87,36.8,11,32,34.4,21,55,38.18,20,25,80,3,42,45,20,9,1,16,21
1972,BOS,1,240,33,74,44.6,11,34,32.4,22,40,55,27,29,93.1,3,41,44,21,7,4,14,16
1973,SAC,1,240,41,84,48.8,8,29,27.6,33,55,60,12,17,70.6,11,27,38,15,8,3,17,23
1974,BKN,1,240,42,85,49.4,19,32,59.4,23,53,43.4,20,28,71.4,10,45,55,26,8,7,22,21
1975,DAL,0,265,40,102,39.2,14,36,38.9,26,66,39.39,16,23,69.6,18,43,61,23,5,1,23,21
1976,NYK,0,240,37,93,39.8,14,38,36.8,23,55,41.82,14,21,66.7,16,35,51,22,9,4,13,23
1977,MIL,1,240,47,93,50.5,17,47,36.2,30,46,65.22,12,18,66.7,11,47,58,24,11,4,14,19
1978,LAL,1,265,47,96,49,9,32,28.1,38,64,59.38,16,21,76.2,6,35,41,24,11,7,11,21
1979,GSW,0,240,39,84,46.4,13,28,46.4,26,56,46.43,19,21,90.5,7,32,39,25,4,2,11,22
1980,DET,0,240,41,85,48.2,6,29,20.7,35,56,62.5,18,24,75,10,37,47,21,11,8,16,21
1981,ORL,0,240,34,91,37.4,12,37,32.4,22,54,40.74,11,17,64.7,10,30,40,21,8,3,16,16
1982,HOU,0,240,41,99,41.4,12,48,25,29,51,56.86,22,27,81.5,9,31,40,21,13,4,12,21
1983,NOP,1,240,41,77,53.2,15,33,45.5,26,44,59.09,25,32,78.1,2,35,37,30,7,4,16,21
1984,ATL,0,240,36,88,40.9,7,34,20.6,29,54,53.7,18,26,69.2,16,34,50,20,5,5,16,15
1985,MIA,1,240,40,84,47.6,14,37,37.8,26,47,55.32,12,19,63.2,9,32,41,29,12,9,14,18
1986,DEN,0,240,43,89,48.3,7,26,26.9,36,63,57.14,14,16,87.5,5,30,35,24,5,3,15,24
1987,SAS,0,240,36,80,45,7,21,33.3,29,59,49.15,18,27,66.7,9,40,49,15,6,5,19,28
1988,LAC,1,240,39,91,42.9,5,26,19.2,34,65,52.31,20,27,74.1,11,36,47,16,9,1,12,23
1989,BOS,1,240,41,92,44.6,17,41,41.5,24,51,47.06,17,21,81,5,40,45,25,4,4,10,20
1990,WAS,0,240,57,91,62.6,20,36,55.6,37,55,67.27,24,29,82.8,11,29,40,31,6,4,19,27
1991,PHX,1,240,44,96,45.8,15,36,41.7,29,60,48.33,18,21,85.7,13,32,45,33,12,4,17,22
1992,SAC,0,240,44,96,45.8,14,46,30.4,30,50,60,9,12,75,10,29,39,26,11,5,15,19
1993,OKC,0,240,33,84,39.3,4,27,14.8,29,57,50.88,29,37,78.4,13,42,55,15,8,2,19,21
1994,MIL,0,240,38,82,46.3,14,45,31.1,24,37,64.86,15,24,62.5,5,40,45,21,3,4,15,21
1995,CLE,1,240,41,78,52.6,10,24,41.7,31,54,57.41,25,31,80.6,10,37,47,25,3,7,19,21
1996,BKN,0,240,41,93,44.1,10,31,32.3,31,62,50,16,26,61.5,18,36,54,21,6,5,20,19
1997,TOR,1,240,51,86,59.3,13,27,48.1,38,59,64.41,10,12,83.3,3,31,34,30,12,2,15,22
1998,CHA,1,240,46,84,54.8,16,32,50,30,52,57.69,10,14,71.4,10,36,46,30,8,3,21,17
1999,HOU,1,240,55,103,53.4,23,54,42.6,32,49,65.31,26,33,78.8,19,25,44,34,10,5,13,24
2000,PHI,1,240,43,92,46.7,9,25,36,34,67,50.75,22,28,78.6,16,40,56,24,14,6,22,27
2001,DET,0,240,41,88,46.6,14,30,46.7,27,58,46.55,17,23,73.9,11,31,42,30,5,1,20,15
2002,GSW,0,240,36,82,43.9,8,28,28.6,28,54,51.85,30,36,83.3,7,36,43,24,8,6,18,22
2003,LAC,0,240,39,82,47.6,8,23,34.8,31,59,52.54,10,12,83.3,6,30,36,19,3,4,20,22
2004,NYK,0,240,31,82,37.8,7,31,22.6,24,51,47.06,14,20,70,10,34,44,19,1,10,11,15
2005,POR,1,240,34,86,39.5,17,35,48.6,17,51,33.33,17,24,70.8,9,40,49,19,9,8,19,30
2006,ORL,1,240,37,88,42,12,32,37.5,25,56,44.64,9,12,75,14,38,52,24,5,6,9,17
2007,UTA,1,240,44,80,55,11,24,45.8,33,56,58.93,11,16,68.8,3,33,36,23,12,5,15,18
2008,MIN,0,240,32,81,39.5,10,35,28.6,22,46,47.83,21,28,75,6,28,34,12,13,6,22,21
2009,IND,1,240,45,96,46.9,11,26,42.3,34,70,48.57,17,20,85,11,30,41,25,9,2,9,24
2010,CHI,0,240,39,90,43.3,14,39,35.9,25,51,49.02,19,23,82.6,9,23,32,25,6,5,7,24
2011,ATL,0,240,35,83,42.2,11,39,28.2,24,44,54.55,16,24,66.7,9,24,33,28,14,7,20,29
2012,MIA,1,240,33,73,45.2,13,31,41.9,20,42,47.62,33,45,73.3,13,36,49,19,11,6,28,22
2013,DAL,1,240,41,84,48.8,13,37,35.1,28,47,59.57,14,24,58.3,10,32,42,29,6,5,9,14
2014,DEN,0,240,43,91,47.3,11,32,34.4,32,59,54.24,9,13,69.2,14,36,50,24,6,1,11,24
2015,MEM,0,240,31,95,32.6,7,34,20.6,24,61,39.34,22,23,95.7,13,33,46,20,10,3,21,27
2016,LAL,1,240,40,86,46.5,7,26,26.9,33,60,55,33,39,84.6,10,44,54,25,9,8,18,19
2017,DEN,1,240,36,98,36.7,10,36,27.8,26,62,41.94,19,21,90.5,19,35,54,19,8,5,12,18
2018,TOR,1,240,33,85,38.8,10,39,25.6,23,46,50,28,30,93.3,6,46,52,19,9,2,17,20
2019,ATL,0,240,36,84,42.9,9,27,33.3,27,57,47.37,22,32,68.8,8,37,45,23,12,3,21,25
2020,OKC,0,240,41,94,43.6,13,35,37.1,28,59,47.46,17,24,70.8,16,36,52,22,7,3,15,27
2021,SAS,1,240,41,85,48.2,7,22,31.8,34,63,53.97,24,32,75,7,43,50,25,5,9,18,19
2022,PHI,1,240,37,88,42,11,41,26.8,26,47,55.32,20,25,80,12,37,49,22,12,11,22,29
2023,POR,0,240,39,100,39,10,33,30.3,29,67,43.28,22,27,81.5,9,40,49,19,4,8,10,27
2024,UTA,1,240,27,71,38,10,31,32.3,17,40,42.5,32,39,82.1,6,43,49,19,8,5,23,26
2025,HOU,1,240,39,90,43.3,10,44,22.7,29,46,63.04,28,33,84.8,9,31,40,21,6,6,14,24
2026,SAC,0,240,36,91,39.6,12,37,32.4,24,54,44.44,10,16,62.5,15,33,48,25,6,8,13,21
2027,PHX,0,240,33,80,41.3,13,34,38.2,20,46,43.48,16,23,69.6,3,37,40,23,7,3,16,31
2028,LAC,1,240,40,83,48.2,12,33,36.4,28,50,56,19,21,90.5,9,35,44,23,11,8,22,24
2029,ORL,0,240,34,89,38.2,12,39,30.8,22,50,44,15,18,83.3,8,39,47,22,9,6,16,20
2030,CHI,0,240,36,85,42.4,9,35,25.7,27,50,54,17,21,81,8,30,38,19,6,5,10,22
2031,MIL,1,240,48,92,52.2,17,38,44.7,31,54,57.41,16,24,66.7,8,42,50,29,9,7,12,15
2032,NYK,1,240,38,91,41.8,9,29,31,29,62,46.77,20,32,62.5,25,38,63,19,3,6,17,19
2033,NOP,0,240,48,103,46.6,15,47,31.9,33,56,58.93,12,22,54.5,11,30,41,36,13,7,15,20
2034,GSW,1,240,51,104,49,14,35,40,37,69,53.62,18,24,75,19,42,61,37,8,2,18,22
2035,DET,1,240,37,81,45.7,13,24,54.2,24,57,42.11,9,10,90,9,39,48,21,2,3,20,18
2036,CHA,0,240,36,83,43.4,14,39,35.9,22,44,50,10,14,71.4,9,29,38,24,5,3,22,23
2037,IND,0,240,39,94,41.5,6,21,28.6,33,73,45.21,10,13,76.9,13,32,45,24,11,4,8,18
2038,CLE,0,240,45,100,45,12,39,30.8,33,61,54.1,10,12,83.3,10,38,48,19,2,3,12,22
2039,MIN,1,240,39,91,42.9,13,45,28.9,26,46,56.52,25,33,75.8,14,32,46,24,12,1,16,17
2040,OKC,1,240,44,78,56.4,15,32,46.9,29,46,63.04,17,22,77.3,8,42,50,24,8,5,24,26
2041,BKN,0,265,44,101,43.6,15,45,33.3,29,56,51.79,30,37,81.1,11,42,53,28,6,5,17,22
2042,MIA,0,240,42,85,49.4,15,36,41.7,27,49,55.1,10,15,66.7,7,34,41,25,7,9,23,23
2043,POR,1,240,45,87,51.7,9,22,40.9,36,65,55.38,22,26,84.6,7,41,48,13,6,4,16,30
2044,MEM,1,265,50,103,48.5,14,33,42.4,36,70,51.43,20,25,80,8,41,49,33,9,10,12,29
2045,DAL,0,240,37,94,39.4,13,50,26,24,44,54.55,32,41,78,12,34,46,27,7,3,12,22
2046,GSW,0,240,30,92,32.6,5,33,15.2,25,59,42.37,27,31,87.1,12,27,39,17,13,2,15,15
2047,LAL,1,240,49,93,52.7,11,31,35.5,38,62,61.29,11,14,78.6,10,37,47,30,7,8,14,22
2048,CHA,0,240,35,91,38.5,10,35,28.6,25,56,44.64,21,23,91.3,13,32,45,19,7,4,16,20
2049,IND,0,240,39,87,44.8,10,28,35.7,29,59,49.15,11,13,84.6,6,30,36,23,7,3,17,27
2050,WAS,0,240,47,95,49.5,16,34,47.1,31,61,50.82,12,17,70.6,8,33,41,30,3,8,13,15
2051,SAC,0,240,30,81,37,7,26,26.9,23,55,41.82,14,17,82.4,6,25,31,16,5,3,18,19
2052,ATL,1,240,43,84,51.2,9,30,30,34,54,62.96,8,15,53.3,9,43,52,22,5,9,18,26
2053,ORL,0,240,35,99,35.4,5,31,16.1,30,68,44.12,24,26,92.3,17,29,46,15,8,7,10,15
2054,CLE,1,240,40,80,50,11,31,35.5,29,49,59.18,19,29,65.5,12,32,44,23,9,7,19,20
2055,TOR,1,240,38,82,46.3,15,42,35.7,23,40,57.5,17,18,94.4,10,49,59,27,9,12,24,25
2056,BOS,1,240,42,93,45.2,15,41,36.6,27,52,51.92,19,29,65.5,13,33,46,24,14,9,13,26
2057,SAS,1,240,50,108,46.3,10,28,35.7,40,80,50,14,17,82.4,21,32,53,29,6,7,9,19
2058,PHX,1,240,43,86,50,17,43,39.5,26,43,60.47,27,34,79.4,9,40,49,32,9,3,16,34
2059,NOP,0,240,46,100,46,18,50,36,28,50,56,13,16,81.3,9,33,42,27,9,2,17,30
2060,DET,0,240,41,76,53.9,8,19,42.1,33,57,57.89,21,36,58.3,5,30,35,20,11,7,23,28
2061,MIL,0,265,41,94,43.6,17,54,31.5,24,40,60,27,35,77.1,5,42,47,22,8,4,18,32
2062,LAC,0,240,40,87,46,11,32,34.4,29,55,52.73,31,39,79.5,10,31,41,20,8,4,12,32
2063,UTA,1,240,44,78,56.4,18,37,48.6,26,41,63.41,7,12,58.3,2,41,43,28,6,1,21,22
2064,MIA,1,265,46,101,45.5,16,44,36.4,30,57,52.63,23,36,63.9,8,46,54,33,7,3,18,30
2065,CHI,0,240,29,97,29.9,9,35,25.7,20,62,32.26,17,25,68,12,33,45,18,9,2,15,22
2066,NYK,0,240,31,82,37.8,7,27,25.9,24,55,43.64,26,34,76.5,16,39,55,15,7,4,24,26
2067,HOU,1,240,43,94,45.7,13,45,28.9,30,49,61.22,27,30,90,9,36,45,27,7,4,19,22
2068,PHI,1,240,42,87,48.3,13,34,38.2,29,53,54.72,20,30,66.7,6,32,38,30,14,3,22,26
2069,DAL,1,240,45,93,48.4,14,40,35,31,53,58.49,19,26,73.1,12,37,49,23,8,7,11,19
2070,LAL,1,240,34,86,39.5,8,26,30.8,26,60,43.33,19,24,79.2,11,31,42,19,14,9,14,21
2071,CHI,1,240,40,93,43,12,42,28.6,28,51,54.9,18,24,75,9,36,45,18,14,7,14,21
2072,CHA,0,240,37,84,44,12,29,41.4,25,55,45.45,13,26,50,9,33,42,26,6,5,20,29
2073,MIN,1,240,43,91,47.3,12,38,31.6,31,53,58.49,23,31,74.2,13,39,52,30,11,6,17,21
2074,NOP,0,240,45,98,45.9,15,41,36.6,30,57,52.63,11,15,73.3,12,36,48,30,6,3,14,22
2075,TOR,0,240,37,78,47.4,18,36,50,19,42,45.24,14,17,82.4,5,41,46,22,2,6,23,28
2076,UTA,0,240,29,70,41.4,8,25,32,21,45,46.67,20,21,95.2,3,37,40,19,8,2,23,25
2077,SAC,0,240,37,87,42.5,15,37,40.5,22,50,44,23,27,85.2,13,30,43,17,10,2,17,26
2078,OKC,0,240,33,83,39.8,5,23,21.7,28,60,46.67,14,22,63.6,7,42,49,14,7,6,19,18
2079,BOS,1,240,42,109,38.5,13,38,34.2,29,71,40.85,15,16,93.8,21,35,56,21,10,8,10,20
2080,MEM,0,240,39,94,41.5,10,29,34.5,29,65,44.62,14,20,70,15,41,56,24,8,6,18,21
2081,POR,1,240,46,85,54.1,11,30,36.7,35,55,63.64,19,22,86.4,5,35,40,23,8,5,16,23
2082,WAS,1,240,39,97,40.2,11,41,26.8,28,56,50,8,10,80,8,39,47,21,9,6,15,21
2083,DEN,1,265,36,92,39.1,7,27,25.9,29,65,44.62,29,36,80.6,8,37,45,21,7,12,14,26
2084,BKN,1,240,37,78,47.4,16,37,43.2,21,41,51.22,23,34,67.6,11,35,46,21,11,2,26,26
2085,PHX,0,265,34,86,39.5,8,28,28.6,26,58,44.83,31,32,96.9,10,44,54,25,5,1,18,35
2086,NYK,0,240,38,81,46.9,17,25,68,21,56,37.5,16,28,57.1,9,30,39,17,14,4,26,31
2087,LAC,1,240,50,80,62.5,18,32,56.3,32,48,66.67,23,30,76.7,3,36,39,33,7,5,20,24
2088,MIL,1,240,46,99,46.5,16,46,34.8,30,53,56.6,9,18,50,6,47,53,31,7,10,11,27
2089,ATL,1,240,44,86,51.2,11,31,35.5,33,55,60,18,21,85.7,8,34,42,27,9,2,13,15
2090,GSW,0,240,39,99,39.4,15,42,35.7,24,57,42.11,29,30,96.7,15,27,42,27,7,0,13,21
2091,DET,0,240,35,85,41.2,10,37,27,25,48,52.08,20,22,90.9,9,30,39,20,6,5,14,20
2092,HOU,0,240,33,90,36.7,16,48,33.3,17,42,40.48,29,39,74.4,10,47,57,25,6,6,14,25
2093,SAC,0,240,34,87,39.1,10,29,34.5,24,58,41.38,17,26,65.4,12,35,47,17,5,5,27,24
2094,MIA,1,240,40,85,47.1,7,18,38.9,33,67,49.25,33,39,84.6,11,40,51,18,9,8,21,33
2095,DET,1,240,41,78,52.6,11,24,45.8,30,54,55.56,26,33,78.8,10,35,45,26,5,6,18,21
2096,WAS,0,240,37,93,39.8,11,41,26.8,26,52,50,15,18,83.3,11,36,47,26,6,3,17,32
2097,SAS,1,240,42,83,50.6,7,21,33.3,35,62,56.45,29,36,80.6,10,41,51,22,6,5,21,18
2098,DAL,1,240,35,76,46.1,11,36,30.6,24,40,60,27,33,81.8,5,41,46,17,6,5,20,22
2099,PHI,1,240,37,85,43.5,7,29,24.1,30,56,53.57,26,36,72.2,12,50,62,24,6,7,17,34
2100,CLE,0,240,33,88,37.5,9,34,26.5,24,54,44.44,10,15,66.7,10,44,54,20,8,2,16,15
2101,BKN,0,265,48,101,47.5,15,34,44.1,33,67,49.25,15,26,57.7,10,38,48,19,8,9,16,30
2102,DEN,1,240,34,81,42,18,32,56.3,16,49,32.65,22,27,81.5,11,34,45,24,11,4,20,23
2103,POR,0,240,36,87,41.4,7,28,25,29,59,49.15,21,23,91.3,13,35,48,13,9,4,20,25
2104,OKC,0,240,32,83,38.6,10,27,37,22,56,39.29,21,31,67.7,7,41,48,15,5,4,16,23
2105,CHA,1,240,45,88,51.1,23,44,52.3,22,44,50,13,16,81.3,9,32,41,28,3,4,19,18
2106,PHX,1,240,49,98,50,11,33,33.3,38,65,58.46,15,18,83.3,9,35,44,31,13,9,14,25
2107,NYK,0,240,44,94,46.8,10,30,33.3,34,64,53.12,13,18,72.2,5,34,39,24,16,1,14,32
2108,MEM,0,240,38,89,42.7,5,32,15.6,33,57,57.89,20,30,66.7,9,31,40,22,9,7,24,31
2109,ORL,1,240,37,86,43,9,30,30,28,56,50,11,19,57.9,7,39,46,24,12,4,13,18
2110,CHI,0,240,49,105,46.7,9,30,30,40,75,53.33,18,22,81.8,20,29,49,25,11,4,12,20
2111,MIN,1,265,46,108,42.6,13,43,30.2,33,65,50.77,22,28,78.6,12,40,52,23,9,4,13,22
2112,UTA,1,240,40,90,44.4,6,24,25,34,66,51.52,14,20,70,11,38,49,15,4,5,11,31
2113,BOS,0,240,33,90,36.7,7,26,26.9,26,64,40.62,20,34,58.8,10,31,41,18,4,2,11,29
2114,IND,0,240,41,89,46.1,8,21,38.1,33,68,48.53,20,24,83.3,10,26,36,26,8,6,15,28
2115,NOP,0,265,43,102,42.2,19,45,42.2,24,57,42.11,17,20,85,16,37,53,30,4,9,19,34
2116,TOR,1,265,42,103,40.8,14,40,35,28,63,44.44,32,38,84.2,16,41,57,23,7,3,17,24
2117,LAC,1,240,42,81,51.9,11,31,35.5,31,50,62,17,24,70.8,11,34,45,24,8,5,14,25
2118,LAL,0,240,37,85,43.5,13,33,39.4,24,52,46.15,15,21,71.4,9,32,41,20,4,7,15,24
1,NYK,1,240,34,79,43,13,27,48.1,21,52,40.38,15,19,78.9,4,37,41,16,7,6,11,17
2,DEN,0,240,44,98,44.9,14,37,37.8,30,61,49.18,14,15,93.3,10,26,36,20,8,2,6,20
3,SAS,0,240,50,98,51,7,24,29.2,43,74,58.11,14,19,73.7,11,35,46,30,5,5,10,8
4,MEM,0,240,40,92,43.5,6,25,24,34,67,50.75,15,19,78.9,12,27,39,25,12,5,13,21
5,CHI,1,240,45,87,51.7,14,32,43.8,31,55,56.36,14,19,73.7,8,37,45,23,8,8,16,20
6,IND,1,240,48,95,50.5,15,37,40.5,33,58,56.9,14,18,77.8,10,37,47,34,8,3,13,19
7,CLE,0,240,38,85,44.7,12,39,30.8,26,46,56.52,21,31,67.7,11,34,45,16,8,5,16,14
8,MIL,0,240,38,90,42.2,12,37,32.4,26,53,49.06,24,32,75,10,31,41,14,13,5,12,16
9,DAL,0,240,44,91,48.4,16,38,42.1,28,53,52.83,17,20,85,11,27,38,32,5,5,16,19
10,POR,1,240,46,87,52.9,18,43,41.9,28,44,63.64,22,26,84.6,11,40,51,24,3,6,14,16
11,ATL,1,240,49,90,54.4,7,21,33.3,42,69,60.87,19,26,73.1,11,45,56,32,10,8,13,16
12,PHI,1,240,46,94,48.9,19,40,47.5,27,54,50,17,23,73.9,9,32,41,35,8,5,12,27
13,HOU,0,240,31,92,33.7,18,63,28.6,13,29,44.83,15,20,75,11,32,43,25,8,5,16,18
14,WAS,1,240,44,91,48.4,10,31,32.3,34,60,56.67,17,21,81,10,43,53,22,4,3,14,20
15,OKC,1,240,50,94,53.2,8,26,30.8,42,68,61.76,9,16,56.3,14,40,54,20,1,12,15,11
16,BKN,1,240,47,83,56.6,16,30,53.3,31,53,58.49,13,17,76.5,4,33,37,35,9,9,12,20
17,UTA,1,240,41,86,47.7,18,39,46.2,23,47,48.94,21,25,84,9,41,50,28,9,3,16,14
18,LAC,0,240,45,106,42.5,10,43,23.3,35,63,55.56,12,15,80,16,28,44,17,8,3,3,14
19,PHX,1,240,53,104,51,13,35,37.1,40,69,57.97,4,4,100,10,38,48,36,7,5,8,13
20,TOR,0,240,39,97,40.2,12,38,31.6,27,59,45.76,23,29,79.3,16,32,48,21,8,3,12,12
21,CHA,0,240,37,94,39.4,14,45,31.1,23,49,46.94,22,24,91.7,10,32,42,25,8,5,13,15
22,NOP,0,240,37,78,47.4,9,25,36,28,53,52.83,15,21,71.4,8,39,47,26,4,5,21,18
23,SAC,0,240,42,90,46.7,9,30,30,33,60,55,6,10,60,5,34,39,24,10,5,13,22
24,MIA,1,240,47,84,56,13,34,38.2,34,50,68,13,20,65,6,33,39,32,11,5,12,19
25,MIN,1,240,49,90,54.4,17,40,42.5,32,50,64,21,25,84,11,27,38,35,11,4,10,22
26,BOS,0,240,35,86,40.7,11,41,26.8,24,45,53.33,11,15,73.3,9,37,46,19,4,6,12,19
27,ORL,0,240,36,76,47.4,10,28,35.7,26,48,54.17,35,41,85.4,9,38,47,23,4,3,17,25
28,GSW,1,240,41,83,49.4,15,39,38.5,26,44,59.09,16,18,88.9,12,34,46,26,9,4,20,19
29,DET,0,240,40,86,46.5,11,35,31.4,29,51,56.86,16,22,72.7,7,26,33,26,4,4,16,21
30,LAL,1,240,45,96,46.9,11,35,31.4,34,61,55.74,9,15,60,8,34,42,30,14,5,10,16
31,PHX,1,240,52,94,55.3,15,33,45.5,37,61,60.66,21,22,95.5,7,40,47,32,10,1,10,15
32,CHA,0,265,39,102,38.2,13,49,26.5,26,53,49.06,18,24,75,15,36,51,28,5,2,8,18
33,LAL,1,240,41,86,47.7,11,29,37.9,30,57,52.63,29,36,80.6,11,34,45,25,5,3,13,15
34,BKN,1,240,41,87,47.1,14,34,41.2,27,53,50.94,9,15,60,8,44,52,26,6,8,10,16
35,MIN,0,240,39,95,41.1,5,37,13.5,34,58,58.62,25,34,73.5,20,31,51,22,8,7,13,19
36,CHI,0,240,34,98,34.7,11,41,26.8,23,57,40.35,12,17,70.6,19,33,52,24,7,4,9,13
37,SAS,0,240,39,88,44.3,4,26,15.4,35,62,56.45,21,24,87.5,7,34,41,23,5,2,16,17
38,MIA,0,240,40,96,41.7,22,49,44.9,18,47,38.3,6,8,75,9,29,38,25,8,3,11,18
39,MIL,1,240,46,86,53.5,13,35,37.1,33,51,64.71,17,24,70.8,5,43,48,29,4,3,11,15
40,IND,0,240,46,89,51.7,9,33,27.3,37,56,66.07,14,19,73.7,8,29,37,28,10,8,13,23
41,NYK,1,265,45,88,51.1,16,37,43.2,29,51,56.86,12,15,80,7,43,50,29,3,7,10,20
42,BOS,1,240,46,95,48.4,18,42,42.9,28,53,52.83,14,18,77.8,9,35,44,27,8,6,15,24
43,PHI,1,240,44,93,47.3,16,34,47.1,28,59,47.46,18,19,94.7,10,36,46,35,9,8,9,25
44,ORL,0,240,33,83,39.8,10,30,33.3,23,53,43.4,21,28,75,10,34,44,21,4,5,13,15
45,OKC,0,240,36,84,42.9,6,19,31.6,30,65,46.15,15,16,93.8,10,35,45,13,6,2,17,20
46,DET,0,240,34,83,41,6,37,16.2,28,46,60.87,17,23,73.9,9,32,41,21,6,8,10,13
47,HOU,1,240,46,86,53.5,14,37,37.8,32,49,65.31,16,22,72.7,8,33,41,30,4,4,16,20
48,DEN,1,240,42,86,48.8,9,32,28.1,33,54,61.11,11,14,78.6,9,40,49,29,6,3,12,17
49,GSW,1,240,42,87,48.3,17,39,43.6,25,48,52.08,24,30,80,8,38,46,29,4,4,12,21
50,LAC,0,240,45,93,48.4,11,35,31.4,34,58,58.62,14,15,93.3,7,28,35,29,9,5,14,15
51,CLE,0,240,39,84,46.4,10,36,27.8,29,48,60.42,17,21,81,7,37,44,24,4,3,17,21
52,NOP,0,240,46,99,46.5,11,27,40.7,35,72,48.61,19,28,67.9,12,39,51,21,6,3,9,23
53,WAS,1,240,41,89,46.1,7,25,28,34,64,53.12,31,37,83.8,12,35,47,23,9,6,11,19
54,SAC,0,240,37,96,38.5,10,42,23.8,27,54,50,22,27,81.5,14,42,56,21,7,2,10,21
55,TOR,0,240,42,85,49.4,13,38,34.2,29,47,61.7,13,17,76.5,4,40,44,19,7,5,12,18
56,DAL,1,240,39,90,43.3,17,42,40.5,22,48,45.83,19,21,90.5,11,31,42,27,4,3,10,18
57,UTA,1,240,40,93,43,13,39,33.3,27,54,50,16,21,76.2,17,36,53,23,9,3,11,17
58,MEM,1,240,37,84,44,11,33,33.3,26,51,50.98,22,35,62.9,9,40,49,23,8,5,13,20
59,CHA,0,240,33,84,39.3,9,33,27.3,24,51,47.06,15,19,78.9,8,27,35,24,9,1,12,15
60,ORL,0,240,36,94,38.3,11,36,30.6,25,58,43.1,10,15,66.7,16,35,51,24,3,6,14,16
61,SAC,0,240,42,96,43.8,17,41,41.5,25,55,45.45,9,14,64.3,13,22,35,33,9,9,11,16
62,MIN,0,240,34,80,42.5,16,41,39,18,39,46.15,19,32,59.4,11,32,43,20,3,5,15,17
63,CHI,1,240,45,83,54.2,17,36,47.2,28,47,59.57,7,10,70,8,43,51,31,4,4,19,15
64,SAS,0,240,38,91,41.8,6,21,28.6,32,70,45.71,16,19,84.2,9,38,47,22,4,6,11,16
65,PHX,1,240,41,88,46.6,13,32,40.6,28,56,50,23,26,88.5,10,32,42,22,4,3,11,17
66,ATL,1,240,41,94,43.6,14,36,38.9,27,58,46.55,20,24,83.3,12,37,49,19,9,4,7,16
67,PHI,0,240,36,78,46.2,7,25,28,29,53,54.72,15,20,75,8,22,30,20,8,1,13,18
68,DEN,1,240,46,96,47.9,12,36,33.3,34,60,56.67,10,11,90.9,14,39,53,30,6,3,14,25
69,MEM,1,240,45,90,50,11,33,33.3,34,57,59.65,15,18,83.3,12,36,48,30,2,9,18,13
70,MIA,1,240,41,81,50.6,13,35,37.1,28,46,60.87,11,11,100,15,32,47,26,5,6,20,15
71,IND,0,240,50,110,45.5,21,43,48.8,29,67,43.28,12,15,80,12,28,40,34,6,2,8,22
72,NYK,1,240,35,86,40.7,14,35,40,21,51,41.18,18,18,100,10,38,48,23,7,8,10,19
73,TOR,0,240,40,90,44.4,12,36,33.3,28,54,51.85,10,18,55.6,7,25,32,24,16,1,11,14
74,MIL,1,240,54,94,57.4,11,30,36.7,43,64,67.19,23,31,74.2,10,41,51,34,5,6,12,10
75,POR,0,240,44,81,54.3,15,33,45.5,29,48,60.42,14,18,77.8,1,32,33,23,7,3,13,18
76,LAC,1,240,40,75,53.3,21,45,46.7,19,30,63.33,12,16,75,6,38,44,28,6,6,17,17
77,DAL,1,240,47,96,49,15,45,33.3,32,51,62.75,16,20,80,9,39,48,23,4,2,8,27
78,WAS,0,240,45,101,44.6,10,29,34.5,35,72,48.61,16,19,84.2,9,33,42,29,10,1,7,20
79,BOS,0,240,36,101,35.6,12,41,29.3,24,60,40,10,14,71.4,13,33,46,14,9,8,7,23
80,LAL,1,240,52,91,57.1,7,20,35,45,71,63.38,13,22,59.1,8,33,41,28,8,3,11,20
81,HOU,0,240,43,85,50.6,18,42,42.9,25,43,58.14,18,27,66.7,8,33,41,33,7,4,15,23
82,POR,1,240,40,91,44,13,32,40.6,27,59,45.76,12,17,70.6,9,30,39,17,7,6,5,18
83,NOP,0,240,36,87,41.4,7,28,25,29,59,49.15,28,38,73.7,11,33,44,18,5,2,13,18
84,ATL,1,240,44,86,51.2,10,33,30.3,34,53,64.15,22,28,78.6,7,44,51,22,4,5,14,21
85,BKN,1,240,48,79,60.8,12,28,42.9,36,51,70.59,20,27,74.1,3,40,43,33,3,9,11,19
86,UTA,0,240,35,85,41.2,12,40,30,23,45,51.11,16,21,76.2,15,38,53,15,4,4,12,22
87,SAS,0,240,43,101,42.6,8,31,25.8,35,70,50,22,27,81.5,16,30,46,21,7,2,8,19
88,CLE,1,240,36,80,45,8,24,33.3,28,56,50,22,27,81.5,7,48,55,27,4,6,16,13
89,LAC,1,240,39,78,50,11,32,34.4,28,46,60.87,26,26,100,9,40,49,25,10,4,18,17
90,BOS,0,240,46,88,52.3,18,37,48.6,28,51,54.9,11,17,64.7,3,29,32,31,8,5,11,21
91,DET,0,240,35,75,46.7,10,23,43.5,25,52,48.08,20,26,76.9,6,40,46,21,8,5,28,23
92,PHX,0,240,41,79,51.9,16,37,43.2,25,42,59.52,18,20,90,6,30,36,26,4,6,11,20
93,TOR,0,240,35,86,40.7,10,37,27,25,49,51.02,16,19,84.2,9,26,35,21,10,8,13,22
94,LAL,1,265,37,89,41.6,12,28,42.9,25,61,40.98,15,19,78.9,14,39,53,31,5,5,20,17
95,PHI,0,240,38,87,43.7,8,26,30.8,30,61,49.18,10,14,71.4,5,30,35,23,9,5,11,17
96,IND,1,240,37,83,44.6,14,41,34.1,23,42,54.76,15,16,93.8,7,38,45,28,7,6,14,15
97,MIN,1,240,45,98,45.9,14,48,29.2,31,50,62,15,21,71.4,11,33,44,30,16,8,15,22
98,MIA,1,240,48,81,59.3,16,30,53.3,32,51,62.75,17,22,77.3,6,37,43,25,7,4,14,21
99,BKN,1,240,42,89,47.2,12,33,36.4,30,56,53.57,19,25,76,13,38,51,32,4,8,8,19
100,NYK,0,265,34,87,39.1,10,29,34.5,24,58,41.38,21,23,91.3,5,36,41,19,8,3,10,21
101,SAC,1,240,44,86,51.2,19,39,48.7,25,47,53.19,15,19,78.9,6,34,40,28,13,6,16,21
102,MEM,1,240,51,89,57.3,16,33,48.5,35,56,62.5,15,16,93.8,10,34,44,32,11,6,11,16
103,CHA,0,240,42,91,46.2,11,39,28.2,31,52,59.62,17,20,85,15,34,49,30,9,5,17,17
104,GSW,1,240,47,95,49.5,11,40,27.5,36,55,65.45,17,20,85,12,28,40,33,8,1,10,20
105,OKC,0,240,39,84,46.4,9,23,39.1,30,61,49.18,19,28,67.9,9,36,45,22,9,5,18,18
106,DEN,1,240,41,83,49.4,13,33,39.4,28,50,56,22,26,84.6,10,28,38,26,12,2,17,19
107,CHI,0,240,39,96,40.6,18,44,40.9,21,52,40.38,11,14,78.6,10,35,45,21,4,5,9,20
108,DAL,0,240,37,88,42,12,38,31.6,25,50,50,18,19,94.7,13,22,35,23,8,2,13,15
109,MIL,1,240,43,101,42.6,8,33,24.2,35,68,51.47,20,27,74.1,17,46,63,16,10,1,9,15
110,ORL,0,240,39,94,41.5,10,30,33.3,29,64,45.31,14,20,70,10,42,52,18,6,2,12,20
111,POR,1,240,47,92,51.1,18,40,45,29,52,55.77,28,35,80,12,35,47,30,7,4,9,18
112,MEM,1,240,45,91,49.5,9,30,30,36,61,59.02,16,27,59.3,10,39,49,33,8,19,12,17
113,GSW,1,240,41,88,46.6,14,42,33.3,27,46,58.7,23,25,92,9,32,41,26,8,2,10,20
114,CLE,0,240,33,93,35.5,13,39,33.3,20,54,37.04,23,30,76.7,15,35,50,21,8,2,12,13
115,ATL,1,240,46,96,47.9,10,30,33.3,36,66,54.55,23,26,88.5,13,42,55,23,4,6,12,17
116,SAS,1,240,56,94,59.6,17,29,58.6,39,65,60,17,21,81,9,37,46,27,6,5,13,16
117,WAS,0,240,51,100,51,13,26,50,38,74,51.35,9,11,81.8,8,34,42,28,8,8,9,21
118,HOU,0,240,42,85,49.4,18,38,47.4,24,47,51.06,27,28,96.4,7,37,44,30,5,2,13,26
119,MIL,0,240,47,94,50,13,41,31.7,34,53,64.15,18,23,78.3,8,26,34,26,6,6,8,13
120,IND,1,240,44,88,50,11,27,40.7,33,61,54.1,12,16,75,10,37,47,32,7,13,11,21
121,NOP,0,240,43,97,44.3,10,23,43.5,33,74,44.59,14,21,66.7,14,36,50,29,9,4,12,18
122,UTA,0,240,41,91,45.1,13,44,29.5,28,47,59.57,21,24,87.5,13,35,48,14,7,1,15,20
123,MIN,1,240,47,97,48.5,16,45,35.6,31,52,59.62,18,24,75,12,45,57,30,5,9,10,20
124,CLE,0,240,33,86,38.4,11,31,35.5,22,55,40,20,31,64.5,10,28,38,18,5,2,16,12
125,PHX,0,240,39,73,53.4,11,25,44,28,48,58.33,21,25,84,3,29,32,23,8,6,15,29
126,BOS,0,240,45,83,54.2,14,38,36.8,31,45,68.89,20,25,80,6,28,34,29,7,3,14,22
127,OKC,0,240,34,87,39.1,11,37,29.7,23,50,46,19,29,65.5,10,28,38,23,9,3,14,18
128,NOP,1,240,45,96,46.9,12,37,32.4,33,59,55.93,10,22,45.5,16,35,51,26,11,9,16,20
129,NYK,1,240,42,90,46.7,13,32,40.6,29,58,50,9,9,100,8,37,45,25,7,5,10,17
130,CHI,1,240,43,84,51.2,12,32,37.5,31,52,59.62,10,14,71.4,5,38,43,27,6,3,9,22
131,DAL,1,240,50,93,53.8,15,39,38.5,35,54,64.81,9,11,81.8,8,34,42,33,9,7,12,24
132,ORL,0,240,36,91,39.6,9,36,25,27,55,49.09,15,22,68.2,10,35,45,20,5,5,13,20
133,MIA,1,240,47,82,57.3,16,35,45.7,31,47,65.96,20,22,90.9,3,32,35,30,8,2,11,20
134,SAC,1,240,45,85,52.9,16,36,44.4,29,49,59.18,20,24,83.3,9,42,51,30,8,11,15,19
135,LAC,0,240,37,86,43,12,35,34.3,25,51,49.02,14,16,87.5,7,36,43,24,5,1,13,12
136,DET,0,240,36,79,45.6,11,27,40.7,25,52,48.08,13,22,59.1,5,32,37,22,4,4,14,14
137,LAL,1,240,39,80,48.8,13,30,43.3,26,50,52,32,41,78,14,27,41,24,11,3,14,21
138,CHA,0,240,42,95,44.2,13,37,35.1,29,58,50,13,18,72.2,11,35,46,22,6,8,19,19
139,HOU,0,240,43,98,43.9,18,51,35.3,25,47,53.19,12,17,70.6,9,31,40,25,11,3,9,15
140,MEM,1,240,38,85,44.7,14,43,32.6,24,42,57.14,19,26,73.1,14,42,56,24,7,8,17,21
141,DEN,0,240,42,92,45.7,14,41,34.1,28,51,54.9,21,23,91.3,10,23,33,21,8,1,12,23
142,PHI,1,240,41,84,48.8,9,30,30,32,54,59.26,27,31,87.1,9,35,44,22,11,4,11,18
143,POR,1,240,45,97,46.4,12,34,35.3,33,63,52.38,22,30,73.3,18,45,63,24,3,5,8,15
144,DET,0,240,41,84,48.8,11,34,32.4,30,50,60,11,16,68.8,10,34,44,22,5,7,18,25
145,TOR,0,240,36,94,38.3,10,32,31.3,26,62,41.94,17,24,70.8,13,33,46,18,10,2,12,21
146,IND,0,265,50,104,48.1,7,29,24.1,43,75,57.33,25,30,83.3,8,41,49,33,11,5,13,24
147,BKN,1,240,41,66,62.1,16,31,51.6,25,35,71.43,27,33,81.8,2,33,35,27,10,5,17,24
148,UTA,1,240,45,85,52.9,15,38,39.5,30,47,63.83,19,21,90.5,7,42,49,28,7,4,18,13
149,OKC,0,240,38,94,40.4,9,37,24.3,29,57,50.88,12,20,60,11,30,41,21,10,1,13,16
150,SAS,0,240,37,93,39.8,8,30,26.7,29,63,46.03,20,23,87,7,33,40,17,6,5,7,24
151,GSW,1,240,47,81,58,27,54,50,20,27,74.07,15,18,83.3,2,44,46,31,5,4,19,19
152,WAS,1,265,49,110,44.5,9,32,28.1,40,78,51.28,26,30,86.7,15,45,60,26,7,9,18,24
153,NOP,0,240,41,101,40.6,9,36,25,32,65,49.23,16,22,72.7,16,36,52,26,12,6,11,21
154,MIL,1,240,51,95,53.7,19,46,41.3,32,49,65.31,20,23,87,13,40,53,30,8,5,17,14
155,POR,1,240,37,88,42,12,37,32.4,25,51,49.02,20,21,95.2,6,38,44,22,6,2,9,20
156,SAC,0,240,41,84,48.8,13,32,40.6,28,52,53.85,9,15,60,4,31,35,27,10,3,16,19
157,UTA,1,240,43,89,48.3,21,46,45.7,22,43,51.16,20,23,87,9,29,38,27,9,3,12,20
158,DAL,1,240,41,83,49.4,10,32,31.3,31,51,60.78,18,22,81.8,9,36,45,21,7,7,10,22
159,MIN,0,240,41,85,48.2,10,37,27,31,48,64.58,20,30,66.7,9,32,41,27,7,4,16,24
160,BOS,0,240,35,86,40.7,11,39,28.2,24,47,51.06,18,23,78.3,11,36,47,19,5,8,14,15
161,PHX,1,240,43,92,46.7,18,41,43.9,25,51,49.02,24,25,96,7,38,45,26,5,3,7,17
162,HOU,0,240,48,96,50,25,53,47.2,23,43,53.49,12,18,66.7,7,30,37,36,10,5,16,21
163,LAL,0,240,37,89,41.6,11,30,36.7,26,59,44.07,16,22,72.7,10,39,49,19,2,4,14,20
164,SAS,1,240,46,89,51.7,4,22,18.2,42,67,62.69,17,19,89.5,7,37,44,20,8,7,13,12
165,DEN,0,240,43,83,51.8,17,38,44.7,26,45,57.78,17,20,85,9,29,38,31,8,3,17,16
166,CLE,0,240,32,83,38.6,6,29,20.7,26,54,48.15,20,26,76.9,11,32,43,17,6,0,15,18
167,NYK,0,240,38,84,45.2,11,32,34.4,27,52,51.92,18,23,78.3,6,35,41,24,2,4,13,25
168,PHI,1,240,38,85,44.7,15,35,42.9,23,50,46,18,22,81.8,10,41,51,27,5,6,17,19
169,CHI,1,240,43,99,43.4,18,40,45,25,59,42.37,17,18,94.4,15,37,52,26,10,4,9,20
170,MIA,1,240,44,87,50.6,13,32,40.6,31,55,56.36,20,27,74.1,8,29,37,27,9,2,14,22
171,CHA,1,240,44,89,49.4,9,33,27.3,35,56,62.5,25,33,75.8,11,40,51,28,5,4,11,23
172,ORL,0,240,41,98,41.8,9,30,30,32,68,47.06,21,28,75,14,33,47,19,6,7,7,24
173,CHA,0,240,38,90,42.2,16,35,45.7,22,55,40,7,18,38.9,13,32,45,29,11,3,15,16
174,TOR,0,265,47,105,44.8,14,38,36.8,33,67,49.25,21,27,77.8,18,32,50,23,9,5,13,30
175,GSW,1,240,42,86,48.8,19,47,40.4,23,39,58.97,15,18,83.3,7,42,49,36,4,1,14,19
176,ATL,0,240,48,94,51.1,15,37,40.5,33,57,57.89,15,18,83.3,10,24,34,27,8,6,12,17
177,LAC,1,240,41,77,53.2,13,31,41.9,28,46,60.87,23,26,88.5,9,39,48,23,4,5,22,25
178,IND,1,240,54,87,62.1,8,20,40,46,67,68.66,17,19,89.5,4,32,36,35,11,4,15,19
179,WAS,1,265,41,94,43.6,13,30,43.3,28,64,43.75,36,43,83.7,11,36,47,29,4,6,15,22
180,CHI,1,240,46,91,50.5,18,37,48.6,28,54,51.85,10,17,58.8,15,41,56,33,10,8,17,20
181,DAL,1,240,40,89,44.9,15,34,44.1,25,55,45.45,18,26,69.2,12,39,51,23,10,3,12,15
182,BKN,0,240,41,95,43.2,13,37,35.1,28,58,48.28,14,15,93.3,10,41,51,18,8,4,13,18
183,MEM,0,240,38,89,42.7,10,37,27,28,52,53.85,11,17,64.7,12,30,42,25,7,5,15,14
184,OKC,0,240,36,88,40.9,9,39,23.1,27,49,55.1,16,20,80,5,34,39,21,9,1,10,19
185,LAL,0,240,33,87,37.9,10,36,27.8,23,51,45.1,18,29,62.1,11,23,34,21,8,6,11,23
186,DET,1,240,44,83,53,11,28,39.3,33,55,60,12,14,85.7,5,34,39,24,9,6,12,18
187,SAS,0,240,37,92,40.2,7,23,30.4,30,69,43.48,13,20,65,9,26,35,22,7,5,7,13
188,DEN,1,240,37,97,38.1,12,39,30.8,25,58,43.1,27,33,81.8,17,46,63,23,13,7,15,24
189,MIN,0,240,49,94,52.1,19,39,48.7,30,55,54.55,18,22,81.8,12,29,41,32,7,5,14,22
190,BOS,1,240,51,96,53.1,21,45,46.7,30,51,58.82,9,12,75,9,36,45,28,8,9,11,23
191,NYK,0,240,33,86,38.4,13,35,37.1,20,51,39.22,18,27,66.7,6,36,42,18,6,10,15,24
192,HOU,0,240,42,93,45.2,17,45,37.8,25,48,52.08,14,18,77.8,12,26,38,28,6,5,13,16
193,UTA,1,240,49,88,55.7,18,41,43.9,31,47,65.96,10,14,71.4,7,46,53,24,5,2,18,20
194,IND,0,240,36,83,43.4,9,25,36,27,58,46.55,12,17,70.6,10,38,48,26,8,6,22,13
195,WAS,0,240,47,96,49,8,22,36.4,39,74,52.7,32,43,74.4,11,32,43,27,6,6,7,23
196,POR,1,240,53,92,57.6,16,33,48.5,37,59,62.71,19,25,76,11,43,54,26,7,9,10,20
197,PHI,1,240,50,94,53.2,15,35,42.9,35,59,59.32,20,22,90.9,11,36,47,26,10,6,10,16
198,CLE,0,240,37,92,40.2,13,38,34.2,24,54,44.44,18,26,69.2,12,30,42,23,9,3,9,18
199,PHX,0,240,33,79,41.8,12,32,37.5,21,47,44.68,25,29,86.2,10,20,30,19,9,3,10,16
200,SAC,1,240,43,95,45.3,8,32,25,35,63,55.56,10,14,71.4,12,36,48,21,16,7,12,14
201,ORL,0,240,33,85,38.8,6,25,24,27,60,45,24,28,85.7,10,35,45,13,7,7,19,11
202,ATL,1,240,53,84,63.1,13,26,50,40,58,68.97,16,18,88.9,9,37,46,35,8,6,11,21
203,MEM,1,240,52,97,53.6,14,29,48.3,38,68,55.88,21,28,75,12,34,46,30,6,4,14,19
204,MIL,1,240,48,89,53.9,18,37,48.6,30,52,57.69,21,28,75,10,35,45,30,4,6,20,31
205,MIL,1,240,44,98,44.9,14,37,37.8,30,61,49.18,22,27,81.5,15,40,55,23,7,3,13,21
206,CLE,0,265,41,90,45.6,13,29,44.8,28,61,45.9,23,27,85.2,9,33,42,29,3,3,18,13
207,OKC,0,240,35,98,35.7,11,36,30.6,24,62,38.71,18,25,72,17,40,57,21,5,4,10,14
208,CHA,1,240,38,93,40.9,8,31,25.8,30,62,48.39,18,24,75,16,35,51,23,8,5,8,23
209,NOP,1,240,39,97,40.2,12,30,40,27,67,40.3,18,22,81.8,14,43,57,28,10,3,12,9
210,DAL,1,240,46,87,52.9,22,48,45.8,24,39,61.54,13,18,72.2,12,32,44,26,6,4,13,17
211,PHX,1,265,55,105,52.4,12,31,38.7,43,74,58.11,12,13,92.3,12,36,48,35,10,11,7,26
212,GSW,0,240,39,93,41.9,20,53,37.7,19,40,47.5,5,7,71.4,8,40,48,22,7,9,18,17
213,BKN,0,240,41,84,48.8,20,43,46.5,21,41,51.22,16,26,61.5,6,33,39,21,6,6,13,25
214,MIA,0,240,39,84,46.4,18,41,43.9,21,43,48.84,17,21,81,8,31,39,30,9,2,12,17
215,DET,0,240,39,85,45.9,9,32,28.1,30,53,56.6,12,20,60,10,36,46,21,3,3,13,21
216,TOR,0,240,40,87,46,12,35,34.3,28,52,53.85,8,13,61.5,7,30,37,22,10,3,12,15
217,LAC,1,240,39,75,52,15,34,44.1,24,41,58.54,12,13,92.3,4,38,42,28,7,5,18,14
218,SAC,1,240,39,95,41.1,12,43,27.9,27,52,51.92,13,16,81.3,9,40,49,25,6,10,12,19
219,NOP,0,240,39,90,43.3,5,25,20,34,65,52.31,25,32,78.1,13,34,47,20,6,4,17,8
220,DEN,0,240,36,82,43.9,6,24,25,30,58,51.72,11,16,68.8,6,35,41,22,10,7,13,24
221,IND,0,240,53,107,49.5,14,27,51.9,39,80,48.75,21,25,84,14,31,45,28,8,6,17,17
222,LAL,1,240,32,73,43.8,13,30,43.3,19,43,44.19,16,23,69.6,7,36,43,18,5,8,20,20
223,ORL,1,240,45,88,51.1,10,23,43.5,35,65,53.85,19,25,76,9,39,48,27,6,3,11,18
224,POR,0,240,43,95,45.3,17,41,41.5,26,54,48.15,11,14,78.6,8,31,39,25,7,4,8,15
225,ATL,1,240,44,84,52.4,20,41,48.8,24,43,55.81,15,18,83.3,5,44,49,32,6,3,11,18
226,MEM,0,240,34,86,39.5,16,41,39,18,45,40,20,24,83.3,13,33,46,26,7,4,12,14
227,PHI,1,240,40,75,53.3,11,28,39.3,29,47,61.7,15,21,71.4,7,37,44,23,11,6,18,13
228,SAS,0,240,42,90,46.7,5,18,27.8,37,72,51.39,10,10,100,8,29,37,25,10,4,13,13
229,NYK,1,240,45,89,50.6,14,27,51.9,31,62,50,14,18,77.8,8,37,45,19,6,8,10,21
230,CHI,0,240,36,87,41.4,11,34,32.4,25,53,47.17,11,14,78.6,12,28,40,25,7,2,15,15
231,WAS,1,240,63,103,61.2,9,22,40.9,54,81,66.67,19,24,79.2,9,35,44,50,10,7,17,19
232,GSW,1,240,47,88,53.4,17,44,38.6,30,44,68.18,12,14,85.7,5,33,38,31,9,8,15,28
233,UTA,1,240,44,88,50,11,36,30.6,33,52,63.46,11,16,68.8,14,36,50,22,10,5,16,11
234,DET,0,240,44,93,47.3,11,35,31.4,33,58,56.9,13,18,72.2,12,30,42,24,8,4,11,19
235,POR,1,240,44,85,51.8,19,38,50,25,47,53.19,22,26,84.6,3,33,36,27,8,5,10,18
236,DAL,0,240,34,81,42,6,35,17.1,28,46,60.87,25,31,80.6,13,27,40,16,12,4,17,16
237,SAC,1,240,45,81,55.6,11,28,39.3,34,53,64.15,10,16,62.5,8,30,38,27,9,1,20,26
238,MIL,1,240,48,98,49,15,37,40.5,33,61,54.1,6,12,50,8,37,45,19,9,11,10,18
239,PHI,1,265,42,94,44.7,11,30,36.7,31,64,48.44,18,25,72,13,36,49,23,7,9,13,19
240,BOS,0,240,43,89,48.3,20,39,51.3,23,50,46,13,15,86.7,10,35,45,29,3,6,18,21
241,PHX,1,240,45,84,53.6,12,31,38.7,33,53,62.26,21,27,77.8,8,31,39,27,9,7,11,17
242,CHA,0,240,40,81,49.4,14,33,42.4,26,48,54.17,17,22,77.3,8,31,39,30,9,1,15,20
243,BKN,0,240,41,96,42.7,17,42,40.5,24,54,44.44,15,17,88.2,14,39,53,18,5,1,16,11
244,SAS,0,265,43,96,44.8,12,31,38.7,31,65,47.69,13,17,76.5,10,38,48,20,9,5,14,25
245,NYK,1,240,45,86,52.3,18,35,51.4,27,51,52.94,14,16,87.5,6,32,38,22,10,1,13,21
246,HOU,0,240,34,79,43,8,35,22.9,26,44,59.09,21,32,65.6,14,33,47,19,6,5,18,18
247,MIA,1,240,45,88,51.1,11,38,28.9,34,50,68,20,27,74.1,11,31,42,30,10,6,11,22
248,OKC,0,240,45,92,48.9,13,30,43.3,32,62,51.61,17,24,70.8,17,30,47,23,7,3,15,22
249,TOR,1,240,42,94,44.7,15,38,39.5,27,56,48.21,22,31,71,13,36,49,24,11,4,13,23
250,LAL,0,240,41,85,48.2,11,29,37.9,30,56,53.57,21,31,67.7,7,37,44,32,7,6,14,22
251,DET,0,240,35,91,38.5,13,37,35.1,22,54,40.74,11,17,64.7,12,31,43,27,6,7,13,16
252,WAS,0,240,47,91,51.6,6,19,31.6,41,72,56.94,24,31,77.4,14,32,46,19,5,3,11,23
253,DAL,1,240,47,87,54,17,38,44.7,30,49,61.22,14,22,63.6,7,29,36,31,6,4,11,25
254,CLE,0,240,37,74,50,20,40,50,17,34,50,13,17,76.5,9,30,39,30,3,4,19,17
255,TOR,0,240,42,94,44.7,12,33,36.4,30,61,49.18,6,9,66.7,11,28,39,26,12,3,10,15
256,HOU,0,240,32,89,36,9,42,21.4,23,47,48.94,14,22,63.6,10,39,49,20,9,3,20,18
257,IND,1,240,57,87,65.5,21,33,63.6,36,54,66.67,17,22,77.3,3,50,53,41,7,11,17,22
258,MEM,0,240,44,96,45.8,10,29,34.5,34,67,50.75,13,21,61.9,17,38,55,21,6,10,17,20
259,CHI,0,240,40,85,47.1,6,24,25,34,61,55.74,11,17,64.7,8,31,39,22,11,0,13,22
260,ORL,1,240,38,85,44.7,11,25,44,27,60,45,25,28,89.3,6,31,37,20,10,5,11,17
261,UTA,1,240,37,78,47.4,17,41,41.5,20,37,54.05,15,18,83.3,9,40,49,20,3,3,21,15
262,MIA,1,240,47,87,54,18,36,50,29,51,56.86,12,15,80,10,27,37,30,12,1,8,16
263,ATL,1,240,37,74,50,14,36,38.9,23,38,60.53,20,26,76.9,6,38,44,19,11,5,15,21
264,GSW,1,240,39,84,46.4,18,46,39.1,21,38,55.26,17,24,70.8,4,46,50,32,10,8,17,18
265,OKC,0,240,38,111,34.2,8,38,21.1,30,73,41.1,11,23,47.8,21,27,48,23,8,4,14,15
266,DEN,1,240,39,80,48.8,12,32,37.5,27,48,56.25,20,21,95.2,8,36,44,26,2,4,11,23
267,NOP,1,265,47,92,51.1,14,36,38.9,33,56,58.93,32,46,69.6,14,38,52,34,8,5,21,20
268,LAC,0,240,36,83,43.4,14,34,41.2,22,49,44.9,18,24,75,10,29,39,21,8,3,6,19
269,CHA,1,240,42,87,48.3,14,37,37.8,28,50,56,9,20,45,14,40,54,24,8,15,14,16
270,MIN,0,265,48,106,45.3,15,48,31.3,33,58,56.9,25,32,78.1,13,38,51,35,17,5,16,30
271,PHX,1,240,48,88,54.5,11,33,33.3,37,55,67.27,14,19,73.7,8,36,44,27,7,7,11,14
272,WAS,1,240,46,92,50,8,18,44.4,38,74,51.35,22,26,84.6,11,35,46,31,14,3,14,19
273,ORL,0,240,27,86,31.4,6,26,23.1,21,60,35,15,20,75,12,44,56,16,4,6,20,19
274,MEM,1,240,34,99,34.3,11,39,28.2,23,60,38.33,13,16,81.3,15,42,57,25,10,8,9,15
275,BKN,0,240,40,95,42.1,13,41,31.7,27,54,50,16,19,84.2,11,31,42,20,6,3,8,18
276,LAL,0,240,42,83,50.6,7,28,25,35,55,63.64,15,21,71.4,11,32,43,24,9,12,21,17
277,MIL,1,240,42,90,46.7,9,25,36,33,65,50.77,15,20,75,8,43,51,24,5,5,11,19
278,SAC,1,240,39,86,45.3,12,33,36.4,27,53,50.94,20,22,90.9,11,26,37,29,10,3,17,16
279,PHI,1,240,47,101,46.5,10,28,35.7,37,73,50.68,22,26,84.6,18,32,50,27,8,6,9,21
280,ATL,0,240,36,82,43.9,10,28,35.7,26,54,48.15,22,28,78.6,12,34,46,19,3,8,18,23
281,CHI,0,240,37,96,38.5,10,33,30.3,27,63,42.86,14,21,66.7,14,36,50,23,5,5,10,18
282,SAS,0,265,49,92,53.3,11,24,45.8,38,68,55.88,31,38,81.6,8,35,43,29,6,1,11,27
283,POR,1,240,47,91,51.6,16,36,44.4,31,55,56.36,18,20,90,8,42,50,24,3,2,10,17
284,BOS,1,265,49,105,46.7,18,38,47.4,31,67,46.27,27,36,75,17,35,52,31,7,7,13,26
285,UTA,0,240,35,80,43.8,14,39,35.9,21,41,51.22,16,18,88.9,8,28,36,22,8,5,14,17
286,CLE,0,240,34,82,41.5,7,33,21.2,27,49,55.1,18,28,64.3,14,32,46,19,6,4,25,17
287,IND,0,240,41,96,42.7,11,39,28.2,30,57,52.63,20,21,95.2,7,31,38,23,8,6,10,23
288,DET,0,240,36,71,50.7,10,29,34.5,26,42,61.9,23,34,67.6,3,36,39,26,7,5,18,23
289,HOU,1,240,49,98,50,25,46,54.3,24,52,46.15,20,24,83.3,16,36,52,23,6,6,18,23
290,DAL,1,240,40,89,44.9,13,30,43.3,27,59,45.76,22,23,95.7,8,27,35,22,6,2,12,20
291,GSW,0,240,42,85,49.4,15,38,39.5,27,47,57.45,15,21,71.4,4,30,34,28,10,7,10,21
292,DEN,1,240,44,93,47.3,12,35,34.3,32,58,55.17,21,26,80.8,14,33,47,22,6,7,11,16
293,OKC,0,240,34,89,38.2,11,39,28.2,23,50,46,16,20,80,12,41,53,18,6,4,22,21
294,BKN,1,240,47,89,52.8,12,35,34.3,35,54,64.81,24,28,85.7,8,42,50,35,3,5,14,19
295,MIL,0,240,49,93,52.7,16,39,41,33,54,61.11,22,25,88,8,30,38,27,12,5,14,21
296,MIN,1,240,43,94,45.7,20,41,48.8,23,53,43.4,20,29,69,16,41,57,31,5,2,14,21
297,TOR,0,240,40,83,48.2,16,32,50,24,51,47.06,15,18,83.3,7,29,36,27,10,6,16,19
298,NOP,1,240,45,101,44.6,5,29,17.2,40,72,55.56,14,19,73.7,15,41,56,26,11,6,12,22
299,ORL,1,240,43,85,50.6,10,29,34.5,33,56,58.93,13,20,65,9,40,49,26,9,7,15,21
300,SAS,0,240,41,88,46.6,10,32,31.3,31,56,55.36,19,24,79.2,7,33,40,26,6,3,9,20
301,UTA,1,240,55,86,64,24,41,58.5,31,45,68.89,20,21,95.2,8,39,47,36,4,9,14,15
302,PHI,1,240,48,89,53.9,16,36,44.4,32,53,60.38,15,22,68.2,11,35,46,29,12,10,8,22
303,CHI,0,240,39,85,45.9,10,29,34.5,29,56,51.79,6,10,60,7,36,43,29,2,4,14,12
304,SAC,0,240,42,87,48.3,7,21,33.3,35,66,53.03,14,17,82.4,3,21,24,24,8,6,13,19
305,DEN,1,240,43,85,50.6,10,32,31.3,33,53,62.26,18,23,78.3,3,35,38,26,14,8,18,17
306,MEM,0,240,37,88,42,9,32,28.1,28,56,50,26,30,86.7,8,36,44,26,7,6,11,21
307,NYK,1,240,42,91,46.2,12,27,44.4,30,64,46.88,17,19,89.5,9,32,41,27,10,9,4,16
308,ATL,0,240,27,81,33.3,6,19,31.6,21,62,33.87,23,29,79.3,17,30,47,17,3,3,15,18
309,LAL,0,240,42,96,43.8,10,34,29.4,32,62,51.61,13,21,61.9,13,28,41,31,10,8,10,20
310,PHX,1,240,43,91,47.3,13,37,35.1,30,54,55.56,10,13,76.9,15,30,45,23,9,4,10,11
311,POR,1,240,45,92,48.9,15,40,37.5,30,52,57.69,25,28,89.3,11,40,51,23,7,6,10,20
312,CLE,0,240,37,92,40.2,12,44,27.3,25,48,52.08,18,24,75,13,32,45,30,12,3,13,15
313,CHA,0,240,37,87,42.5,13,35,37.1,24,52,46.15,24,32,75,11,22,33,29,7,5,11,18
314,MIA,1,240,43,85,50.6,9,25,36,34,60,56.67,21,24,87.5,10,38,48,26,4,1,13,23
315,LAC,0,240,41,80,51.3,12,31,38.7,29,49,59.18,7,9,77.8,5,31,36,24,8,0,15,16
316,WAS,1,240,47,90,52.2,6,18,33.3,41,72,56.94,16,21,76.2,10,40,50,24,6,4,14,20
317,BOS,1,240,44,92,47.8,15,40,37.5,29,52,55.77,17,22,77.3,19,35,54,26,9,8,14,24
318,NOP,0,240,43,87,49.4,12,30,40,31,57,54.39,14,19,73.7,6,36,42,27,13,5,21,24
319,POR,1,240,50,106,47.2,20,35,57.1,30,71,42.25,13,16,81.3,20,37,57,26,6,5,13,19
320,TOR,0,240,36,91,39.6,15,43,34.9,21,48,43.75,16,19,84.2,15,32,47,24,5,3,13,19
321,GSW,0,240,34,84,40.5,16,43,37.2,18,41,43.9,19,24,79.2,10,33,43,25,11,5,18,18
322,MIN,1,240,45,93,48.4,10,38,26.3,35,55,63.64,14,25,56,12,36,48,29,10,6,14,20
323,MIL,1,240,47,93,50.5,9,35,25.7,38,58,65.52,11,14,78.6,9,39,48,28,13,3,15,24
324,OKC,1,240,39,81,48.1,13,30,43.3,26,51,50.98,28,36,77.8,10,41,51,25,5,3,27,24
325,DAL,1,240,48,92,52.2,18,35,51.4,30,57,52.63,19,22,86.4,9,41,50,21,9,4,13,19
326,BKN,1,240,40,83,48.2,18,45,40,22,38,57.89,18,18,100,7,34,41,30,9,6,11,20
327,IND,0,240,40,86,46.5,10,30,33.3,30,56,53.57,22,28,78.6,7,31,38,25,6,12,13,17
328,HOU,0,240,42,86,48.8,7,31,22.6,35,55,63.64,16,22,72.7,8,37,45,24,9,4,17,22
329,CHA,0,240,38,82,46.3,12,35,34.3,26,47,55.32,16,23,69.6,7,31,38,26,6,7,18,17
330,BOS,0,240,41,97,42.3,11,49,22.4,30,48,62.5,22,25,88,8,31,39,21,16,7,14,26
331,CHI,1,240,41,77,53.2,11,29,37.9,30,48,62.5,17,22,77.3,9,42,51,33,3,4,18,21
332,PHI,1,240,47,86,54.7,14,31,45.2,33,55,60,13,18,72.2,10,31,41,27,22,7,21,19
333,TOR,1,240,43,79,54.4,8,29,27.6,35,50,70,18,20,90,5,35,40,32,7,5,13,19
334,LAC,0,240,36,90,40,14,45,31.1,22,45,48.89,17,17,100,13,31,44,20,5,5,19,23
335,MIA,0,240,36,84,42.9,7,36,19.4,29,48,60.42,23,25,92,6,28,34,18,13,4,6,19
336,OKC,0,240,35,78,44.9,7,30,23.3,28,48,58.33,13,23,56.5,11,27,38,21,11,1,30,16
337,NYK,0,240,45,87,51.7,12,29,41.4,33,58,56.9,8,10,80,6,29,35,24,6,1,11,19
338,SAC,1,240,42,81,51.9,13,29,44.8,29,52,55.77,16,18,88.9,11,35,46,23,6,4,18,15
339,PHX,1,240,45,83,54.2,14,34,41.2,31,49,63.27,14,17,82.4,5,32,37,23,5,6,12,13
340,UTA,0,240,37,95,38.9,16,57,28.1,21,38,55.26,14,19,73.7,16,33,49,24,9,6,11,18
341,CLE,0,240,36,83,43.4,10,38,26.3,26,45,57.78,14,16,87.5,9,28,37,25,6,3,14,16
342,DAL,0,240,43,92,46.7,12,42,28.6,31,50,62,8,14,57.1,14,26,40,24,9,2,10,15
343,WAS,0,265,58,109,53.2,6,20,30,52,89,58.43,21,25,84,18,32,50,26,4,8,8,23
344,LAL,1,240,47,87,54,11,31,35.5,36,56,64.29,9,14,64.3,9,35,44,23,8,5,12,18
345,DEN,1,240,45,94,47.9,11,33,33.3,34,61,55.74,19,22,86.4,8,40,48,25,8,3,11,20
346,SAS,1,265,55,103,53.4,6,17,35.3,49,86,56.98,30,35,85.7,13,31,44,27,6,1,6,21
347,DET,1,240,40,84,47.6,9,26,34.6,31,58,53.45,11,15,73.3,8,39,47,22,9,8,14,16
348,ORL,0,240,36,76,47.4,11,25,44,25,51,49.02,20,24,83.3,4,24,28,16,5,3,11,18
349,ATL,0,240,33,85,38.8,4,27,14.8,29,58,50,16,17,94.1,9,36,45,19,10,4,16,17
350,NOP,1,240,44,82,53.7,15,29,51.7,29,53,54.72,17,26,65.4,8,36,44,28,13,5,16,18
351,MEM,0,240,34,81,42,4,32,12.5,30,49,61.22,24,31,77.4,6,39,45,20,8,6,16,22
352,MIN,1,240,37,83,44.6,16,44,36.4,21,39,53.85,15,21,71.4,8,40,48,29,7,4,16,21
353,BOS,0,240,34,88,38.6,14,41,34.1,20,47,42.55,22,26,84.6,11,30,41,18,6,2,13,13
354,GSW,1,240,46,95,48.4,14,36,38.9,32,59,54.24,11,15,73.3,17,36,53,30,5,3,17,16
355,PHX,0,240,43,90,47.8,12,34,35.3,31,56,55.36,21,25,84,15,28,43,22,5,3,12,24
356,CHA,1,240,47,93,50.5,21,43,48.8,26,50,52,10,11,90.9,10,36,46,39,7,8,11,21
357,ORL,0,240,40,101,39.6,10,32,31.3,30,69,43.48,22,28,78.6,15,36,51,22,9,3,7,14
358,POR,0,240,39,105,37.1,14,38,36.8,25,67,37.31,21,25,84,15,38,53,21,11,6,11,22
359,IND,1,240,50,91,54.9,15,32,46.9,35,59,59.32,16,18,88.9,5,43,48,28,3,5,13,20
360,BKN,1,240,46,87,52.9,13,28,46.4,33,59,55.93,23,27,85.2,11,33,44,30,6,4,11,17
361,SAC,0,240,41,86,47.7,14,37,37.8,27,49,55.1,17,22,77.3,6,31,37,22,8,5,11,15
362,WAS,1,240,43,89,48.3,12,31,38.7,31,58,53.45,21,26,80.8,10,26,36,25,11,6,10,21
363,ATL,1,240,40,88,45.5,13,35,37.1,27,53,50.94,18,23,78.3,5,39,44,23,6,1,10,20
364,CLE,0,240,40,78,51.3,10,27,37,30,51,58.82,20,25,80,10,27,37,28,5,4,19,25
365,MIL,0,240,39,81,48.1,8,28,28.6,31,53,58.49,18,23,78.3,4,37,41,20,6,6,12,18
366,MEM,1,240,42,91,46.2,12,23,52.2,30,68,44.12,24,28,85.7,8,46,54,22,9,7,15,22
367,CHI,0,240,38,79,48.1,13,38,34.2,25,41,60.98,12,13,92.3,6,36,42,28,7,2,18,20
368,MIA,1,240,36,80,45,14,37,37.8,22,43,51.16,20,24,83.3,6,31,37,22,11,2,13,12
369,NYK,1,240,42,75,56,16,31,51.6,26,44,59.09,20,24,83.3,5,39,44,20,4,4,15,17
370,DAL,1,240,38,78,48.7,13,30,43.3,25,48,52.08,19,25,76,10,41,51,26,3,2,18,17
371,SAS,1,240,37,85,43.5,9,31,29,28,54,51.85,27,32,84.4,9,37,46,22,9,8,17,23
372,MIN,1,240,40,92,43.5,9,38,23.7,31,54,57.41,12,20,60,11,36,47,15,13,2,14,19
373,PHI,0,240,31,82,37.8,7,31,22.6,24,51,47.06,25,34,73.5,10,31,41,15,11,4,17,20
374,NOP,0,240,41,87,47.1,9,22,40.9,32,65,49.23,17,32,53.1,10,38,48,20,12,1,20,24
375,IND,1,240,40,96,41.7,10,32,31.3,30,64,46.88,25,35,71.4,9,30,39,28,10,9,5,21
376,DET,0,240,39,96,40.6,10,34,29.4,29,62,46.77,21,26,80.8,15,47,62,26,3,7,18,25
377,LAL,0,240,33,86,38.4,12,45,26.7,21,41,51.22,15,19,78.9,6,30,36,22,11,4,9,22
378,HOU,0,240,41,82,50,15,40,37.5,26,42,61.9,19,28,67.9,6,29,35,27,10,1,16,16
379,TOR,0,240,36,83,43.4,17,44,38.6,19,39,48.72,14,19,73.7,5,28,33,31,6,3,7,19
380,MIL,1,240,49,95,51.6,18,40,45,31,55,56.36,16,24,66.7,16,39,55,33,10,4,16,28
381,UTA,0,240,33,82,40.2,19,47,40.4,14,35,40,11,15,73.3,9,36,45,24,9,5,20,21
382,DEN,1,240,50,84,59.5,16,37,43.2,34,47,72.34,13,16,81.3,1,35,36,36,8,8,15,22
383,CLE,0,240,41,80,51.3,10,30,33.3,31,50,62,10,14,71.4,11,36,47,27,4,1,17,20
384,WAS,1,240,48,93,51.6,18,32,56.3,30,61,49.18,15,16,93.8,12,38,50,25,7,7,20,23
385,MEM,1,240,52,98,53.1,9,30,30,43,68,63.24,17,22,77.3,8,31,39,33,7,5,9,21
386,DEN,0,240,34,88,38.6,13,46,28.3,21,42,50,16,20,80,6,30,36,26,9,7,9,14
387,GSW,1,240,45,84,53.6,15,39,38.5,30,45,66.67,13,18,72.2,7,45,52,40,8,4,15,15
388,CHA,1,240,40,94,42.6,14,40,35,26,54,48.15,14,18,77.8,15,23,38,26,7,1,5,16
389,LAC,1,240,39,97,40.2,12,34,35.3,27,63,42.86,19,23,82.6,14,44,58,22,8,3,14,19
390,OKC,0,240,39,93,41.9,10,33,30.3,29,60,48.33,21,25,84,14,26,40,18,12,7,17,17
391,POR,0,240,46,96,47.9,14,35,40,32,61,52.46,22,27,81.5,14,36,50,28,6,3,12,20
392,ATL,1,240,43,80,53.8,15,35,42.9,28,45,62.22,17,19,89.5,8,30,38,24,12,2,14,17
393,HOU,0,240,36,89,40.4,13,42,31,23,47,48.94,19,22,86.4,9,38,47,24,7,5,14,19
394,BKN,1,240,37,86,43,11,32,34.4,26,54,48.15,24,28,85.7,6,41,47,26,12,7,11,19
395,MIA,0,240,38,79,48.1,13,37,35.1,25,42,59.52,14,16,87.5,6,24,30,24,10,5,13,18
396,BOS,0,240,38,94,40.4,17,42,40.5,21,52,40.38,11,16,68.8,15,39,54,21,6,6,19,20
397,PHX,0,240,36,88,40.9,6,35,17.1,30,53,56.6,8,9,88.9,10,28,38,18,10,2,17,23
398,PHI,0,240,46,91,50.5,12,27,44.4,34,64,53.12,13,18,72.2,7,26,33,27,7,3,9,17
399,CHA,0,240,35,82,42.7,8,31,25.8,27,51,52.94,13,17,76.5,7,31,38,30,5,3,14,18
400,SAS,1,240,37,80,46.3,11,24,45.8,26,56,46.43,21,27,77.8,11,32,43,28,12,7,10,19
401,CHI,1,240,43,87,49.4,14,43,32.6,29,44,65.91,8,11,72.7,11,39,50,30,8,2,18,14
402,NOP,1,240,50,90,55.6,12,28,42.9,38,62,61.29,23,26,88.5,12,46,58,34,2,3,15,16
403,DET,0,240,35,77,45.5,8,22,36.4,27,55,49.09,13,22,59.1,9,34,43,15,2,5,18,22
404,BOS,1,240,33,77,42.9,12,40,30,21,37,56.76,21,24,87.5,10,38,48,20,7,2,23,12
405,DAL,1,240,40,82,48.8,9,24,37.5,31,58,53.45,26,36,72.2,9,29,38,23,11,5,12,15
406,ORL,0,240,36,98,36.7,13,36,36.1,23,62,37.1,15,19,78.9,13,27,40,13,6,6,6,18
407,MIL,1,240,45,81,55.6,20,40,50,25,41,60.98,14,23,60.9,6,39,45,32,6,8,16,16
408,LAL,0,240,43,90,47.8,10,30,33.3,33,60,55,14,17,82.4,12,33,45,26,7,5,16,28
409,ATL,0,265,49,102,48,12,34,35.3,37,68,54.41,17,24,70.8,12,29,41,28,10,3,10,18
410,UTA,1,240,41,90,45.6,17,46,37,24,44,54.55,13,16,81.3,9,52,61,27,7,4,12,16
411,CHI,0,240,39,79,49.4,13,37,35.1,26,42,61.9,14,18,77.8,7,34,41,27,6,4,20,24
412,MEM,0,240,38,84,45.2,13,30,43.3,25,54,46.3,16,23,69.6,11,31,42,19,6,8,13,29
413,DAL,1,240,46,92,50,16,43,37.2,30,49,61.22,19,26,73.1,11,32,43,25,8,2,6,22
414,NYK,1,265,49,91,53.8,19,35,54.3,30,56,53.57,20,25,80,8,41,49,29,8,3,17,19
415,MIN,0,240,46,87,52.9,15,34,44.1,31,53,58.49,18,22,81.8,9,25,34,30,7,4,12,21
416,MIA,1,240,39,83,47,13,31,41.9,26,52,50,16,20,80,9,35,44,28,8,1,8,20
417,LAC,1,240,38,84,45.2,14,27,51.9,24,57,42.11,27,36,75,10,33,43,28,4,5,13,17
418,CLE,1,240,45,88,51.1,16,36,44.4,29,52,55.77,15,19,78.9,9,32,41,27,8,1,12,19
419,TOR,1,240,39,90,43.3,18,47,38.3,21,43,48.84,18,21,85.7,9,39,48,23,7,8,11,20
420,PHX,1,240,41,86,47.7,15,42,35.7,26,44,59.09,19,21,90.5,10,23,33,30,7,8,10,21
421,DET,0,240,40,79,50.6,13,32,40.6,27,47,57.45,24,31,77.4,7,35,42,30,2,2,14,24
422,OKC,0,240,48,104,46.2,9,29,31,39,75,52,11,16,68.8,17,38,55,26,8,3,17,18
423,POR,0,240,40,87,46,12,36,33.3,28,51,54.9,13,15,86.7,9,32,41,21,7,2,11,16
424,WAS,1,240,38,91,41.8,10,28,35.7,28,63,44.44,32,38,84.2,15,46,61,23,12,7,23,16
425,IND,1,240,46,101,45.5,14,40,35,32,61,52.46,16,20,80,14,33,47,30,13,7,11,16
426,BKN,0,240,36,91,39.6,13,41,31.7,23,50,46,18,23,78.3,12,38,50,19,3,6,13,17
427,SAC,1,240,43,74,58.1,17,33,51.5,26,41,63.41,25,31,80.6,4,29,33,29,7,5,14,20
428,SAS,0,240,31,77,40.3,10,35,28.6,21,42,50,15,20,75,7,31,38,21,1,7,11,15
429,DEN,1,240,39,88,44.3,13,39,33.3,26,49,53.06,15,17,88.2,16,30,46,24,7,5,14,16
430,PHI,0,240,41,80,51.3,13,25,52,28,55,50.91,18,26,69.2,14,30,44,24,7,7,17,19
431,GSW,0,240,40,101,39.6,15,45,33.3,25,56,44.64,19,21,90.5,10,34,44,22,15,5,17,23
432,HOU,0,240,35,99,35.4,10,49,20.4,25,50,50,9,17,52.9,12,38,50,17,7,5,11,21
433,POR,0,240,42,94,44.7,14,44,31.8,28,50,56,14,19,73.7,13,29,42,22,7,4,6,16
434,ATL,1,240,39,94,41.5,9,34,26.5,30,60,50,25,29,86.2,18,47,65,20,6,3,14,22
435,SAC,0,240,44,97,45.4,18,42,42.9,26,55,47.27,14,16,87.5,13,26,39,28,10,3,11,17
436,NOP,0,240,51,91,56,12,33,36.4,39,58,67.24,15,24,62.5,7,30,37,28,5,2,13,21
437,MIN,1,240,51,90,56.7,18,43,41.9,33,47,70.21,14,19,73.7,12,38,50,34,5,9,18,16
438,NYK,1,240,40,83,48.2,18,45,40,22,38,57.89,11,12,91.7,11,28,39,22,5,6,12,13
439,ORL,0,240,34,86,39.5,8,37,21.6,26,49,53.06,20,29,69,6,34,40,13,11,3,10,19
440,BKN,1,240,49,89,55.1,14,37,37.8,35,52,67.31,22,28,78.6,10,34,44,30,7,2,13,21
441,LAC,1,240,45,90,50,11,38,28.9,34,52,65.38,12,15,80,10,35,45,24,3,3,10,15
442,CHA,0,240,39,86,45.3,16,39,41,23,47,48.94,3,8,37.5,11,28,39,26,6,3,13,10
443,LAL,0,240,34,79,43,12,28,42.9,22,51,43.14,17,25,68,5,27,32,17,10,1,10,14
444,MIL,0,265,49,102,48,11,34,32.4,38,68,55.88,18,19,94.7,9,42,51,19,7,3,12,15
445,OKC,0,240,36,83,43.4,13,33,39.4,23,50,46,22,27,81.5,9,39,48,23,6,2,19,26
446,PHX,1,265,51,106,48.1,17,42,40.5,34,64,53.12,9,10,90,8,37,45,28,7,4,11,16
447,MEM,0,290,51,107,47.7,17,40,42.5,34,67,50.75,18,24,75,10,37,47,33,15,3,15,24
448,DEN,1,290,51,102,50,15,39,38.5,36,63,57.14,22,26,84.6,13,45,58,30,6,6,24,19
449,PHI,0,240,35,89,39.3,12,32,37.5,23,57,40.35,14,18,77.8,10,32,42,26,9,6,13,21
450,WAS,1,240,46,91,50.5,10,31,32.3,36,60,60,17,29,58.6,8,34,42,31,8,2,12,19
451,SAS,1,240,36,84,42.9,8,28,28.6,28,56,50,29,35,82.9,9,48,57,27,4,4,12,23
452,HOU,0,240,33,85,38.8,9,38,23.7,24,47,51.06,16,17,94.1,6,35,41,20,8,3,13,7
453,DET,1,240,42,86,48.8,10,27,37,32,59,54.24,15,21,71.4,10,34,44,25,8,5,17,22
454,UTA,1,240,43,75,57.3,15,33,45.5,28,42,66.67,10,11,90.9,2,40,42,29,5,5,17,20
455,MIA,1,240,45,93,48.4,19,48,39.6,26,45,57.78,4,7,57.1,11,41,52,31,7,5,15,19
456,CHI,1,240,41,91,45.1,11,32,34.4,30,59,50.85,9,10,90,9,31,40,30,11,8,12,15
457,GSW,1,240,34,76,44.7,14,32,43.8,20,44,45.45,25,32,78.1,6,39,45,15,2,5,16,19
458,BOS,0,240,36,77,46.8,10,25,40,26,52,50,14,15,93.3,3,36,39,21,8,3,16,15
459,IND,0,240,34,104,32.7,8,34,23.5,26,70,37.14,18,27,66.7,14,40,54,20,4,7,7,27
460,CLE,0,240,42,86,48.8,5,26,19.2,37,60,61.67,16,20,80,9,30,39,24,9,8,18,21
461,DAL,0,240,39,87,44.8,16,48,33.3,23,39,58.97,13,20,65,10,32,42,15,3,8,14,20
462,LAC,1,240,45,89,50.6,21,42,50,24,47,51.06,13,17,76.5,8,40,48,31,6,3,15,26
463,CHA,1,240,39,83,47,18,43,41.9,21,40,52.5,13,17,76.5,7,39,46,26,6,8,14,25
464,MIA,1,240,38,87,43.7,16,39,41,22,48,45.83,17,21,81,16,37,53,28,9,1,17,13
465,ORL,0,240,41,91,45.1,11,32,34.4,30,59,50.85,17,19,89.5,9,27,36,28,10,5,15,19
466,TOR,1,240,37,96,38.5,17,38,44.7,20,58,34.48,21,24,87.5,16,31,47,23,9,5,15,15
467,BKN,0,240,39,82,47.6,17,43,39.5,22,39,56.41,12,18,66.7,8,30,38,26,10,6,11,17
468,NYK,1,265,45,95,47.4,11,29,37.9,34,66,51.52,21,24,87.5,13,36,49,27,9,6,13,26
469,IND,0,240,45,92,48.9,10,32,31.3,35,60,58.33,17,20,85,8,33,41,33,7,5,12,27
470,MIN,0,240,36,88,40.9,17,45,37.8,19,43,44.19,16,21,76.2,6,31,37,27,6,7,11,21
471,SAC,1,240,44,89,49.4,11,24,45.8,33,65,50.77,22,25,88,10,32,42,22,11,3,8,19
472,HOU,1,240,42,82,51.2,16,34,47.1,26,48,54.17,14,20,70,10,33,43,26,7,7,19,21
473,POR,0,240,36,91,39.6,10,36,27.8,26,55,47.27,19,28,67.9,13,34,47,18,7,3,9,17
474,OKC,0,240,37,82,45.1,14,33,42.4,23,49,46.94,18,21,85.7,9,37,46,22,6,8,23,19
475,ATL,1,240,45,92,48.9,13,32,40.6,32,60,53.33,26,34,76.5,14,37,51,20,8,7,10,19
476,NOP,0,265,41,101,40.6,6,27,22.2,35,74,47.3,24,30,80,20,32,52,25,6,4,13,16
477,SAS,1,240,45,89,50.6,12,29,41.4,33,60,55,9,12,75,5,41,46,23,10,9,13,17
478,CLE,0,240,39,88,44.3,12,30,40,27,58,46.55,6,7,85.7,11,33,44,27,6,1,11,10
479,WAS,1,240,50,94,53.2,9,16,56.3,41,78,52.56,12,19,63.2,10,38,48,25,11,6,14,24
480,MIL,0,240,39,91,42.9,16,47,34,23,44,52.27,21,27,77.8,13,32,45,27,7,1,16,8
481,BOS,1,240,44,94,46.8,15,46,32.6,29,48,60.42,16,20,80,14,31,45,18,9,2,9,18
482,MEM,1,240,51,93,54.8,15,40,37.5,36,53,67.92,11,12,91.7,7,36,43,31,10,3,11,18
483,CHI,1,240,41,82,50,16,40,40,25,42,59.52,8,9,88.9,4,34,38,30,6,2,10,15
484,UTA,0,265,42,101,41.6,23,59,39,19,42,45.24,8,8,100,6,31,37,31,10,3,16,21
485,GSW,0,240,41,80,51.3,17,40,42.5,24,40,60,15,20,75,8,32,40,22,6,2,18,23
486,LAL,1,265,48,93,51.6,11,33,33.3,37,60,61.67,20,23,87,11,41,52,26,8,8,15,14
487,DET,0,240,37,84,44,9,27,33.3,28,57,49.12,17,23,73.9,9,36,45,19,7,6,18,20
488,PHX,0,240,36,90,40,6,27,22.2,30,63,47.62,7,16,43.8,15,33,48,19,7,2,14,14
489,POR,1,240,41,89,46.1,11,29,37.9,30,60,50,14,16,87.5,9,29,38,23,9,6,11,12
490,DET,1,240,38,90,42.2,10,35,28.6,28,55,50.91,24,34,70.6,15,39,54,22,13,7,18,24
491,DAL,0,240,40,91,44,15,45,33.3,25,46,54.35,14,19,73.7,10,31,41,30,6,7,9,17
492,CHI,0,240,45,96,46.9,13,34,38.2,32,62,51.61,12,15,80,13,33,46,34,3,1,12,20
493,HOU,0,240,38,86,44.2,11,35,31.4,27,51,52.94,12,18,66.7,8,27,35,23,7,3,14,19
494,ORL,0,240,35,77,45.5,8,23,34.8,27,54,50,24,34,70.6,6,29,35,20,8,4,11,14
495,DEN,1,240,46,94,48.9,9,31,29,37,63,58.73,27,31,87.1,18,36,54,22,11,3,9,15
496,TOR,1,240,41,82,50,14,35,40,27,47,57.45,17,18,94.4,8,34,42,24,6,10,17,24
497,MIA,0,240,39,80,48.8,14,34,41.2,25,46,54.35,19,26,73.1,7,26,33,33,11,5,14,28
498,SAS,0,240,45,95,47.4,7,23,30.4,38,72,52.78,9,10,90,14,35,49,30,7,9,14,14
499,CHA,0,240,44,83,53,12,34,35.3,32,49,65.31,15,20,75,8,29,37,26,12,3,19,18
500,MEM,1,240,45,86,52.3,17,40,42.5,28,46,60.87,19,24,79.2,6,36,42,33,9,4,6,17
501,UTA,1,240,42,87,48.3,16,42,38.1,26,45,57.78,19,24,79.2,10,46,56,22,5,6,21,19
502,NYK,1,240,44,86,51.2,14,28,50,30,58,51.72,15,21,71.4,9,36,45,22,4,5,10,20
503,MIN,1,240,42,81,51.9,15,36,41.7,27,45,60,20,29,69,10,35,45,30,8,2,21,22
504,IND,0,240,41,105,39,13,39,33.3,28,66,42.42,16,17,94.1,14,29,43,23,13,3,10,19
505,BKN,1,240,47,85,55.3,21,41,51.2,26,44,59.09,15,16,93.8,7,30,37,35,12,5,18,17
506,NOP,0,265,40,97,41.2,7,28,25,33,69,47.83,28,33,84.8,11,45,56,26,11,7,16,22
507,WAS,1,265,45,96,46.9,4,27,14.8,41,69,59.42,23,32,71.9,3,43,46,24,5,7,13,24
508,PHI,1,240,35,83,42.2,14,44,31.8,21,39,53.85,22,30,73.3,11,35,46,21,13,7,13,19
509,LAC,0,240,37,82,45.1,19,39,48.7,18,43,41.86,10,16,62.5,8,35,43,26,6,3,19,26
510,OKC,0,240,39,97,40.2,7,39,17.9,32,58,55.17,19,26,73.1,18,38,56,19,13,8,22,23
511,ATL,0,240,39,86,45.3,14,34,41.2,25,52,48.08,17,19,89.5,8,31,39,23,5,4,12,15
512,MIL,1,240,46,95,48.4,16,43,37.2,30,52,57.69,12,17,70.6,14,37,51,25,8,1,9,16
513,PHX,1,240,48,86,55.8,14,38,36.8,34,48,70.83,12,14,85.7,10,29,39,30,9,4,11,18
514,SAC,0,240,43,78,55.1,14,30,46.7,29,48,60.42,14,19,73.7,4,28,32,22,7,4,15,16
515,BOS,1,240,48,85,56.5,14,32,43.8,34,53,64.15,11,13,84.6,7,41,48,33,4,6,21,20
516,LAL,0,240,44,98,44.9,12,37,32.4,32,61,52.46,13,19,68.4,11,25,36,28,12,2,8,16
517,GSW,1,240,47,92,51.1,17,46,37,30,46,65.22,8,10,80,9,38,47,33,9,5,16,24
518,CLE,0,240,35,81,43.2,10,31,32.3,25,50,50,21,27,77.8,8,31,39,21,11,2,15,20
519,NYK,1,240,44,97,45.4,17,33,51.5,27,64,42.19,11,13,84.6,11,37,48,19,6,5,6,17
520,SAS,0,240,38,89,42.7,17,39,43.6,21,50,42,19,27,70.4,12,29,41,26,6,7,13,19
521,SAC,0,240,42,91,46.2,9,27,33.3,33,64,51.56,18,24,75,5,25,30,22,17,8,17,22
522,DAL,1,240,44,88,50,13,40,32.5,31,48,64.58,13,17,76.5,8,37,45,25,4,3,11,17
523,DET,0,240,37,85,43.5,7,24,29.2,30,61,49.18,17,22,77.3,11,35,46,17,5,4,16,21
524,MIL,1,240,46,98,46.9,19,40,47.5,27,58,46.55,19,23,82.6,7,45,52,26,14,4,16,20
525,ORL,1,240,44,89,49.4,12,27,44.4,32,62,51.61,15,20,75,13,33,46,29,8,10,7,15
526,MEM,0,240,42,90,46.7,13,34,38.2,29,56,51.79,16,21,76.2,11,34,45,27,7,3,7,18
527,MIN,0,240,34,92,37,15,41,36.6,19,51,37.25,22,31,71,10,37,47,22,13,7,16,17
528,CLE,1,240,37,76,48.7,13,31,41.9,24,45,53.33,16,19,84.2,9,38,47,27,9,7,16,11
529,CHA,0,240,34,84,40.5,16,44,36.4,18,40,45,6,12,50,10,28,38,23,8,5,13,18
530,BKN,0,240,43,83,51.8,4,21,19,39,62,62.9,27,30,90,11,32,43,23,6,3,16,21
531,GSW,1,240,52,95,54.7,24,47,51.1,28,48,58.33,19,23,82.6,9,32,41,39,12,6,14,20
532,PHI,1,240,45,87,51.7,13,28,46.4,32,59,54.24,20,25,80,4,28,32,23,8,9,10,21
533,WAS,1,240,47,90,52.2,7,24,29.2,40,66,60.61,22,27,81.5,14,42,56,23,12,3,26,18
534,HOU,0,240,48,104,46.2,10,34,29.4,38,70,54.29,18,22,81.8,16,31,47,22,12,6,15,17
535,OKC,0,240,44,92,47.8,7,27,25.9,37,65,56.92,14,25,56,17,33,50,22,6,2,21,22
536,LAC,1,240,37,93,39.8,7,29,24.1,30,64,46.88,19,21,90.5,15,32,47,10,8,2,11,20
537,DEN,1,240,48,89,53.9,17,36,47.2,31,53,58.49,10,13,76.9,11,32,43,32,5,7,11,19
538,IND,1,240,50,94,53.2,15,36,41.7,35,58,60.34,17,22,77.3,11,37,48,28,10,6,18,16
539,TOR,1,240,41,88,46.6,14,30,46.7,27,58,46.55,21,25,84,13,41,54,21,8,5,16,19
540,NOP,0,240,40,88,45.5,6,28,21.4,34,60,56.67,20,24,83.3,9,40,49,25,3,5,9,12
541,CHI,0,240,41,86,47.7,17,37,45.9,24,49,48.98,7,9,77.8,7,33,40,23,7,6,12,16
542,MIA,0,240,39,79,49.4,13,32,40.6,26,47,55.32,15,18,83.3,4,26,30,29,7,8,8,13
543,TOR,0,240,42,88,47.7,10,39,25.6,32,49,65.31,9,13,69.2,6,36,42,16,7,4,13,19
544,LAL,1,240,34,82,41.5,16,44,36.4,18,38,47.37,17,18,94.4,8,30,38,24,9,2,11,18
545,BOS,1,240,42,90,46.7,15,35,42.9,27,55,49.09,17,24,70.8,9,37,46,30,5,4,10,19
546,BKN,1,240,46,91,50.5,15,36,41.7,31,55,56.36,20,24,83.3,11,46,57,31,8,4,19,22
547,CHA,0,240,36,83,43.4,9,35,25.7,27,48,56.25,12,18,66.7,12,33,45,22,5,3,18,18
548,PHX,1,240,38,82,46.3,13,42,31,25,40,62.5,17,18,94.4,9,39,48,28,11,2,21,18
549,OKC,0,240,36,93,38.7,14,34,41.2,22,59,37.29,10,18,55.6,15,35,50,13,8,1,14,23
550,ATL,1,240,40,84,47.6,13,30,43.3,27,54,50,15,22,68.2,8,31,39,21,7,2,14,16
551,UTA,1,240,36,86,41.9,17,47,36.2,19,39,48.72,17,20,85,11,40,51,24,6,10,14,18
552,POR,0,240,43,90,47.8,17,43,39.5,26,47,55.32,12,17,70.6,8,38,46,31,6,5,14,22
553,MIA,0,240,31,82,37.8,9,44,20.5,22,38,57.89,15,19,78.9,8,28,36,24,13,2,18,20
554,MIN,0,240,30,87,34.5,13,49,26.5,17,38,44.74,24,33,72.7,11,33,44,16,13,12,14,20
555,IND,0,240,44,96,45.8,9,40,22.5,35,56,62.5,18,22,81.8,9,33,42,14,9,5,12,17
556,LAC,1,240,48,89,53.9,13,28,46.4,35,61,57.38,17,19,89.5,6,42,48,34,10,5,14,20
557,HOU,0,240,44,87,50.6,17,42,40.5,27,45,60,15,19,78.9,12,39,51,32,9,3,21,15
558,CHI,0,240,36,86,41.9,5,31,16.1,31,55,56.36,13,17,76.5,8,32,40,23,8,3,17,16
559,WAS,1,240,47,90,52.2,9,19,47.4,38,71,53.52,22,28,78.6,8,36,44,29,7,4,8,27
560,PHX,1,240,45,94,47.9,25,45,55.6,20,49,40.82,11,18,61.1,12,30,42,33,14,3,14,18
561,UTA,0,240,41,85,48.2,15,36,41.7,26,49,53.06,24,31,77.4,9,34,43,21,2,3,14,23
562,NYK,1,240,42,89,47.2,5,27,18.5,37,62,59.68,22,27,81.5,15,32,47,18,14,9,15,20
563,PHI,1,240,39,80,48.8,12,31,38.7,27,49,55.1,23,33,69.7,6,34,40,24,9,4,9,20
564,DEN,0,240,39,83,47,8,26,30.8,31,57,54.39,21,25,84,10,31,41,23,11,2,20,24
565,SAC,0,240,39,90,43.3,10,35,28.6,29,55,52.73,22,37,59.5,8,26,34,21,14,3,10,26
566,NOP,1,240,42,77,54.5,6,19,31.6,36,58,62.07,27,39,69.2,9,42,51,24,8,5,23,23
567,SAS,1,240,48,93,51.6,10,25,40,38,68,55.88,14,18,77.8,12,35,47,30,6,5,9,26
568,MEM,1,240,40,85,47.1,9,28,32.1,31,57,54.39,12,14,85.7,10,41,51,27,7,7,20,20
569,GSW,1,240,39,81,48.1,18,44,40.9,21,37,56.76,20,22,90.9,4,32,36,23,11,3,16,22
570,ORL,0,240,36,80,45,5,20,25,31,60,51.67,20,32,62.5,11,33,44,15,6,2,15,17
571,DAL,0,240,35,83,42.2,9,36,25,26,47,55.32,16,20,80,11,35,46,16,7,3,15,24
572,LAL,0,240,35,80,43.8,12,36,33.3,23,44,52.27,14,18,77.8,4,29,33,22,5,7,25,21
573,IND,1,240,52,99,52.5,13,37,35.1,39,62,62.9,15,17,88.2,15,38,53,35,5,10,12,16
574,DEN,0,240,32,88,36.4,8,34,23.5,24,54,44.44,15,18,83.3,13,33,46,23,5,4,9,20
575,MIN,1,240,40,81,49.4,16,36,44.4,24,45,53.33,25,25,100,3,33,36,27,7,6,15,14
576,DAL,0,240,45,94,47.9,13,42,31,32,52,61.54,14,15,93.3,11,26,37,25,5,3,12,21
577,BOS,1,240,39,87,44.8,7,33,21.2,32,54,59.26,20,23,87,10,42,52,20,4,7,11,18
578,MIL,1,240,46,94,48.9,19,40,47.5,27,54,50,13,15,86.7,12,44,56,28,8,7,12,15
579,CLE,0,240,41,85,48.2,13,40,32.5,28,45,62.22,14,17,82.4,9,27,36,29,7,5,17,23
580,CHA,0,240,37,80,46.3,15,43,34.9,22,37,59.46,12,14,85.7,6,32,38,28,5,5,12,14
581,POR,0,240,37,77,48.1,11,35,31.4,26,42,61.9,13,19,68.4,8,33,41,21,5,5,17,16
582,DET,0,240,46,87,52.9,15,32,46.9,31,55,56.36,17,19,89.5,12,19,31,33,12,4,13,24
583,NYK,1,240,35,88,39.8,9,35,25.7,26,53,49.06,23,27,85.2,11,35,46,19,9,4,13,19
584,TOR,0,240,33,79,41.8,11,34,32.4,22,45,48.89,19,23,82.6,5,35,40,19,8,7,17,23
585,SAS,1,240,45,83,54.2,8,21,38.1,37,62,59.68,21,27,77.8,10,31,41,20,10,7,15,20
586,ATL,1,240,38,84,45.2,17,39,43.6,21,45,46.67,12,16,75,7,34,41,27,7,1,12,11
587,NOP,1,240,44,86,51.2,7,24,29.2,37,62,59.68,21,26,80.8,14,36,50,30,9,3,16,16
588,MEM,0,240,53,115,46.1,6,20,30,47,95,49.47,13,19,68.4,24,26,50,27,11,6,6,12
589,LAC,1,240,50,80,62.5,15,27,55.6,35,53,66.04,16,21,76.2,7,30,37,35,4,5,17,18
590,MIA,1,240,41,83,49.4,12,29,41.4,29,54,53.7,13,20,65,6,24,30,21,12,4,8,18
591,ORL,0,240,32,86,37.2,8,36,22.2,24,50,48,15,19,78.9,7,30,37,19,8,6,14,13
592,CHI,0,240,47,92,51.1,15,38,39.5,32,54,59.26,8,13,61.5,8,30,38,30,10,8,14,19
593,DET,0,240,37,83,44.6,9,26,34.6,28,57,49.12,20,28,71.4,9,29,38,25,9,6,12,23
594,PHI,1,240,44,94,46.8,12,38,31.6,32,56,57.14,17,25,68,13,34,47,24,11,10,10,17
595,GSW,1,240,49,91,53.8,14,35,40,35,56,62.5,13,16,81.3,9,36,45,31,13,5,16,19
596,CLE,0,240,39,86,45.3,15,35,42.9,24,51,47.06,22,26,84.6,7,25,32,27,11,5,17,13
597,SAC,0,240,42,88,47.7,14,42,33.3,28,46,60.87,14,22,63.6,4,34,38,23,8,4,10,23
598,PHX,1,240,55,107,51.4,17,43,39.5,38,64,59.38,7,7,100,5,40,45,36,8,3,3,18
599,OKC,0,240,38,76,50,8,20,40,30,56,53.57,9,19,47.4,6,39,45,21,3,4,23,21
600,HOU,0,240,41,88,46.6,13,37,35.1,28,51,54.9,14,20,70,13,32,45,25,8,3,18,17
601,UTA,1,240,40,88,45.5,18,50,36,22,38,57.89,30,35,85.7,11,41,52,22,8,5,10,17
602,TOR,1,240,53,86,61.6,17,32,53.1,36,54,66.67,12,14,85.7,5,34,39,29,12,11,19,18
603,LAL,1,240,47,93,50.5,19,34,55.9,28,59,47.46,13,20,65,12,35,47,30,12,4,15,24
604,POR,1,240,43,90,47.8,13,29,44.8,30,61,49.18,19,24,79.2,14,35,49,18,5,8,16,20
605,WAS,0,240,39,84,46.4,9,25,36,30,59,50.85,19,28,67.9,7,42,49,27,2,1,16,12
606,BKN,0,240,35,80,43.8,5,27,18.5,30,53,56.6,26,30,86.7,9,33,42,19,6,10,19,20
607,HOU,0,240,39,83,47,12,37,32.4,27,46,58.7,19,27,70.4,12,29,41,28,3,6,14,15
608,MEM,0,265,47,94,50,14,30,46.7,33,64,51.56,21,34,61.8,10,33,43,33,7,6,14,27
609,CHI,0,240,41,86,47.7,13,33,39.4,28,53,52.83,13,14,92.9,8,30,38,25,6,1,13,17
610,BOS,1,265,47,87,54,19,42,45.2,28,45,62.22,32,34,94.1,9,36,45,32,9,5,21,25
611,ORL,0,240,38,90,42.2,6,24,25,32,66,48.48,24,31,77.4,12,38,50,23,3,8,15,22
612,GSW,0,240,41,88,46.6,11,36,30.6,30,52,57.69,14,21,66.7,8,33,41,27,15,3,13,20
613,NYK,1,265,45,96,46.9,14,32,43.8,31,64,48.44,29,33,87.9,11,37,48,24,7,7,14,25
614,CHA,1,240,44,91,48.4,19,50,38,25,41,60.98,20,22,90.9,13,36,49,35,4,10,20,19
615,DEN,1,240,43,79,54.4,14,27,51.9,29,52,55.77,21,23,91.3,9,37,46,32,5,4,18,22
616,MIN,0,265,47,96,49,15,42,35.7,32,54,59.26,27,30,90,9,28,37,30,14,0,15,26
617,WAS,1,240,43,89,48.3,5,19,26.3,38,70,54.29,19,24,79.2,11,36,47,30,6,1,18,16
618,MIL,0,240,44,98,44.9,14,38,36.8,30,60,50,17,23,73.9,13,35,48,23,10,3,17,14
619,NOP,1,240,39,90,43.3,4,22,18.2,35,68,51.47,19,30,63.3,10,46,56,22,11,7,14,17
620,SAS,0,240,43,93,46.2,9,27,33.3,34,66,51.52,24,28,85.7,11,27,38,33,10,2,9,21
621,PHI,0,240,33,79,41.8,11,31,35.5,22,48,45.83,17,24,70.8,4,43,47,20,8,5,19,23
622,LAC,1,240,48,88,54.5,19,37,51.4,29,51,56.86,11,13,84.6,4,34,38,31,10,4,10,24
623,IND,1,240,38,92,41.3,11,33,33.3,27,59,45.76,24,28,85.7,11,38,49,26,8,10,14,24
624,ATL,1,240,47,84,56,7,27,25.9,40,57,70.18,19,23,82.6,6,35,41,25,7,4,9,14
625,UTA,1,240,43,95,45.3,12,42,28.6,31,53,58.49,24,27,88.9,14,44,58,21,4,3,7,15
626,MIL,0,240,38,100,38,12,33,36.4,26,67,38.81,13,16,81.3,14,38,52,16,8,1,9,20
627,CLE,1,240,48,94,51.1,13,37,35.1,35,57,61.4,20,24,83.3,9,35,44,35,8,3,7,12
628,CHI,1,240,47,87,54,12,30,40,35,57,61.4,16,18,88.9,12,37,49,35,5,3,16,16
629,MIA,1,240,34,71,47.9,10,25,40,24,46,52.17,32,40,80,9,29,38,22,12,8,21,25
630,PHX,0,240,36,71,50.7,6,24,25,30,47,63.83,25,30,83.3,9,27,36,20,6,6,15,18
631,LAC,1,240,42,84,50,18,37,48.6,24,47,51.06,11,12,91.7,9,26,35,26,5,1,11,22
632,DET,1,240,44,84,52.4,8,23,34.8,36,61,59.02,17,20,85,7,36,43,24,7,4,16,24
633,TOR,0,240,42,97,43.3,11,34,32.4,31,63,49.21,18,22,81.8,15,26,41,19,10,4,10,20
634,DAL,1,240,43,97,44.3,17,45,37.8,26,52,50,13,18,72.2,15,41,56,23,6,8,11,15
635,LAL,0,240,35,79,44.3,12,35,34.3,23,44,52.27,22,25,88,10,30,40,26,9,3,22,24
636,POR,0,240,38,96,39.6,13,48,27.1,25,48,52.08,14,18,77.8,9,32,41,18,3,5,6,21
637,SAC,0,240,38,86,44.2,7,30,23.3,31,56,55.36,18,26,69.2,6,32,38,20,9,4,12,21
638,OKC,0,240,40,89,44.9,13,32,40.6,27,57,47.37,9,13,69.2,11,33,44,28,5,5,18,20
639,DEN,1,240,40,91,44,8,26,30.8,32,65,49.23,18,24,75,12,41,53,26,10,6,19,18
640,CHA,1,240,43,97,44.3,15,44,34.1,28,53,52.83,12,13,92.3,11,31,42,27,12,5,12,16
641,DAL,0,240,33,87,37.9,10,39,25.6,23,48,47.92,17,22,77.3,11,35,46,16,4,5,9,15
642,ATL,0,240,45,101,44.6,10,28,35.7,35,73,47.95,13,15,86.7,11,31,42,26,5,3,7,19
643,ORL,0,240,44,93,47.3,12,31,38.7,32,62,51.61,16,23,69.6,11,28,39,22,11,3,11,16
644,SAS,0,240,38,91,41.8,6,24,25,32,67,47.76,14,21,66.7,11,31,42,23,11,4,15,19
645,MIN,0,240,48,91,52.7,10,28,35.7,38,63,60.32,31,40,77.5,13,29,42,30,7,2,13,17
646,BKN,1,240,51,92,55.4,19,41,46.3,32,51,62.75,18,22,81.8,10,35,45,37,10,8,17,31
647,HOU,1,240,38,88,43.2,17,44,38.6,21,44,47.73,9,16,56.3,10,39,49,21,7,5,11,18
648,OKC,0,240,37,85,43.5,16,41,39,21,44,47.73,12,17,70.6,11,35,46,29,4,5,22,11
649,PHX,1,265,45,101,44.6,11,34,32.4,34,67,50.75,16,20,80,16,45,61,20,7,5,14,21
650,BOS,1,240,36,86,41.9,15,40,37.5,21,46,45.65,14,20,70,16,37,53,22,6,7,20,14
651,WAS,1,240,49,85,57.6,19,36,52.8,30,49,61.22,14,16,87.5,5,32,37,35,7,3,13,18
652,MEM,1,240,48,89,53.9,17,40,42.5,31,49,63.27,18,21,85.7,11,43,54,30,5,5,14,17
653,IND,1,240,55,93,59.1,14,28,50,41,65,63.08,17,19,89.5,7,28,35,32,6,7,13,28
654,UTA,0,265,46,103,44.7,11,44,25,35,59,59.32,10,15,66.7,7,38,45,14,6,4,13,23
655,NOP,0,240,38,89,42.7,6,27,22.2,32,62,51.61,29,39,74.4,17,23,40,23,9,2,15,14
656,NYK,0,240,35,84,41.7,16,33,48.5,19,51,37.25,13,16,81.3,5,34,39,22,7,4,14,21
657,CHI,1,240,44,94,46.8,14,33,42.4,30,61,49.18,11,14,78.6,14,43,57,28,9,5,21,12
658,LAL,1,240,39,79,49.4,18,40,45,21,39,53.85,14,22,63.6,11,38,49,29,8,7,22,24
659,MEM,1,240,46,84,54.8,17,41,41.5,29,43,67.44,15,20,75,9,33,42,30,11,2,14,13
660,MIA,0,240,44,82,53.7,13,33,39.4,31,49,63.27,11,18,61.1,7,28,35,34,9,4,14,16
661,LAC,1,240,46,89,51.7,16,41,39,30,48,62.5,25,30,83.3,8,40,48,24,5,5,8,24
662,PHI,1,240,34,73,46.6,9,24,37.5,25,49,51.02,29,39,74.4,9,29,38,16,11,4,13,20
663,BOS,0,240,33,70,47.1,14,34,41.2,19,36,52.78,16,18,88.9,3,29,32,19,5,6,22,22
664,DEN,1,240,56,94,59.6,14,31,45.2,42,63,66.67,8,9,88.9,13,31,44,36,7,5,11,20
665,GSW,1,240,46,96,47.9,15,40,37.5,31,56,55.36,15,17,88.2,12,30,42,28,6,5,11,18
666,IND,0,240,38,88,43.2,9,30,30,29,58,50,12,16,75,6,27,33,20,15,12,15,17
667,MIL,0,240,44,86,51.2,14,32,43.8,30,54,55.56,19,22,86.4,6,34,40,25,7,2,14,13
668,ATL,1,240,44,88,50,20,31,64.5,24,57,42.11,15,22,68.2,10,32,42,24,7,6,11,23
669,TOR,0,240,36,91,39.6,5,33,15.2,31,58,53.45,24,30,80,15,27,42,17,13,3,12,19
670,POR,0,240,37,92,40.2,11,36,30.6,26,56,46.43,31,37,83.8,14,34,48,18,4,5,7,22
671,NOP,0,240,37,91,40.7,12,38,31.6,25,53,47.17,21,28,75,16,33,49,24,7,7,14,15
672,DET,0,240,44,81,54.3,15,35,42.9,29,46,63.04,16,20,80,7,23,30,27,4,2,13,12
673,SAC,0,240,39,88,44.3,9,36,25,30,52,57.69,19,24,79.2,10,32,42,27,9,8,15,19
674,BKN,1,240,42,92,45.7,10,32,31.3,32,60,53.33,20,26,76.9,11,34,45,27,6,6,10,14
675,OKC,0,240,41,97,42.3,5,27,18.5,36,70,51.43,21,25,84,13,29,42,17,10,6,15,20
676,DAL,1,240,41,91,45.1,23,49,46.9,18,42,42.86,6,8,75,10,34,44,22,2,2,10,18
677,SAS,0,240,35,83,42.2,5,26,19.2,30,57,52.63,26,32,81.3,8,30,38,22,4,3,10,22
678,UTA,0,240,37,88,42,12,44,27.3,25,44,56.82,17,22,77.3,14,34,48,20,3,4,9,18
679,WAS,0,240,37,94,39.4,12,35,34.3,25,59,42.37,15,18,83.3,15,39,54,21,7,5,18,18
680,MIN,1,240,38,91,41.8,12,32,37.5,26,59,44.07,28,33,84.8,15,36,51,22,10,4,14,16
681,DET,1,240,49,95,51.6,13,28,46.4,36,67,53.73,21,24,87.5,13,37,50,32,10,7,14,20
682,TOR,1,240,44,94,46.8,7,33,21.2,37,61,60.66,8,11,72.7,6,39,45,22,11,9,13,20
683,PHX,1,240,44,86,51.2,18,37,48.6,26,49,53.06,27,31,87.1,6,31,37,29,11,3,11,22
684,HOU,0,240,43,79,54.4,17,33,51.5,26,46,56.52,27,33,81.8,5,33,38,28,6,3,18,25
685,CLE,1,240,45,86,52.3,12,34,35.3,33,52,63.46,23,27,85.2,7,40,47,29,5,4,9,24
686,NYK,0,240,40,86,46.5,14,29,48.3,26,57,45.61,18,22,81.8,5,36,41,24,7,4,12,25
687,CHI,1,240,43,78,55.1,8,22,36.4,35,56,62.5,21,30,70,6,34,40,29,4,3,9,11
688,MEM,1,240,44,89,49.4,16,38,42.1,28,51,54.9,12,15,80,10,39,49,30,6,10,12,23
689,CHA,0,240,32,80,40,10,31,32.3,22,49,44.9,12,20,60,9,33,42,23,3,5,17,15
690,BOS,1,240,43,94,45.7,21,54,38.9,22,40,55,9,11,81.8,14,30,44,29,11,5,6,20
691,GSW,0,240,43,92,46.7,10,40,25,33,52,63.46,15,21,71.4,9,36,45,25,12,6,16,26
692,LAL,0,240,32,80,40,7,23,30.4,25,57,43.86,15,20,75,7,29,36,16,9,7,19,11
693,LAC,1,240,41,86,47.7,14,28,50,27,58,46.55,8,9,88.9,13,37,50,23,10,4,20,25
694,ORL,0,240,42,89,47.2,13,35,37.1,29,54,53.7,12,17,70.6,10,26,36,27,11,4,12,26
695,HOU,0,240,41,89,46.1,16,40,40,25,49,51.02,17,24,70.8,9,39,48,25,3,3,17,24
696,DEN,1,240,43,88,48.9,9,29,31,34,59,57.63,24,31,77.4,19,35,54,27,6,5,15,14
697,NOP,1,240,42,91,46.2,16,37,43.2,26,54,48.15,22,35,62.9,16,39,55,26,12,9,15,27
698,PHI,0,240,37,89,41.6,8,34,23.5,29,55,52.73,18,28,64.3,16,34,50,23,4,6,11,19
699,ATL,1,240,35,81,43.2,12,32,37.5,23,49,46.94,35,45,77.8,10,39,49,19,10,3,15,19
700,BKN,0,240,45,93,48.4,11,28,39.3,34,65,52.31,6,7,85.7,4,31,35,28,3,3,5,17
701,POR,1,240,51,104,49,20,46,43.5,31,58,53.45,11,14,78.6,15,41,56,25,13,3,9,18
702,SAS,0,265,48,99,48.5,10,29,34.5,38,70,54.29,27,32,84.4,18,28,46,22,6,6,18,21
703,NYK,1,240,43,79,54.4,19,39,48.7,24,40,60,20,27,74.1,7,37,44,31,12,11,7,18
704,DAL,1,240,40,90,44.4,10,30,33.3,30,60,50,19,24,79.2,14,36,50,17,7,4,8,22
705,PHI,1,240,41,81,50.6,12,28,42.9,29,53,54.72,28,37,75.7,8,34,42,26,7,7,12,24
706,MIL,1,240,50,93,53.8,11,31,35.5,39,62,62.9,18,20,90,12,35,47,31,10,3,13,15
707,OKC,0,240,30,85,35.3,8,34,23.5,22,51,43.14,17,24,70.8,12,34,46,17,4,6,22,21
708,DET,0,240,29,82,35.4,9,28,32.1,20,54,37.04,14,20,70,12,31,43,20,4,4,15,20
709,WAS,0,240,35,86,40.7,5,25,20,30,61,49.18,12,15,80,9,35,44,12,4,3,14,21
710,MIA,1,240,44,82,53.7,15,38,39.5,29,44,65.91,12,16,75,4,33,37,35,6,3,11,20
711,IND,1,265,52,94,55.3,12,29,41.4,40,65,61.54,23,26,88.5,11,33,44,27,10,6,14,22
712,SAC,0,240,49,99,49.5,17,39,43.6,32,60,53.33,13,13,100,12,28,40,31,7,4,12,17
713,UTA,1,240,51,92,55.4,26,55,47.3,25,37,67.57,9,12,75,7,43,50,34,10,6,11,25
714,ORL,0,240,32,87,36.8,2,23,8.7,30,64,46.88,25,31,80.6,9,30,39,11,5,4,11,14
715,MIN,0,240,35,78,44.9,12,36,33.3,23,42,54.76,31,36,86.1,6,30,36,17,7,5,11,24
716,CLE,0,240,35,74,47.3,10,31,32.3,25,43,58.14,21,25,84,5,30,35,25,7,4,16,15
717,UTA,1,240,37,79,46.8,13,36,36.1,24,43,55.81,26,27,96.3,6,37,43,16,6,5,11,18
718,TOR,1,240,47,88,53.4,15,35,42.9,32,53,60.38,21,25,84,10,43,53,26,14,8,12,17
719,ATL,1,240,49,87,56.3,13,29,44.8,36,58,62.07,15,21,71.4,6,36,42,25,10,9,15,23
720,CHI,0,240,43,89,48.3,7,28,25,36,61,59.02,13,17,76.5,7,34,41,26,5,3,7,19
721,MIL,1,240,49,90,54.4,12,39,30.8,37,51,72.55,17,19,89.5,4,46,50,25,7,5,15,18
722,POR,0,240,36,99,36.4,21,54,38.9,15,45,33.33,16,22,72.7,13,32,45,19,11,3,14,18
723,SAC,0,240,36,85,42.4,10,35,28.6,26,50,52,12,16,75,6,32,38,24,8,5,15,16
724,GSW,0,240,26,79,32.9,11,34,32.4,15,45,33.33,14,18,77.8,7,31,38,19,5,4,21,18
725,PHX,1,240,54,90,60,15,33,45.5,39,57,68.42,17,21,81,6,35,41,36,12,8,10,20
726,LAL,1,240,43,91,47.3,17,33,51.5,26,58,44.83,12,20,60,13,42,55,26,10,2,17,19
727,BOS,1,240,46,88,52.3,17,41,41.5,29,47,61.7,9,12,75,11,39,50,35,9,7,15,22
728,NOP,0,240,38,88,43.2,8,29,27.6,30,59,50.85,19,23,82.6,5,29,34,22,7,6,15,18
729,NYK,0,240,32,89,36,12,38,31.6,20,51,39.22,10,10,100,9,34,43,18,7,3,12,17
730,CHA,1,240,43,95,45.3,8,31,25.8,35,64,54.69,20,29,69,11,33,44,27,16,3,10,16
731,IND,0,240,38,82,46.3,10,33,30.3,28,49,57.14,11,19,57.9,9,39,48,29,7,6,20,21
732,OKC,0,240,35,89,39.3,15,38,39.5,20,51,39.22,18,23,78.3,11,27,38,19,6,3,16,17
733,MIN,0,240,38,85,44.7,12,33,36.4,26,52,50,20,23,87,5,34,39,21,6,6,11,20
734,HOU,0,240,37,86,43,12,36,33.3,25,50,50,16,26,61.5,10,30,40,26,6,1,14,11
735,DAL,1,240,41,88,46.6,12,37,32.4,29,51,56.86,5,10,50,4,43,47,19,6,2,10,12
736,MEM,1,240,42,95,44.2,19,39,48.7,23,56,41.07,17,25,68,14,39,53,26,8,4,12,20
737,ORL,1,265,45,106,42.5,5,25,20,40,81,49.38,20,23,87,12,36,48,20,17,5,11,20
738,WAS,0,240,40,85,47.1,5,19,26.3,35,66,53.03,6,19,31.6,4,36,40,25,6,6,15,21
739,DEN,1,240,39,81,48.1,13,25,52,26,56,46.43,10,14,71.4,7,31,38,28,6,5,13,16
740,PHI,1,240,40,93,43,15,37,40.5,25,56,44.64,19,25,76,12,43,55,27,11,8,10,19
741,SAS,0,290,49,110,44.5,13,40,32.5,36,70,51.43,18,24,75,11,35,46,25,8,6,6,22
742,NOP,0,265,41,93,44.1,12,29,41.4,29,64,45.31,16,19,84.2,12,43,55,26,7,7,25,23
743,BKN,1,240,44,91,48.4,20,45,44.4,24,46,52.17,3,4,75,13,43,56,34,8,5,15,18
744,DET,1,240,45,94,47.9,12,29,41.4,33,65,50.77,18,22,81.8,10,38,48,31,8,5,13,18
745,MIA,1,240,39,82,47.6,13,39,33.3,26,43,60.47,25,30,83.3,5,32,37,30,10,6,12,22
746,CLE,0,240,34,80,42.5,10,35,28.6,24,45,53.33,16,21,76.2,4,36,40,26,5,3,18,24
747,ATL,1,290,50,100,50,13,24,54.2,37,76,48.68,21,26,80.8,10,47,57,28,3,9,12,22
748,CHA,0,240,30,86,34.9,13,38,34.2,17,48,35.42,16,19,84.2,11,32,43,22,11,5,12,9
749,GSW,0,240,36,82,43.9,15,37,40.5,21,45,46.67,22,25,88,12,34,46,23,7,3,20,26
750,LAC,0,240,35,85,41.2,10,34,29.4,25,51,49.02,14,16,87.5,13,32,45,17,6,5,12,19
751,CHI,0,240,43,99,43.4,11,33,33.3,32,66,48.48,19,21,90.5,18,32,50,27,6,4,10,20
752,POR,1,240,42,82,51.2,16,30,53.3,26,52,50,24,26,92.3,6,37,43,27,11,7,13,20
753,DAL,1,240,38,77,49.4,19,39,48.7,19,38,50,18,25,72,4,39,43,20,6,4,20,18
754,IND,0,240,34,85,40,11,37,29.7,23,48,47.92,8,12,66.7,11,37,48,23,7,4,15,23
755,PHX,1,240,46,81,56.8,11,25,44,35,56,62.5,18,24,75,4,28,32,29,6,7,10,21
756,MEM,0,240,42,90,46.7,5,18,27.8,37,72,51.39,18,23,78.3,11,35,46,23,10,4,11,20
757,DET,0,240,40,86,46.5,9,27,33.3,31,59,52.54,12,17,70.6,5,31,36,29,7,7,17,26
758,HOU,0,240,39,78,50,13,40,32.5,26,38,68.42,17,24,70.8,6,25,31,22,5,8,13,21
759,OKC,1,240,39,86,45.3,14,33,42.4,25,53,47.17,21,28,75,19,45,64,19,2,6,20,16
760,MIA,1,240,32,78,41,10,32,31.3,22,46,47.83,18,28,64.3,8,34,42,22,5,4,12,14
761,TOR,0,240,35,90,38.9,16,46,34.8,19,44,43.18,17,20,85,7,28,35,21,13,7,7,25
762,BOS,0,240,39,94,41.5,11,47,23.4,28,47,59.57,19,23,82.6,8,28,36,20,11,2,9,19
763,BKN,1,240,44,90,48.9,13,36,36.1,31,54,57.41,19,19,100,12,33,45,25,6,3,12,21
764,MIN,1,240,36,87,41.4,14,40,35,22,47,46.81,16,19,84.2,9,31,40,25,9,8,13,14
765,MIL,1,240,42,79,53.2,14,26,53.8,28,53,52.83,14,18,77.8,7,35,42,23,13,8,22,17
766,LAL,0,240,35,87,40.2,10,36,27.8,25,51,49.02,17,22,77.3,11,29,40,22,9,5,22,22
767,SAS,1,240,43,92,46.7,10,26,38.5,33,66,50,24,34,70.6,14,40,54,24,9,2,11,17
768,SAC,0,240,39,92,42.4,11,35,31.4,28,57,49.12,17,19,89.5,11,32,43,22,7,5,12,20
769,NYK,0,240,39,82,47.6,11,23,47.8,28,59,47.46,12,17,70.6,7,34,41,20,7,6,17,18
770,UTA,1,240,38,89,42.7,16,49,32.7,22,40,55,19,25,76,11,35,46,20,10,5,15,21
771,LAC,0,240,37,89,41.6,12,37,32.4,25,52,48.08,10,10,100,12,36,48,25,3,4,17,21
772,PHX,1,240,45,88,51.1,12,32,37.5,33,56,58.93,15,18,83.3,11,38,49,27,6,1,14,14
773,ATL,0,240,41,85,48.2,13,32,40.6,28,53,52.83,15,21,71.4,6,30,36,30,9,1,7,17
774,WAS,0,240,41,100,41,10,37,27,31,63,49.21,12,15,80,15,36,51,22,5,1,13,19
775,PHI,0,240,35,82,42.7,11,35,31.4,24,47,51.06,14,15,93.3,5,29,34,18,14,6,12,18
776,ORL,1,240,38,92,41.3,5,17,29.4,33,75,44,22,25,88,15,35,50,23,10,6,9,13
777,DEN,1,240,39,81,48.1,12,31,38.7,27,50,54,14,17,82.4,9,42,51,26,9,6,20,16
778,CHA,1,240,42,90,46.7,14,34,41.2,28,56,50,16,19,84.2,9,41,50,24,6,6,14,17
779,UTA,1,240,38,82,46.3,19,41,46.3,19,41,46.34,19,23,82.6,9,46,55,29,6,5,12,14
780,IND,0,240,44,93,47.3,12,30,40,32,63,50.79,24,33,72.7,7,30,37,32,11,6,14,18
781,BKN,1,240,40,85,47.1,10,30,33.3,30,55,54.55,22,25,88,7,43,50,31,10,7,16,18
782,SAS,0,240,47,93,50.5,10,27,37,37,66,56.06,11,14,78.6,12,29,41,24,5,4,11,18
783,CHI,0,240,44,84,52.4,6,24,25,38,60,63.33,8,11,72.7,8,31,39,33,8,5,20,18
784,HOU,0,240,40,94,42.6,11,42,26.2,29,52,55.77,19,22,86.4,10,32,42,28,9,5,12,18
785,MEM,1,240,46,85,54.1,11,31,35.5,35,54,64.81,17,24,70.8,7,40,47,31,8,4,16,18
786,NYK,0,240,33,80,41.3,10,36,27.8,23,44,52.27,12,20,60,6,35,41,15,4,6,14,19
787,TOR,0,240,35,86,40.7,11,36,30.6,24,50,48,23,28,82.1,11,28,39,21,5,6,13,25
788,WAS,1,240,55,99,55.6,10,19,52.6,45,80,56.25,12,18,66.7,12,43,55,30,5,8,19,24
789,DAL,1,240,51,96,53.1,16,44,36.4,35,52,67.31,9,13,69.2,8,35,43,30,11,3,9,21
790,MIL,0,240,38,81,46.9,11,30,36.7,27,51,52.94,18,21,85.7,5,27,32,18,8,4,12,14
791,OKC,0,240,38,81,46.9,9,26,34.6,29,55,52.73,21,33,63.6,10,37,47,17,8,4,16,14
792,BOS,0,240,40,93,43,14,43,32.6,26,50,52,15,19,78.9,12,34,46,21,5,9,14,25
793,MIN,0,240,40,103,38.8,14,44,31.8,26,59,44.07,13,17,76.5,17,34,51,23,10,10,15,25
794,LAC,1,240,51,95,53.7,19,34,55.9,32,61,52.46,8,10,80,13,33,46,25,5,2,14,15
795,GSW,1,240,46,92,50,16,38,42.1,30,54,55.56,8,9,88.9,10,29,39,28,9,8,15,14
796,SAC,1,240,47,84,56,18,36,50,29,48,60.42,20,25,80,4,33,37,29,9,6,7,15
797,DET,1,240,38,75,50.7,15,30,50,23,45,51.11,27,34,79.4,9,34,43,26,6,6,19,24
798,NOP,1,240,41,82,50,16,31,51.6,25,51,49.02,17,30,56.7,8,39,47,30,8,2,15,21
799,CLE,0,240,29,83,34.9,7,34,20.6,22,49,44.9,10,16,62.5,6,34,40,17,5,5,10,18
800,MIA,1,240,37,86,43,10,34,29.4,27,52,51.92,14,17,82.4,12,35,47,22,7,5,12,18
801,CHA,0,265,34,85,40,13,43,30.2,21,42,50,16,23,69.6,16,36,52,16,8,3,21,23
802,PHX,1,265,34,96,35.4,8,40,20,26,56,46.43,25,29,86.2,21,29,50,17,15,2,14,17
803,ORL,0,240,34,88,38.6,11,33,33.3,23,55,41.82,14,17,82.4,10,41,51,19,5,4,11,18
804,ATL,0,240,36,76,47.4,12,34,35.3,24,42,57.14,18,21,85.7,2,29,31,18,7,3,12,16
805,LAL,1,240,34,82,41.5,11,40,27.5,23,42,54.76,17,23,73.9,8,44,52,25,9,5,12,17
806,TOR,0,240,39,87,44.8,14,42,33.3,25,45,55.56,25,33,75.8,12,33,45,17,3,6,13,20
807,POR,1,240,46,97,47.4,10,34,29.4,36,63,57.14,20,24,83.3,13,34,47,24,7,11,8,25
808,DEN,1,240,50,92,54.3,15,36,41.7,35,56,62.5,11,16,68.8,15,34,49,32,7,3,10,15
809,NYK,1,240,40,93,43,16,44,36.4,24,49,48.98,6,8,75,12,32,44,28,9,11,16,19
810,CLE,0,240,37,84,44,9,26,34.6,28,58,48.28,15,23,65.2,7,29,36,20,11,2,10,13
811,UTA,1,240,46,92,50,19,45,42.2,27,47,57.45,15,20,75,13,39,52,22,8,8,22,22
812,CHI,0,240,41,95,43.2,8,34,23.5,33,61,54.1,14,18,77.8,11,37,48,28,6,3,14,25
813,DAL,0,240,37,83,44.6,10,31,32.3,27,52,51.92,19,24,79.2,10,28,38,19,2,4,7,20
814,SAS,1,240,46,85,54.1,10,25,40,36,60,60,18,28,64.3,4,37,41,29,9,7,11,15
815,LAC,1,240,45,85,52.9,11,26,42.3,34,59,57.63,21,27,77.8,9,29,38,26,9,3,12,25
816,BOS,1,240,44,96,45.8,12,38,31.6,32,58,55.17,11,14,78.6,10,42,52,22,10,4,12,19
817,HOU,1,240,50,92,54.3,18,39,46.2,32,53,60.38,11,13,84.6,10,31,41,29,7,7,12,24
818,WAS,1,240,44,91,48.4,9,21,42.9,35,70,50,9,9,100,7,41,48,24,7,5,18,22
819,OKC,0,240,34,83,41,11,38,28.9,23,45,51.11,15,24,62.5,10,40,50,16,7,4,18,12
820,MIL,0,240,36,87,41.4,14,36,38.9,22,51,43.14,10,16,62.5,15,33,48,21,11,7,16,11
821,PHI,0,240,39,77,50.6,10,26,38.5,29,51,56.86,24,33,72.7,8,30,38,17,5,2,16,27
822,MIN,0,240,36,85,42.4,13,40,32.5,23,45,51.11,22,28,78.6,10,30,40,26,8,6,13,15
823,SAC,1,240,41,80,51.3,7,30,23.3,34,50,68,11,14,78.6,7,37,44,16,4,9,18,20
824,DET,0,240,33,85,38.8,10,29,34.5,23,56,41.07,16,19,84.2,7,36,43,19,9,5,19,18
825,MEM,0,240,39,97,40.2,9,33,27.3,30,64,46.88,23,30,76.7,16,31,47,24,16,2,15,14
826,NOP,1,240,42,81,51.9,9,26,34.6,33,55,60,19,29,65.5,8,34,42,20,2,5,7,18
827,GSW,0,240,39,79,49.4,12,28,42.9,27,51,52.94,18,26,69.2,5,28,33,29,7,4,13,22
828,MEM,0,240,44,97,45.4,12,30,40,32,67,47.76,14,18,77.8,12,36,48,27,3,2,7,14
829,CHA,1,240,39,79,49.4,18,43,41.9,21,36,58.33,14,19,73.7,6,36,42,30,6,7,16,16
830,MIA,0,240,40,87,46,15,43,34.9,25,44,56.82,10,20,50,9,30,39,28,9,3,10,17
831,DEN,1,240,47,93,50.5,14,28,50,33,65,50.77,5,7,71.4,11,25,36,28,7,7,8,16
832,HOU,0,240,37,87,42.5,17,44,38.6,20,43,46.51,10,13,76.9,7,40,47,26,5,9,21,20
833,ORL,0,240,42,95,44.2,12,27,44.4,30,68,44.12,9,17,52.9,11,29,40,29,7,5,12,18
834,DET,0,240,33,73,45.2,11,31,35.5,22,42,52.38,34,47,72.3,7,29,36,19,6,4,11,30
835,TOR,0,240,37,90,41.1,12,45,26.7,25,45,55.56,14,16,87.5,7,31,38,20,5,4,12,17
836,BKN,1,240,37,84,44,13,33,39.4,24,51,47.06,26,34,76.5,16,33,49,19,3,4,10,27
837,UTA,1,240,45,98,45.9,12,33,36.4,33,65,50.77,15,18,83.3,14,37,51,25,5,4,7,15
838,ATL,1,240,46,84,54.8,13,33,39.4,33,51,64.71,19,24,79.2,8,37,45,31,6,5,10,23
839,POR,1,240,40,85,47.1,18,40,45,22,45,48.89,14,21,66.7,10,36,46,21,7,9,16,18
840,CLE,0,240,31,80,38.8,5,26,19.2,26,54,48.15,19,28,67.9,10,27,37,24,11,4,21,19
841,BOS,1,240,43,88,48.9,22,47,46.8,21,41,51.22,14,16,87.5,8,36,44,27,10,8,15,16
842,MIN,1,240,39,103,37.9,10,38,26.3,29,65,44.62,19,24,79.2,14,36,50,30,12,3,9,13
843,IND,1,240,38,87,43.7,20,47,42.6,18,40,45,13,18,72.2,13,36,49,26,9,10,12,17
844,MIL,0,240,44,99,44.4,19,47,40.4,25,52,48.08,7,11,63.6,16,33,49,24,7,3,16,16
845,DAL,0,240,39,95,41.1,8,35,22.9,31,60,51.67,8,14,57.1,15,36,51,17,4,4,16,18
846,LAL,1,240,38,78,48.7,6,26,23.1,32,52,61.54,18,25,72,9,36,45,23,15,3,23,23
847,PHX,1,240,43,90,47.8,9,36,25,34,54,62.96,9,9,100,9,38,47,26,4,3,13,16
848,NOP,0,240,39,78,50,12,29,41.4,27,49,55.1,18,20,90,6,31,37,30,7,7,15,11
849,SAC,1,240,53,89,59.6,19,38,50,34,51,66.67,16,19,84.2,5,33,38,28,6,4,6,13
850,PHI,1,240,39,80,48.8,17,45,37.8,22,35,62.86,14,21,66.7,7,32,39,24,13,9,21,26
851,SAS,0,240,33,82,40.2,8,23,34.8,25,59,42.37,11,13,84.6,2,37,39,16,4,6,7,14
852,MIA,0,240,47,84,56,16,34,47.1,31,50,62,12,13,92.3,5,34,39,34,3,7,11,18
853,GSW,0,240,45,88,51.1,17,32,53.1,28,56,50,12,12,100,7,31,38,24,4,0,12,19
854,LAC,1,240,34,89,38.2,13,34,38.2,21,55,38.18,17,18,94.4,14,43,57,16,6,5,10,13
855,POR,1,240,44,92,47.8,20,46,43.5,24,46,52.17,17,19,89.5,10,30,40,24,3,7,11,14
856,NYK,1,240,34,93,36.6,7,28,25,27,65,41.54,31,42,73.8,18,37,55,14,12,4,15,28
857,WAS,0,240,37,80,46.3,8,26,30.8,29,54,53.7,20,33,60.6,8,38,46,26,8,9,17,32
858,LAL,0,240,34,78,43.6,9,26,34.6,25,52,48.08,24,33,72.7,7,35,42,22,10,0,22,19
859,BKN,0,240,35,97,36.1,7,35,20,28,62,45.16,11,15,73.3,13,35,48,19,9,1,9,10
860,OKC,0,240,43,95,45.3,10,35,28.6,33,60,55,11,17,64.7,9,35,44,26,13,8,15,10
861,LAC,1,240,49,88,55.7,17,33,51.5,32,55,58.18,19,30,63.3,5,39,44,23,10,3,8,20
862,IND,1,240,45,97,46.4,15,34,44.1,30,63,47.62,11,14,78.6,11,26,37,25,7,8,10,20
863,ORL,1,240,42,90,46.7,13,37,35.1,29,53,54.72,15,19,78.9,9,40,49,18,3,5,11,18
864,DET,0,240,44,83,53,11,28,39.3,33,55,60,12,19,63.2,5,36,41,29,8,9,15,18
865,CLE,1,240,42,92,45.7,11,29,37.9,31,63,49.21,8,10,80,12,34,46,28,8,7,11,16
866,PHX,0,240,40,90,44.4,11,33,33.3,29,57,50.88,20,22,90.9,10,37,47,22,9,3,9,15
867,MIL,1,240,45,90,50,17,37,45.9,28,53,52.83,14,20,70,13,33,46,19,8,5,16,14
868,SAC,1,240,40,84,47.6,10,30,33.3,30,54,55.56,20,22,90.9,12,30,42,21,5,6,16,16
869,UTA,1,240,41,91,45.1,23,55,41.8,18,36,50,13,14,92.9,11,45,56,24,6,6,13,15
870,MEM,1,240,47,99,47.5,11,30,36.7,36,69,52.17,11,13,84.6,14,42,56,19,12,10,18,10
871,ATL,0,240,41,85,48.2,7,25,28,34,60,56.67,19,23,82.6,11,31,42,17,5,3,13,20
872,DEN,0,240,41,98,41.8,14,43,32.6,27,55,49.09,15,18,83.3,17,29,46,25,5,2,12,19
873,MIN,0,240,38,86,44.2,12,38,31.6,26,48,54.17,20,26,76.9,6,31,37,24,6,2,12,25
874,CHI,0,240,37,83,44.6,8,28,28.6,29,55,52.73,12,14,85.7,10,35,45,21,6,4,15,12
875,CHA,1,240,41,80,51.3,18,38,47.4,23,42,54.76,22,29,75.9,10,40,50,27,4,3,14,20
876,HOU,0,240,33,86,38.4,16,49,32.7,17,37,45.95,15,22,68.2,10,29,39,24,6,2,7,19
877,TOR,1,240,45,89,50.6,24,48,50,21,41,51.22,21,23,91.3,9,36,45,31,3,6,10,21
878,BOS,0,240,45,94,47.9,19,47,40.4,26,47,55.32,10,10,100,9,29,38,24,9,6,13,15
879,DAL,1,240,48,99,48.5,16,44,36.4,32,55,58.18,16,22,72.7,14,39,53,27,5,6,10,22
880,SAS,0,240,39,85,45.9,7,22,31.8,32,63,50.79,16,19,84.2,6,34,40,22,6,6,16,24
881,MIA,0,240,36,86,41.9,13,36,36.1,23,50,46,15,17,88.2,17,33,50,23,3,4,14,13
882,DEN,1,240,45,91,49.5,8,30,26.7,37,61,60.66,12,13,92.3,13,39,52,25,12,7,12,13
883,NOP,1,240,47,90,52.2,10,29,34.5,37,61,60.66,24,26,92.3,11,42,53,28,9,3,14,24
884,PHX,1,240,45,91,49.5,12,37,32.4,33,54,61.11,8,9,88.9,8,31,39,29,5,6,7,18
885,PHI,1,240,39,86,45.3,7,24,29.2,32,62,51.61,23,35,65.7,13,38,51,15,5,4,14,24
886,GSW,0,240,36,83,43.4,8,25,32,28,58,48.28,18,26,69.2,6,32,38,22,5,7,13,23
887,BKN,1,240,43,87,49.4,9,30,30,34,57,59.65,21,27,77.8,10,37,47,25,5,2,11,17
888,NYK,1,240,47,92,51.1,16,30,53.3,31,62,50,21,24,87.5,12,30,42,23,6,8,10,28
889,ORL,0,240,39,88,44.3,11,34,32.4,28,54,51.85,10,14,71.4,9,28,37,27,8,4,13,12
890,LAL,0,240,36,85,42.4,18,37,48.6,18,48,37.5,21,30,70,6,28,34,25,10,4,13,17
891,WAS,0,240,38,79,48.1,9,23,39.1,29,56,51.79,28,35,80,7,31,38,25,5,5,17,23
892,POR,0,240,36,90,40,19,55,34.5,17,35,48.57,21,23,91.3,13,31,44,25,4,5,8,20
893,TOR,0,240,37,87,42.5,10,40,25,27,47,57.45,15,19,78.9,8,36,44,19,6,5,15,24
894,SAS,0,240,36,78,46.2,11,32,34.4,25,46,54.35,14,17,82.4,5,33,38,17,5,9,14,22
895,CHA,1,240,34,81,42,12,32,37.5,22,49,44.9,20,23,87,7,33,40,27,5,7,15,14
896,UTA,1,240,45,92,48.9,17,39,43.6,28,53,52.83,13,15,86.7,10,36,46,25,9,10,9,16
897,CHI,0,240,39,96,40.6,6,26,23.1,33,70,47.14,11,12,91.7,14,35,49,21,5,3,14,14
898,MIL,1,240,53,94,56.4,24,39,61.5,29,55,52.73,10,15,66.7,8,47,55,35,3,5,16,16
899,LAC,1,240,42,85,49.4,17,38,44.7,25,47,53.19,18,20,90,8,36,44,26,4,7,8,16
900,MEM,1,265,55,110,50,12,35,34.3,43,75,57.33,10,15,66.7,17,37,54,38,8,6,10,20
901,IND,0,240,45,111,40.5,12,50,24,33,61,54.1,11,12,91.7,11,29,40,27,8,3,6,16
902,ATL,0,240,43,95,45.3,12,34,35.3,31,61,50.82,12,16,75,15,33,48,21,3,3,7,18
903,OKC,1,240,41,87,47.1,21,37,56.8,20,50,40,9,10,90,9,38,47,27,8,10,17,14
904,HOU,1,240,41,90,45.6,14,36,38.9,27,54,50,21,26,80.8,10,37,47,28,7,7,12,21
905,CLE,0,240,41,96,42.7,4,17,23.5,37,79,46.84,19,23,82.6,10,29,39,22,13,4,10,11
906,SAC,1,240,49,90,54.4,13,30,43.3,36,60,60,8,12,66.7,10,39,49,26,6,7,17,17
907,BOS,0,265,47,90,52.2,17,35,48.6,30,55,54.55,15,24,62.5,5,38,43,31,3,6,13,18
908,MIN,0,240,38,92,41.3,14,39,35.9,24,53,45.28,13,18,72.2,11,31,42,24,11,4,12,17
909,DAL,1,240,48,86,55.8,19,37,51.4,29,49,59.18,17,20,85,8,44,52,23,4,3,11,17
910,PHX,1,240,42,87,48.3,9,32,28.1,33,55,60,18,23,78.3,9,42,51,30,7,6,11,24
911,TOR,0,240,37,95,38.9,15,46,32.6,22,49,44.9,16,19,84.2,9,28,37,19,13,3,14,26
912,NOP,1,240,41,85,48.2,8,28,28.6,33,57,57.89,23,30,76.7,14,31,45,26,8,7,16,12
913,HOU,0,240,39,79,49.4,14,38,36.8,25,41,60.98,20,27,74.1,8,30,38,22,7,4,16,20
914,LAL,0,240,35,85,41.2,5,25,20,30,60,50,19,28,67.9,7,34,41,20,3,2,11,18
915,DET,0,240,32,82,39,4,25,16,28,57,49.12,18,25,72,8,29,37,20,11,5,15,16
916,CHI,1,240,37,80,46.3,14,28,50,23,52,44.23,12,14,85.7,9,43,52,26,8,8,21,22
917,IND,1,265,38,98,38.8,15,45,33.3,23,53,43.4,18,20,90,13,37,50,27,8,10,15,22
918,OKC,1,240,42,91,46.2,13,39,33.3,29,52,55.77,17,25,68,19,33,52,22,8,2,18,21
919,NYK,0,265,38,88,43.2,11,24,45.8,27,64,42.19,13,23,56.5,13,31,44,16,13,2,17,19
920,PHI,1,265,38,82,46.3,11,25,44,27,57,47.37,14,23,60.9,8,36,44,19,12,9,20,18
921,WAS,0,240,42,79,53.2,7,21,33.3,35,58,60.34,15,19,78.9,10,33,43,24,5,4,19,22
922,BOS,1,240,40,88,45.5,23,55,41.8,17,33,51.52,9,9,100,7,38,45,27,6,3,10,21
923,POR,0,240,34,89,38.2,9,41,22,25,48,52.08,15,19,78.9,9,24,33,17,7,3,7,17
924,ORL,0,240,32,84,38.1,11,34,32.4,21,50,42,21,30,70,9,35,44,20,6,4,6,13
925,MIA,0,265,39,97,40.2,9,37,24.3,30,60,50,19,23,82.6,13,38,51,27,7,7,16,19
926,CLE,1,240,39,77,50.6,17,33,51.5,22,44,50,21,28,75,7,47,54,29,8,4,27,19
927,DEN,0,240,44,88,50,12,34,35.3,32,54,59.26,8,10,80,10,27,37,30,9,5,15,28
928,BKN,1,240,44,90,48.9,9,29,31,35,61,57.38,16,22,72.7,10,25,35,24,11,8,7,18
929,LAC,1,240,45,86,52.3,12,34,35.3,33,52,63.46,23,23,100,9,33,42,26,9,1,10,25
930,CHA,0,240,31,80,38.8,15,41,36.6,16,39,41.03,21,28,75,13,26,39,25,5,4,14,20
931,GSW,0,240,31,90,34.4,13,41,31.7,18,49,36.73,28,34,82.4,7,39,46,23,8,7,12,25
932,LAL,0,240,34,81,42,8,26,30.8,26,55,47.27,18,24,75,13,39,52,18,6,3,16,16
933,SAS,0,240,46,96,47.9,12,33,36.4,34,63,53.97,9,10,90,5,36,41,29,6,4,9,11
934,ATL,1,240,39,98,39.8,13,37,35.1,26,61,42.62,8,9,88.9,16,33,49,26,13,7,8,21
935,MIL,1,240,45,92,48.9,14,38,36.8,31,54,57.41,16,18,88.9,6,43,49,24,5,3,11,11
936,SAC,0,240,39,85,45.9,10,28,35.7,29,57,50.88,17,27,63,4,29,33,28,4,2,8,21
937,PHI,1,240,48,86,55.8,11,23,47.8,37,63,58.73,22,29,75.9,9,43,52,24,7,3,11,22
938,MEM,1,240,37,95,38.9,10,32,31.3,27,63,42.86,27,31,87.1,13,47,60,25,8,5,12,22
939,PHX,1,240,43,86,50,14,27,51.9,29,59,49.15,13,17,76.5,6,34,40,29,8,1,18,19
940,MEM,0,240,39,84,46.4,8,26,30.8,31,58,53.45,17,21,81,9,37,46,24,10,6,21,17
941,SAS,1,240,41,88,46.6,7,18,38.9,34,70,48.57,27,33,81.8,17,34,51,19,5,4,13,25
942,SAC,1,240,37,81,45.7,12,30,40,25,51,49.02,21,26,80.8,11,34,45,22,6,9,14,16
943,GSW,1,240,44,91,48.4,15,41,36.6,29,50,58,13,18,72.2,8,35,43,31,13,6,13,16
944,DET,1,240,37,85,43.5,14,29,48.3,23,56,41.07,25,28,89.3,12,37,49,28,7,4,13,17
945,BKN,0,240,43,91,47.3,10,37,27,33,54,61.11,17,23,73.9,9,30,39,24,9,3,8,16
946,MIA,0,240,41,92,44.6,9,34,26.5,32,58,55.17,19,20,95,10,26,36,22,10,4,11,17
947,CLE,0,240,39,89,43.8,7,27,25.9,32,62,51.61,25,32,78.1,15,32,47,19,8,4,11,21
948,MIN,0,240,37,79,46.8,13,35,37.1,24,44,54.55,14,18,77.8,5,34,39,22,8,6,20,19
949,DEN,1,265,48,91,52.7,14,34,41.2,34,57,59.65,21,27,77.8,9,34,43,29,10,3,13,22
950,CHI,0,265,47,90,52.2,17,35,48.6,30,55,54.55,16,23,69.6,9,33,42,32,6,2,18,20
951,IND,1,240,52,89,58.4,20,36,55.6,32,53,60.38,13,19,68.4,9,38,47,38,7,9,17,17
952,UTA,1,240,34,74,45.9,12,37,32.4,22,37,59.46,35,41,85.4,9,39,48,21,7,5,13,16
953,POR,1,240,44,93,47.3,22,47,46.8,22,46,47.83,15,17,88.2,13,30,43,17,5,0,6,15
954,HOU,0,240,39,88,44.3,9,32,28.1,30,56,53.57,13,16,81.3,7,31,38,21,7,4,15,17
955,BOS,0,240,39,91,42.9,12,31,38.7,27,60,45,6,7,85.7,12,33,45,22,8,4,16,20
956,TOR,0,240,40,83,48.2,21,44,47.7,19,39,48.72,11,14,78.6,3,28,31,31,9,4,11,28
957,DAL,0,240,44,81,54.3,19,42,45.2,25,39,64.1,12,13,92.3,5,34,39,25,4,4,12,16
958,ORL,1,240,43,84,51.2,21,40,52.5,22,44,50,14,20,70,8,36,44,26,4,1,17,20
959,POR,1,240,33,87,37.9,14,43,32.6,19,44,43.18,21,25,84,14,36,50,11,8,8,13,19
960,ATL,1,240,47,87,54,11,33,33.3,36,54,66.67,11,13,84.6,6,44,50,26,6,7,14,16
961,UTA,0,240,44,96,45.8,18,48,37.5,26,48,54.17,16,28,57.1,11,36,47,19,10,3,17,27
962,LAL,1,240,44,92,47.8,13,39,33.3,31,53,58.49,15,20,75,11,37,48,23,7,6,11,19
963,NYK,1,240,37,86,43,14,34,41.2,23,52,44.23,6,11,54.5,5,38,43,24,6,4,7,14
964,PHX,0,240,45,85,52.9,15,36,41.7,30,49,61.22,14,19,73.7,9,38,47,29,6,6,22,30
965,WAS,1,240,47,86,54.7,7,17,41.2,40,69,57.97,30,38,78.9,7,36,43,23,6,2,13,27
966,NOP,0,240,33,83,39.8,10,37,27,23,46,50,17,25,68,10,34,44,24,6,5,13,19
967,MIN,1,240,44,93,47.3,11,34,32.4,33,59,55.93,24,35,68.6,11,27,38,22,14,4,12,16
968,CHA,0,240,41,83,49.4,11,29,37.9,30,54,55.56,12,20,60,8,36,44,26,7,8,19,19
969,ORL,0,240,35,82,42.7,10,34,29.4,25,48,52.08,13,16,81.3,8,41,49,21,6,6,11,13
970,OKC,0,240,34,93,36.6,13,34,38.2,21,59,35.59,12,16,75,11,27,38,18,5,3,10,13
971,MEM,1,240,30,85,35.3,10,42,23.8,20,43,46.51,19,25,76,8,42,50,22,5,4,10,17
972,SAC,1,240,41,93,44.1,10,33,30.3,31,60,51.67,29,35,82.9,6,32,38,25,10,4,10,26
973,CLE,1,240,40,74,54.1,10,23,43.5,30,51,58.82,27,33,81.8,7,33,40,23,6,3,17,17
974,CHA,0,240,36,80,45,12,38,31.6,24,42,57.14,20,28,71.4,7,26,33,25,11,1,17,16
975,TOR,0,240,37,86,43,12,40,30,25,46,54.35,26,34,76.5,10,20,30,27,7,6,9,26
976,WAS,0,240,46,94,48.9,4,25,16,42,69,60.87,23,28,82.1,10,42,52,25,5,2,15,25
977,DET,1,240,38,75,50.7,12,29,41.4,26,46,56.52,28,32,87.5,13,41,54,23,8,5,21,30
978,BOS,0,240,40,88,45.5,10,38,26.3,30,50,60,20,29,69,15,25,40,19,10,9,12,27
979,GSW,1,240,41,90,45.6,16,45,35.6,25,45,55.56,10,12,83.3,6,42,48,32,7,4,13,26
980,DEN,1,240,52,90,57.8,16,44,36.4,36,46,78.26,9,13,69.2,8,40,48,37,12,3,16,22
981,IND,0,240,43,84,51.2,9,32,28.1,34,52,65.38,20,25,80,4,30,34,29,10,3,16,28
982,PHI,0,265,43,109,39.4,14,41,34.1,29,68,42.65,5,8,62.5,13,46,59,28,14,7,20,23
983,CHI,0,240,40,91,44,11,33,33.3,29,58,50,8,9,88.9,14,37,51,24,6,3,17,22
984,MIA,0,240,32,89,36,8,34,23.5,24,55,43.64,13,18,72.2,8,43,51,17,4,2,11,21
985,SAS,1,240,38,89,42.7,8,31,25.8,30,58,51.72,22,30,73.3,13,33,46,19,5,6,9,8
986,LAC,0,240,37,88,42,9,32,28.1,28,56,50,6,11,54.5,8,29,37,22,12,3,13,15
987,BKN,1,240,42,87,48.3,9,27,33.3,33,60,55,31,40,77.5,15,35,50,22,10,2,18,20
988,DAL,1,240,40,79,50.6,15,34,44.1,25,45,55.56,10,12,83.3,6,37,43,14,7,7,18,16
989,MIL,1,265,41,101,40.6,9,39,23.1,32,62,51.61,18,24,75,12,46,58,22,11,1,22,11
990,HOU,0,240,33,80,41.3,7,27,25.9,26,53,49.06,21,40,52.5,8,40,48,19,7,3,16,15
991,HOU,0,240,42,88,47.7,13,34,38.2,29,54,53.7,10,13,76.9,10,27,37,27,6,6,13,19
992,CHI,1,240,48,94,51.1,12,36,33.3,36,58,62.07,15,18,83.3,12,30,42,24,8,4,12,17
993,OKC,0,240,42,90,46.7,7,20,35,35,70,50,11,13,84.6,13,30,43,16,9,9,17,15
994,MIN,0,240,47,90,52.2,11,35,31.4,36,55,65.45,16,22,72.7,8,26,34,28,9,6,12,21
995,PHI,1,240,37,90,41.1,11,32,34.4,26,58,44.83,14,19,73.7,12,38,50,19,8,10,12,22
996,ATL,1,240,44,86,51.2,17,37,45.9,27,49,55.1,14,16,87.5,9,29,38,32,8,6,12,18
997,LAL,1,240,50,87,57.5,13,26,50,37,61,60.66,24,28,85.7,10,33,43,37,3,3,14,16
998,MIA,1,240,42,85,49.4,10,27,37,32,58,55.17,19,21,90.5,16,32,48,30,11,5,15,18
999,NOP,0,240,46,88,52.3,16,33,48.5,30,55,54.55,16,20,80,10,31,41,38,8,3,16,24
1000,CLE,0,240,39,86,45.3,10,35,28.6,29,51,56.86,10,14,71.4,15,27,42,23,7,6,14,19
1001,BOS,0,240,48,98,49,10,29,34.5,38,69,55.07,3,4,75,16,29,45,28,8,5,14,18
1002,POR,1,240,38,73,52.1,18,43,41.9,20,30,66.67,31,31,100,4,28,32,20,8,8,17,19
1003,NYK,0,240,37,84,44,8,24,33.3,29,60,48.33,14,22,63.6,9,38,47,19,7,5,13,23
1004,UTA,1,240,38,80,47.5,19,43,44.2,19,37,51.35,22,24,91.7,10,28,38,23,6,6,17,18
1005,DET,0,240,39,83,47,7,25,28,32,58,55.17,14,25,56,8,26,34,22,9,5,10,9
1006,DEN,1,240,45,97,46.4,15,28,53.6,30,69,43.48,16,19,84.2,17,37,54,32,7,7,10,15
1007,BKN,1,240,44,76,57.9,12,29,41.4,32,47,68.09,17,22,77.3,3,38,41,29,3,6,15,19
1008,LAL,1,240,49,78,62.8,11,27,40.7,38,51,74.51,19,25,76,7,39,46,36,9,3,19,25
1009,CHA,1,240,45,94,47.9,12,30,40,33,64,51.56,20,25,80,10,36,46,30,7,3,9,15
1010,MEM,0,240,38,87,43.7,5,23,21.7,33,64,51.56,18,26,69.2,10,29,39,15,11,0,11,17
1011,GSW,0,240,34,79,43,13,37,35.1,21,42,50,16,24,66.7,9,21,30,24,9,2,22,23
1012,DAL,0,240,39,79,49.4,17,41,41.5,22,38,57.89,4,5,80,4,29,33,24,8,4,15,16
1013,NYK,0,240,37,92,40.2,15,42,35.7,22,50,44,23,27,85.2,13,27,40,16,9,2,9,22
1014,WAS,0,240,44,87,50.6,16,38,42.1,28,49,57.14,18,24,75,2,31,33,34,5,1,14,18
1015,MIL,1,240,52,94,55.3,11,28,39.3,41,66,62.12,18,19,94.7,9,37,46,29,6,5,16,20
1016,SAC,0,240,48,86,55.8,9,31,29,39,55,70.91,11,17,64.7,4,40,44,28,7,6,12,19
1017,SAS,1,240,47,83,56.6,12,25,48,35,58,60.34,3,5,60,10,35,45,29,3,9,22,23
1018,IND,0,240,39,90,43.3,17,42,40.5,22,48,45.83,11,13,84.6,10,29,39,28,8,9,12,13
1019,LAC,1,240,43,86,50,14,32,43.8,29,54,53.7,9,11,81.8,9,37,46,23,10,0,9,12
1020,PHX,1,240,47,83,56.6,12,30,40,35,53,66.04,16,18,88.9,5,37,42,28,7,5,15,19
1021,POR,0,240,39,89,43.8,17,45,37.8,22,44,50,17,21,81,9,33,42,22,6,3,12,29
1022,NOP,1,240,53,81,65.4,12,26,46.2,41,55,74.55,17,21,81,4,36,40,38,8,1,19,16
1023,CHI,1,240,44,97,45.4,12,44,27.3,32,53,60.38,18,23,78.3,14,46,60,35,6,7,12,20
1024,ATL,1,240,32,71,45.1,12,29,41.4,20,42,47.62,24,26,92.3,12,37,49,21,4,6,21,21
1025,GSW,1,240,50,89,56.2,16,31,51.6,34,58,58.62,15,18,83.3,5,35,40,33,12,2,14,26
1026,MEM,0,240,47,92,51.1,7,22,31.8,40,70,57.14,21,29,72.4,11,21,32,27,13,3,7,21
1027,HOU,0,240,35,91,38.5,16,50,32,19,41,46.34,21,31,67.7,10,27,37,23,8,5,11,19
1028,ORL,0,240,33,75,44,16,40,40,17,35,48.57,15,21,71.4,8,37,45,25,4,1,23,18
1029,LAC,0,240,42,92,45.7,15,43,34.9,27,49,55.1,16,19,84.2,9,23,32,23,12,2,12,17
1030,OKC,1,240,42,73,57.5,16,31,51.6,26,42,61.9,28,34,82.4,8,38,46,26,7,4,25,20
1031,SAS,0,240,36,85,42.4,4,21,19,32,64,50,23,31,74.2,10,22,32,20,8,10,9,13
1032,TOR,0,240,34,90,37.8,12,45,26.7,22,45,48.89,15,21,71.4,7,31,38,23,5,7,12,22
1033,MIA,1,240,37,89,41.6,14,50,28,23,39,58.97,14,15,93.3,10,33,43,28,15,6,11,17
1034,MIN,1,240,36,73,49.3,13,38,34.2,23,35,65.71,29,39,74.4,5,40,45,24,6,4,12,22
1035,CLE,0,240,31,81,38.3,8,30,26.7,23,51,45.1,12,23,52.2,14,20,34,19,4,5,13,18
1036,BOS,1,240,51,92,55.4,18,37,48.6,33,55,60,14,21,66.7,10,45,55,29,8,3,14,22
1037,PHI,1,240,56,98,57.1,15,29,51.7,41,69,59.42,7,11,63.6,13,41,54,35,7,7,11,27
1038,UTA,0,240,41,93,44.1,15,44,34.1,26,49,53.06,22,29,75.9,18,33,51,24,6,6,14,16
1039,OKC,0,240,37,76,48.7,8,32,25,29,44,65.91,15,21,71.4,5,35,40,22,3,4,18,18
1040,DAL,1,240,42,86,48.8,18,46,39.1,24,40,60,14,16,87.5,11,37,48,26,5,3,8,19
1041,IND,1,240,46,87,52.9,13,28,46.4,33,59,55.93,17,21,81,9,36,45,25,9,6,16,18
1042,POR,1,240,43,89,48.3,13,40,32.5,30,49,61.22,26,30,86.7,7,27,34,26,6,5,8,18
1043,CHA,1,240,39,81,48.1,21,49,42.9,18,32,56.25,15,19,78.9,8,43,51,30,10,6,27,22
1044,PHX,0,240,43,91,47.3,12,31,38.7,31,60,51.67,13,17,76.5,10,30,40,28,9,4,16,17
1045,BKN,1,240,39,80,48.8,6,27,22.2,33,53,62.26,16,22,72.7,5,30,35,22,8,7,12,16
1046,DET,0,240,36,89,40.4,8,32,25,28,57,49.12,15,20,75,12,34,46,26,10,8,13,16
1047,DEN,0,240,37,90,41.1,16,41,39,21,49,42.86,13,18,72.2,12,30,42,27,5,1,10,19
1048,WAS,0,240,43,94,45.7,16,41,39,27,53,50.94,17,22,77.3,6,35,41,25,9,2,15,20
1049,MIN,0,240,44,86,51.2,10,26,38.5,34,60,56.67,23,31,74.2,19,37,56,23,5,7,18,24
1050,ATL,1,240,43,84,51.2,12,33,36.4,31,51,60.78,23,33,69.7,13,32,45,21,6,2,9,17
1051,TOR,0,240,37,96,38.5,15,46,32.6,22,50,44,15,18,83.3,13,34,47,25,10,6,16,16
1052,MIL,1,240,43,99,43.4,17,45,37.8,26,54,48.15,22,25,88,13,44,57,33,9,3,18,19
1053,SAC,0,240,43,98,43.9,7,36,19.4,36,62,58.06,13,16,81.3,22,25,47,27,5,1,13,26
1054,NYK,1,240,44,90,48.9,14,35,40,30,55,54.55,17,22,77.3,11,33,44,23,12,2,11,20
1055,MIA,1,240,37,80,46.3,12,35,34.3,25,45,55.56,15,20,75,1,40,41,26,11,6,10,13
1056,CLE,0,240,30,88,34.1,7,32,21.9,23,56,41.07,15,20,75,5,28,33,13,8,9,7,18
1057,DEN,1,240,41,92,44.6,13,37,35.1,28,55,50.91,8,11,72.7,9,36,45,27,10,5,12,10
1058,UTA,1,240,39,81,48.1,15,40,37.5,24,41,58.54,21,25,84,6,45,51,24,7,10,20,17
1059,MEM,0,240,40,87,46,14,28,50,26,59,44.07,8,8,100,8,37,45,27,6,5,17,15
1060,WAS,0,240,40,82,48.8,8,24,33.3,32,58,55.17,13,22,59.1,6,26,32,19,10,2,18,16
1061,ORL,0,240,29,80,36.3,10,38,26.3,19,42,45.24,9,12,75,9,37,46,17,3,4,20,16
1062,CHI,0,240,34,92,37,15,38,39.5,19,54,35.19,7,7,100,12,38,50,25,5,3,16,16
1063,NOP,1,240,47,101,46.5,6,24,25,41,77,53.25,16,19,84.2,19,51,70,25,2,7,14,18
1064,LAL,1,240,34,76,44.7,7,22,31.8,27,54,50,30,39,76.9,6,38,44,20,10,5,15,20
1065,HOU,0,240,41,112,36.6,9,43,20.9,32,69,46.38,8,13,61.5,19,31,50,15,11,5,11,19
1066,IND,0,240,37,88,42,8,36,22.2,29,52,55.77,18,21,85.7,10,34,44,22,7,4,16,27
1067,PHI,1,240,49,90,54.4,11,21,52.4,38,69,55.07,18,18,100,10,39,49,26,13,6,17,19
1068,SAS,1,240,40,89,44.9,10,29,34.5,30,60,50,14,18,77.8,7,38,45,24,8,5,11,15
1069,MIN,1,240,51,95,53.7,19,40,47.5,32,55,58.18,14,16,87.5,7,31,38,28,11,10,12,20
1070,MIA,1,240,41,91,45.1,16,49,32.7,25,42,59.52,13,22,59.1,9,35,44,27,8,4,11,16
1071,DET,0,240,38,85,44.7,15,46,32.6,23,39,58.97,11,14,78.6,11,39,50,27,6,5,14,21
1072,GSW,0,240,38,88,43.2,9,36,25,29,52,55.77,19,27,70.4,5,39,44,20,6,6,16,23
1073,POR,0,240,43,94,45.7,18,43,41.9,25,51,49.02,17,19,89.5,15,26,41,26,8,2,11,18
1074,NYK,0,240,37,88,42,13,37,35.1,24,51,47.06,14,21,66.7,10,28,38,19,3,5,15,19
1075,PHI,1,240,53,103,51.5,10,33,30.3,43,70,61.43,11,15,73.3,13,32,45,25,11,7,11,16
1076,CHI,0,240,39,83,47,14,29,48.3,25,54,46.3,13,16,81.3,8,30,38,26,3,6,19,19
1077,SAC,1,240,45,92,48.9,11,33,33.3,34,59,57.63,24,28,85.7,8,45,53,25,11,5,15,19
1078,CHA,1,240,36,90,40,10,30,33.3,26,60,43.33,23,24,95.8,12,33,45,26,9,3,9,14
1079,LAC,1,240,44,96,45.8,18,41,43.9,26,55,47.27,24,29,82.8,11,45,56,23,10,6,11,22
1080,ATL,1,240,39,90,43.3,15,42,35.7,24,48,50,28,35,80,12,41,53,20,8,13,14,26
1081,BOS,0,240,41,91,45.1,13,40,32.5,28,51,54.9,14,22,63.6,11,28,39,22,10,10,11,13
1082,TOR,0,240,42,96,43.8,17,37,45.9,25,59,42.37,19,23,82.6,13,37,50,23,8,4,14,25
1083,DAL,0,240,35,82,42.7,15,34,44.1,20,48,41.67,23,33,69.7,6,31,37,20,4,9,6,22
1084,HOU,0,240,41,99,41.4,11,45,24.4,30,54,55.56,12,17,70.6,10,34,44,24,7,6,13,22
1085,NOP,0,240,43,100,43,6,32,18.8,37,68,54.41,13,24,54.2,19,32,51,28,7,6,18,18
1086,ORL,0,240,39,96,40.6,12,34,35.3,27,62,43.55,13,15,86.7,16,41,57,22,6,4,14,19
1087,BKN,1,240,42,88,47.7,19,42,45.2,23,46,50,18,22,81.8,11,34,45,21,3,5,15,22
1088,PHX,1,240,49,83,59,13,24,54.2,36,59,61.02,16,19,84.2,5,33,38,28,6,1,13,20
1089,OKC,1,240,41,91,45.1,16,32,50,25,59,42.37,18,20,90,16,39,55,25,2,6,9,24
1090,MIL,1,240,50,87,57.5,18,38,47.4,32,49,65.31,16,17,94.1,5,38,43,29,9,9,12,18
1091,SAS,0,240,38,83,45.8,12,28,42.9,26,55,47.27,16,20,80,6,24,30,18,10,2,9,19
1092,DAL,1,240,43,83,51.8,13,40,32.5,30,43,69.77,16,19,84.2,13,38,51,29,3,1,15,19
1093,WAS,0,240,38,95,40,11,36,30.6,27,59,45.76,25,27,92.6,6,33,39,23,9,6,9,26
1094,MEM,1,240,50,99,50.5,8,23,34.8,42,76,55.26,19,29,65.5,14,46,60,31,4,6,16,26
1095,IND,0,240,41,90,45.6,14,39,35.9,27,51,52.94,7,12,58.3,11,23,34,27,12,3,15,17
1096,OKC,1,240,37,85,43.5,12,40,30,25,45,55.56,21,26,80.8,9,36,45,20,9,4,17,16
1097,GSW,0,240,38,88,43.2,12,35,34.3,26,53,49.06,10,16,62.5,9,31,40,22,9,4,17,11
1098,WAS,1,240,40,88,45.5,9,23,39.1,31,65,47.69,30,42,71.4,11,30,41,20,12,3,9,24
1099,SAC,0,240,49,103,47.6,11,29,37.9,38,74,51.35,10,16,62.5,18,33,51,25,3,3,7,19
1100,NOP,0,240,33,84,39.3,11,43,25.6,22,41,53.66,16,20,80,15,29,44,28,5,3,14,21
1101,LAC,0,240,38,82,46.3,16,35,45.7,22,47,46.81,25,27,92.6,10,35,45,24,4,4,19,31
1102,MIA,1,240,36,73,49.3,10,30,33.3,26,43,60.47,21,25,84,5,36,41,27,6,3,11,20
1103,DET,0,240,39,80,48.8,14,36,38.9,25,44,56.82,12,15,80,6,23,29,23,6,2,13,13
1104,SAS,0,240,40,85,47.1,10,31,32.3,30,54,55.56,12,12,100,6,40,46,23,9,5,19,24
1105,DEN,1,240,45,77,58.4,12,28,42.9,33,49,67.35,11,16,68.8,6,35,41,27,6,5,19,13
1106,PHX,1,240,49,96,51,12,30,40,37,66,56.06,10,13,76.9,12,40,52,31,8,4,16,16
1107,POR,1,240,42,88,47.7,15,38,39.5,27,50,54,24,25,96,9,32,41,20,6,7,9,14
1108,TOR,0,240,45,91,49.5,21,50,42,24,41,58.54,14,17,82.4,8,20,28,36,6,1,14,25
1109,MEM,0,240,40,101,39.6,8,34,23.5,32,67,47.76,23,24,95.8,17,39,56,21,13,8,12,20
1110,MIL,1,240,42,95,44.2,10,34,29.4,32,61,52.46,18,22,81.8,13,39,52,21,11,5,16,19
1111,BOS,1,240,45,74,60.8,13,29,44.8,32,45,71.11,29,40,72.5,9,30,39,25,6,7,16,20
1112,NYK,1,240,45,83,54.2,9,27,33.3,36,56,64.29,15,19,78.9,12,35,47,25,10,4,13,13
1113,DAL,1,240,32,83,38.6,8,40,20,24,43,55.81,15,19,78.9,7,46,53,18,8,3,15,13
1114,BKN,1,240,49,85,57.6,17,35,48.6,32,50,64,17,24,70.8,10,43,53,33,5,1,15,24
1115,CLE,0,240,43,83,51.8,11,28,39.3,32,55,58.18,14,15,93.3,11,32,43,29,8,1,26,18
1116,OKC,0,240,29,87,33.3,9,39,23.1,20,48,41.67,11,17,64.7,8,37,45,13,6,4,13,20
1117,UTA,0,265,44,100,44,21,44,47.7,23,56,41.07,14,19,73.7,12,40,52,22,7,1,16,24
1118,CHA,1,240,51,98,52,17,39,43.6,34,59,57.63,16,21,76.2,13,41,54,33,14,7,17,18
1119,LAL,0,240,49,93,52.7,12,27,44.4,37,66,56.06,10,14,71.4,15,26,41,27,7,3,12,19
1120,HOU,0,240,38,91,41.8,18,43,41.9,20,48,41.67,20,28,71.4,12,25,37,24,10,5,9,18
1121,ATL,1,240,38,85,44.7,21,45,46.7,17,40,42.5,18,19,94.7,6,36,42,26,7,5,12,25
1122,PHI,1,265,48,93,51.6,8,25,32,40,68,58.82,27,35,77.1,8,42,50,22,9,6,11,17
1123,POR,1,240,36,86,41.9,14,49,28.6,22,37,59.46,22,26,84.6,8,39,47,15,5,4,10,16
1124,IND,1,240,47,83,56.6,8,25,32,39,58,67.24,12,16,75,4,23,27,27,18,8,14,16
1125,ORL,0,240,36,84,42.9,13,35,37.1,23,49,46.94,27,27,100,10,36,46,24,6,5,10,15
1126,SAC,1,240,48,80,60,12,25,48,36,55,65.45,15,19,78.9,6,24,30,32,5,1,14,19
1127,CHI,1,240,48,94,51.1,12,28,42.9,36,66,54.55,20,22,90.9,13,32,45,28,6,8,16,21
1128,NOP,0,240,46,83,55.4,6,22,27.3,40,61,65.57,26,38,68.4,7,28,35,29,10,6,11,19
1129,GSW,0,240,41,97,42.3,15,42,35.7,26,55,47.27,9,14,64.3,17,37,54,27,8,1,11,24
1130,TOR,0,240,34,77,44.2,12,36,33.3,22,41,53.66,25,30,83.3,7,27,34,17,6,5,14,20
1131,DET,1,240,48,91,52.7,20,41,48.8,28,50,56,13,21,61.9,12,37,49,39,11,4,14,28
1132,MIN,0,240,39,96,40.6,9,40,22.5,30,56,53.57,15,18,83.3,12,33,45,25,11,2,21,18
1133,DEN,1,240,53,95,55.8,11,30,36.7,42,65,64.62,11,12,91.7,9,36,45,28,10,3,10,19
1134,BOS,1,240,42,86,48.8,16,32,50,26,54,48.15,17,23,73.9,14,29,43,25,6,4,9,12
1135,LAC,0,240,43,87,49.4,18,38,47.4,25,49,51.02,8,9,88.9,10,25,35,28,3,5,9,19
1136,PHX,1,240,38,77,49.4,16,29,55.2,22,48,45.83,22,25,88,5,30,35,30,5,7,14,16
1137,SAS,1,240,43,89,48.3,18,42,42.9,25,47,53.19,15,21,71.4,9,36,45,31,12,4,9,14
1138,WAS,0,240,41,81,50.6,11,31,35.5,30,50,60,18,25,72,4,33,37,29,8,3,22,20
1139,MIL,0,240,32,79,40.5,11,40,27.5,21,39,53.85,22,31,71,11,29,40,22,4,4,13,18
1140,NYK,0,240,33,81,40.7,15,36,41.7,18,45,40,12,15,80,9,32,41,18,2,5,16,16
1141,MEM,1,240,47,95,49.5,13,29,44.8,34,66,51.52,18,23,78.3,9,35,44,26,15,1,13,21
1142,MIA,0,240,28,75,37.3,9,33,27.3,19,42,45.24,15,22,68.2,5,21,26,15,16,4,9,13
1143,LAL,0,240,40,79,50.6,11,31,35.5,29,48,60.42,13,17,76.5,5,29,34,18,6,8,12,23
1144,ATL,1,240,34,71,47.9,13,36,36.1,21,35,60,13,15,86.7,11,36,47,26,5,2,23,18
1145,NOP,1,240,52,92,56.5,7,11,63.6,45,81,55.56,18,23,78.3,10,43,53,27,5,5,13,15
1146,UTA,0,240,46,101,45.5,17,43,39.5,29,58,50,15,18,83.3,11,28,39,26,11,7,9,22
1147,CLE,1,240,36,73,49.3,10,30,33.3,26,43,60.47,19,24,79.2,6,42,48,23,7,6,21,18
1148,CHA,0,240,43,88,48.9,15,34,44.1,28,54,51.85,10,17,58.8,11,26,37,25,12,5,16,16
1149,BKN,1,265,47,100,47,17,41,41.5,30,59,50.85,13,17,76.5,13,38,51,35,6,8,5,13
1150,IND,0,240,44,91,48.4,8,29,27.6,36,62,58.06,18,21,85.7,8,26,34,27,8,1,19,19
1151,POR,1,240,46,86,53.5,24,46,52.2,22,40,55,7,10,70,8,30,38,26,12,7,17,15
1152,SAS,0,265,44,97,45.4,15,35,42.9,29,62,46.77,10,15,66.7,9,39,48,30,2,3,9,16
1153,CHI,0,240,42,94,44.7,12,38,31.6,30,56,53.57,16,22,72.7,14,30,44,25,7,3,10,18
1154,DAL,1,240,47,90,52.2,17,46,37,30,44,68.18,19,23,82.6,7,39,46,29,6,6,8,12
1155,HOU,0,240,31,76,40.8,10,31,32.3,21,45,46.67,18,24,75,4,26,30,13,13,4,14,18
1156,PHI,1,240,50,88,56.8,15,35,42.9,35,53,66.04,15,16,93.8,6,33,39,27,10,6,19,19
1157,ORL,0,240,47,95,49.5,20,41,48.8,27,54,50,10,14,71.4,6,35,41,25,5,1,8,17
1158,DEN,1,240,46,87,52.9,10,27,37,36,60,60,16,20,80,9,41,50,22,4,6,13,18
1159,LAC,0,240,40,97,41.2,14,44,31.8,26,53,49.06,6,7,85.7,13,36,49,20,7,3,10,19
1160,GSW,0,240,35,86,40.7,8,34,23.5,27,52,51.92,13,19,68.4,3,32,35,26,10,4,20,25
1161,MIA,1,240,39,86,45.3,11,37,29.7,28,49,57.14,20,22,90.9,12,33,45,27,8,6,14,20
1162,ATL,0,240,36,87,41.4,8,35,22.9,28,52,53.85,19,22,86.4,16,33,49,22,12,6,17,20
1163,DET,0,240,28,72,38.9,9,32,28.1,19,40,47.5,25,31,80.6,7,33,40,16,8,4,16,15
1164,HOU,0,240,23,83,27.7,4,45,8.9,19,38,50,34,41,82.9,12,26,38,10,7,6,23,24
1165,CHA,1,240,45,83,54.2,11,30,36.7,34,53,64.15,26,27,96.3,7,30,37,30,3,6,16,20
1166,PHX,1,240,44,89,49.4,7,27,25.9,37,62,59.68,23,24,95.8,8,39,47,27,7,5,16,18
1167,BOS,1,240,42,89,47.2,10,30,33.3,32,59,54.24,17,24,70.8,13,36,49,25,7,0,19,25
1168,LAL,1,240,40,85,47.1,11,31,35.5,29,54,53.7,26,38,68.4,14,46,60,22,14,6,20,21
1169,MEM,1,240,50,94,53.2,10,30,33.3,40,64,62.5,23,28,82.1,11,45,56,27,16,3,18,31
1170,MIL,1,240,38,85,44.7,12,38,31.6,26,47,55.32,17,22,77.3,8,40,48,21,7,5,12,11
1171,NYK,1,240,44,86,51.2,13,26,50,31,60,51.67,8,10,80,6,35,41,23,9,7,12,23
1172,SAC,0,240,50,92,54.3,16,36,44.4,34,56,60.71,10,17,58.8,9,24,33,32,6,2,10,19
1173,MIN,0,240,35,93,37.6,8,35,22.9,27,58,46.55,21,24,87.5,10,34,44,21,12,4,16,22
1174,WAS,0,240,38,84,45.2,9,32,28.1,29,52,55.77,25,29,86.2,7,29,36,16,10,5,14,22
1175,DEN,1,240,49,89,55.1,15,31,48.4,34,58,58.62,13,16,81.3,6,43,49,30,6,3,13,16
1176,OKC,0,240,37,88,42,11,47,23.4,26,41,63.41,11,15,73.3,7,30,37,24,7,6,14,16
1177,SAS,1,240,41,86,47.7,12,32,37.5,29,54,53.7,23,28,82.1,8,30,38,24,7,5,9,26
1178,IND,0,240,38,84,45.2,11,28,39.3,27,56,48.21,20,25,80,6,29,35,27,5,7,16,17
1179,ORL,0,240,44,96,45.8,14,34,41.2,30,62,48.39,7,8,87.5,7,30,37,27,6,3,4,18
1180,PHI,0,265,38,83,45.8,10,28,35.7,28,55,50.91,23,35,65.7,8,38,46,25,9,10,19,26
1181,NOP,0,240,40,91,44,9,32,28.1,31,59,52.54,25,31,80.6,17,35,52,27,3,2,10,17
1182,DAL,1,240,45,86,52.3,14,36,38.9,31,50,62,11,17,64.7,6,30,36,23,12,8,9,15
1183,CLE,1,265,41,97,42.3,8,24,33.3,33,73,45.21,22,29,75.9,13,39,52,24,12,3,17,26
1184,WAS,1,240,44,98,44.9,13,33,39.4,31,65,47.69,27,34,79.4,15,42,57,27,6,6,16,24
1185,MIN,0,240,41,95,43.2,11,35,31.4,30,60,50,19,29,65.5,12,38,50,23,9,10,18,29
1186,BKN,0,240,35,86,40.7,14,44,31.8,21,42,50,14,19,73.7,14,33,47,21,5,4,19,16
1187,UTA,1,240,45,85,52.9,17,45,37.8,28,40,70,17,24,70.8,10,42,52,29,2,3,12,14
1188,NYK,1,240,40,81,49.4,12,24,50,28,57,49.12,18,22,81.8,4,34,38,26,12,2,21,22
1189,IND,0,240,35,89,39.3,15,46,32.6,20,43,46.51,27,29,93.1,8,32,40,26,8,6,9,22
1190,MIA,1,240,44,86,51.2,14,31,45.2,30,55,54.55,22,25,88,11,39,50,24,5,1,15,21
1191,OKC,1,240,46,88,52.3,16,42,38.1,30,46,65.22,10,16,62.5,5,34,39,31,6,2,10,17
1192,CHI,0,240,39,78,50,12,31,38.7,27,47,57.45,7,10,70,6,35,41,25,2,4,19,16
1193,LAC,1,240,44,80,55,14,35,40,30,45,66.67,17,18,94.4,4,43,47,34,6,8,17,19
1194,SAC,1,240,37,89,41.6,7,32,21.9,30,57,52.63,29,41,70.7,14,35,49,24,5,6,11,25
1195,TOR,1,240,40,89,44.9,16,41,39,24,48,50,26,27,96.3,11,37,48,29,6,8,13,20
1196,BOS,1,240,42,82,51.2,9,22,40.9,33,60,55,25,29,86.2,7,38,45,24,3,6,12,20
1197,DET,0,240,37,82,45.1,12,33,36.4,25,49,51.02,21,32,65.6,10,35,45,20,6,6,11,25
1198,HOU,0,240,39,91,42.9,16,47,34,23,44,52.27,17,20,85,7,30,37,23,4,5,11,24
1199,GSW,1,240,48,79,60.8,11,24,45.8,37,55,67.27,23,25,92,4,33,37,38,10,3,25,19
1200,CHA,0,240,41,89,46.1,17,41,41.5,24,48,50,22,32,68.8,13,25,38,27,11,1,21,23
1201,PHX,1,240,44,88,50,6,22,27.3,38,66,57.58,12,15,80,3,27,30,35,11,4,7,11
1202,ATL,0,240,43,97,44.3,12,40,30,31,57,54.39,11,17,64.7,19,35,54,21,6,5,11,13
1203,MEM,0,240,39,97,40.2,9,28,32.1,30,69,43.48,12,16,75,8,29,37,24,10,4,9,14
1204,LAL,1,240,37,88,42,7,27,25.9,30,61,49.18,21,28,75,15,37,52,25,9,7,10,23
1205,POR,0,240,32,83,38.6,11,37,29.7,21,46,45.65,18,20,90,10,35,45,19,5,5,16,21
1206,UTA,0,240,40,94,42.6,15,46,32.6,25,48,52.08,21,23,91.3,9,27,36,24,9,3,9,21
1207,BKN,1,240,49,92,53.3,20,45,44.4,29,47,61.7,11,14,78.6,7,44,51,30,11,2,13,18
1208,DEN,0,240,37,85,43.5,15,38,39.5,22,47,46.81,21,24,87.5,12,32,44,23,6,7,18,20
1209,LAC,0,240,34,84,40.5,12,34,35.3,22,50,44,14,16,87.5,8,33,41,19,4,4,14,15
1210,MIL,1,240,52,96,54.2,13,31,41.9,39,65,60,12,16,75,8,34,42,21,4,8,9,13
1211,SAC,0,240,42,85,49.4,12,35,34.3,30,50,60,25,33,75.8,8,26,34,25,12,0,16,22
1212,WAS,1,240,41,86,47.7,8,26,30.8,33,60,55,22,25,88,10,32,42,24,9,2,11,20
1213,DAL,0,240,32,78,41,13,34,38.2,19,44,43.18,20,23,87,10,40,50,17,2,9,22,21
1214,NYK,1,240,51,87,58.6,19,36,52.8,32,51,62.75,19,21,90.5,9,34,43,24,8,2,16,23
1215,NOP,0,240,51,102,50,13,39,33.3,38,63,60.32,10,14,71.4,12,35,47,32,5,4,9,17
1216,PHI,1,240,39,90,43.3,12,29,41.4,27,61,44.26,21,25,84,8,31,39,26,11,6,8,19
1217,ORL,0,240,35,87,40.2,9,36,25,26,51,50.98,13,15,86.7,4,31,35,19,8,1,18,10
1218,MEM,1,240,50,92,54.3,11,19,57.9,39,73,53.42,11,16,68.8,7,41,48,27,7,1,7,17
1219,NOP,1,240,50,90,55.6,10,23,43.5,40,67,59.7,18,29,62.1,12,33,45,31,10,6,13,10
1220,CLE,1,240,43,85,50.6,16,36,44.4,27,49,55.1,10,15,66.7,11,44,55,24,4,10,18,20
1221,CHA,1,240,43,88,48.9,13,36,36.1,30,52,57.69,25,27,92.6,9,37,46,24,8,5,14,21
1222,BOS,0,240,42,95,44.2,8,31,25.8,34,64,53.12,20,23,87,12,24,36,20,10,6,6,16
1223,CHI,1,265,55,93,59.1,10,25,40,45,68,66.18,13,16,81.3,7,36,43,28,11,5,21,15
1224,DET,0,240,47,89,52.8,13,36,36.1,34,53,64.15,11,16,68.8,9,29,38,31,8,6,13,23
1225,ATL,1,240,45,85,52.9,23,42,54.8,22,43,51.16,14,17,82.4,12,33,45,27,4,5,17,23
1226,OKC,1,240,37,89,41.6,18,44,40.9,19,45,42.22,10,11,90.9,10,42,52,21,6,4,17,14
1227,LAL,0,240,34,85,40,8,33,24.2,26,52,50,13,20,65,12,33,45,17,5,4,14,15
1228,UTA,1,240,41,87,47.1,22,48,45.8,19,39,48.72,10,15,66.7,14,39,53,28,7,1,12,16
1229,IND,0,240,37,81,45.7,7,29,24.1,30,52,57.69,26,32,81.3,7,32,39,20,11,6,19,22
1230,HOU,0,240,36,90,40,10,33,30.3,26,57,45.61,14,17,82.4,9,24,33,18,8,8,7,15
1231,MIN,0,265,47,104,45.2,12,38,31.6,35,66,53.03,20,21,95.2,13,28,41,28,11,4,17,24
1232,TOR,0,240,37,74,50,20,44,45.5,17,30,56.67,14,17,82.4,3,29,32,30,5,3,16,25
1233,GSW,1,240,39,83,47,5,26,19.2,34,57,59.65,28,31,90.3,8,33,41,27,10,4,18,25
1234,PHX,0,240,44,87,50.6,14,38,36.8,30,49,61.22,19,27,70.4,7,34,41,26,9,6,14,25
1235,MIA,1,240,37,80,46.3,17,38,44.7,20,42,47.62,25,29,86.2,11,31,42,31,6,4,11,21
1236,SAS,0,240,40,86,46.5,9,25,36,31,61,50.82,10,15,66.7,6,38,44,20,10,4,13,13
1237,MIL,1,240,53,99,53.5,20,42,47.6,33,57,57.89,13,18,72.2,9,43,52,33,11,5,8,13
1238,DAL,1,240,42,89,47.2,13,33,39.4,29,56,51.79,13,15,86.7,8,30,38,19,5,1,10,17
1239,PHI,1,240,33,80,41.3,17,38,44.7,16,42,38.1,26,30,86.7,12,42,54,24,5,8,19,15
1240,BKN,1,240,44,89,49.4,17,40,42.5,27,49,55.1,22,31,71,10,31,41,30,8,5,8,16
1241,ORL,0,240,33,88,37.5,14,38,36.8,19,50,38,13,22,59.1,10,38,48,25,9,6,12,16
1242,WAS,0,240,47,88,53.4,11,20,55,36,68,52.94,11,16,68.8,6,30,36,32,5,1,13,16
1243,TOR,0,240,40,93,43,11,37,29.7,29,56,51.79,11,13,84.6,8,30,38,29,12,11,10,20
1244,GSW,1,240,40,89,44.9,13,38,34.2,27,51,52.94,21,24,87.5,7,34,41,30,9,8,10,18
1245,ATL,0,240,40,89,44.9,14,31,45.2,26,58,44.83,17,23,73.9,13,28,41,22,10,4,13,19
1246,POR,0,240,41,87,47.1,14,41,34.1,27,46,58.7,10,10,100,7,40,47,21,0,7,9,19
1247,MIN,0,240,42,98,42.9,19,54,35.2,23,44,52.27,9,9,100,7,36,43,35,4,5,14,16
1248,DET,1,240,41,88,46.6,10,34,29.4,31,54,57.41,13,16,81.3,8,41,49,24,10,9,15,19
1249,NYK,0,240,38,97,39.2,11,29,37.9,27,68,39.71,19,22,86.4,18,38,56,22,4,5,15,23
1250,LAC,1,240,54,94,57.4,19,38,50,35,56,62.5,8,13,61.5,7,39,46,26,7,5,11,22
1251,DEN,1,240,40,94,42.6,14,36,38.9,26,58,44.83,17,18,94.4,10,30,40,25,8,3,1,10
1252,CLE,1,240,41,78,52.6,15,28,53.6,26,50,52,15,19,78.9,7,29,36,28,7,10,16,19
1253,SAC,0,240,45,87,51.7,15,31,48.4,30,56,53.57,13,19,68.4,5,33,38,25,6,7,15,17
1254,BOS,0,240,41,86,47.7,12,39,30.8,29,47,61.7,13,18,72.2,12,34,46,19,6,6,13,21
1255,POR,0,240,37,84,44,12,39,30.8,25,45,55.56,14,19,73.7,13,33,46,15,6,6,17,17
1256,CHA,0,240,41,89,46.1,11,36,30.6,30,53,56.6,17,21,81,8,27,35,18,13,2,16,17
1257,LAL,0,265,49,104,47.1,15,44,34.1,34,60,56.67,11,17,64.7,12,33,45,29,9,11,20,29
1258,WAS,1,265,47,96,49,9,25,36,38,71,53.52,24,33,72.7,5,44,49,25,9,4,16,25
1259,MIA,1,240,36,81,44.4,15,40,37.5,21,41,51.22,21,25,84,10,35,45,30,7,6,13,20
1260,CHI,1,240,49,91,53.8,15,36,41.7,34,55,61.82,7,10,70,8,47,55,24,5,5,12,17
1261,MEM,0,240,37,94,39.4,6,31,19.4,31,63,49.21,12,19,63.2,13,38,51,17,7,1,14,23
1262,DAL,1,240,35,80,43.8,15,41,36.6,20,39,51.28,17,26,65.4,5,44,49,17,6,4,16,18
1263,HOU,0,240,37,96,38.5,13,40,32.5,24,56,42.86,13,19,68.4,11,35,46,20,7,4,9,16
1264,UTA,1,240,45,85,52.9,28,55,50.9,17,30,56.67,14,17,82.4,8,37,45,34,7,7,23,19
1265,OKC,0,240,32,74,43.2,14,39,35.9,18,35,51.43,16,19,84.2,5,33,38,20,6,1,18,24
1266,PHX,1,240,50,99,50.5,16,33,48.5,34,66,51.52,16,18,88.9,13,30,43,29,6,5,7,13
1267,MIL,1,240,44,90,48.9,11,28,39.3,33,62,53.23,29,36,80.6,14,42,56,22,8,5,18,19
1268,CLE,0,240,39,84,46.4,8,35,22.9,31,49,63.27,15,20,75,14,28,42,22,9,4,18,17
1269,PHI,0,240,33,85,38.8,11,37,29.7,22,48,45.83,26,35,74.3,11,34,45,26,8,7,10,21
1270,TOR,1,240,40,81,49.4,14,34,41.2,26,47,55.32,16,18,88.9,5,34,39,25,5,5,14,24
1271,DET,0,240,34,91,37.4,11,40,27.5,23,51,45.1,17,21,81,9,40,49,23,10,4,11,21
1272,MIN,0,240,33,82,40.2,16,35,45.7,17,47,36.17,17,21,81,7,36,43,24,6,3,16,24
1273,BKN,1,240,44,92,47.8,11,38,28.9,33,54,61.11,13,19,68.4,9,31,40,21,10,4,6,19
1274,SAC,0,240,44,100,44,12,33,36.4,32,67,47.76,15,20,75,14,29,43,29,6,3,13,26
1275,BOS,0,265,39,98,39.8,10,37,27,29,61,47.54,27,34,79.4,11,38,49,22,9,11,11,30
1276,ATL,1,240,42,81,51.9,12,34,35.3,30,47,63.83,27,33,81.8,10,34,44,29,6,4,11,20
1277,NYK,1,240,33,78,42.3,6,18,33.3,27,60,45,31,38,81.6,11,37,48,17,4,4,13,25
1278,NOP,1,265,42,94,44.7,11,36,30.6,31,58,53.45,25,37,67.6,12,40,52,22,5,7,13,24
1279,DEN,0,240,43,84,51.2,16,36,44.4,27,48,56.25,13,16,81.3,3,30,33,25,8,3,13,24
1280,ORL,1,240,35,81,43.2,9,30,30,26,51,50.98,26,29,89.7,5,46,51,24,7,8,12,18
1281,OKC,1,240,43,79,54.4,13,28,46.4,30,51,58.82,18,24,75,5,32,37,22,9,3,15,18
1282,LAC,0,240,40,87,46,15,35,42.9,25,52,48.08,13,18,72.2,16,36,52,24,3,4,17,17
1283,CHI,1,240,49,82,59.8,11,23,47.8,38,59,64.41,13,15,86.7,2,36,38,24,5,8,14,23
1284,WAS,1,240,45,89,50.6,6,26,23.1,39,63,61.9,22,29,75.9,12,42,54,23,8,3,17,19
1285,LAL,0,240,33,84,39.3,13,45,28.9,20,39,51.28,15,17,88.2,6,37,43,25,5,6,15,17
1286,MEM,0,240,36,93,38.7,5,33,15.2,31,60,51.67,20,23,87,17,32,49,19,5,4,12,12
1287,POR,0,240,37,103,35.9,19,55,34.5,18,48,37.5,18,25,72,17,33,50,19,10,7,13,22
1288,MIA,1,240,36,85,42.4,8,28,28.6,28,57,49.12,16,23,69.6,10,39,49,24,8,3,14,20
1289,PHX,1,240,46,86,53.5,24,46,52.2,22,40,55,12,13,92.3,5,36,41,35,5,7,12,14
1290,CHA,1,240,37,75,49.3,20,40,50,17,35,48.57,8,9,88.9,4,40,44,23,7,2,25,22
1291,GSW,0,240,37,85,43.5,13,39,33.3,24,46,52.17,13,17,76.5,9,30,39,23,10,3,14,12
1292,SAC,0,240,44,98,44.9,8,29,27.6,36,69,52.17,18,22,81.8,12,29,41,22,8,3,7,18
1293,UTA,0,240,41,86,47.7,12,34,35.3,29,52,55.77,18,21,85.7,6,32,38,13,7,6,11,22
1294,CHI,0,240,40,95,42.1,7,32,21.9,33,63,52.38,18,18,100,13,29,42,24,5,6,11,20
1295,ORL,1,240,46,94,48.9,18,43,41.9,28,51,54.9,14,17,82.4,8,43,51,30,7,8,13,19
1296,ATL,0,240,38,90,42.2,10,30,33.3,28,60,46.67,23,25,92,13,28,41,21,14,6,14,14
1297,PHI,1,240,41,87,47.1,7,21,33.3,34,66,51.52,23,29,79.3,16,37,53,23,5,7,15,18
1298,OKC,0,240,31,85,36.5,12,40,30,19,45,42.22,11,21,52.4,8,38,46,20,4,5,12,23
1299,DET,0,240,36,86,41.9,14,45,31.1,22,41,53.66,9,13,69.2,13,32,45,27,8,7,21,22
1300,GSW,0,240,46,97,47.4,19,42,45.2,27,55,49.09,9,15,60,9,36,45,37,8,0,13,19
1301,MEM,1,240,42,90,46.7,5,20,25,37,70,52.86,20,23,87,13,36,49,20,12,4,13,13
1302,BOS,1,240,50,90,55.6,14,35,40,36,55,65.45,7,10,70,9,35,44,26,8,12,18,21
1303,NOP,0,240,42,82,51.2,11,32,34.4,31,50,62,19,24,79.2,6,31,37,28,11,3,14,16
1304,DEN,1,240,46,80,57.5,15,31,48.4,31,49,63.27,13,17,76.5,6,31,37,24,9,2,17,17
1305,LAC,1,240,43,89,48.3,10,30,33.3,33,59,55.93,20,22,90.9,11,34,45,22,5,4,11,20
1306,CLE,0,240,39,83,47,12,31,38.7,27,52,51.92,13,21,61.9,13,21,34,30,8,4,18,15
1307,TOR,1,240,28,85,32.9,12,40,30,16,45,35.56,18,22,81.8,15,36,51,16,8,6,15,16
1308,MIN,0,240,32,83,38.6,9,38,23.7,23,45,51.11,8,11,72.7,6,37,43,24,6,9,17,23
1309,MIL,1,240,35,86,40.7,11,34,32.4,24,52,46.15,17,25,68,11,50,61,23,5,6,13,18
1310,PHX,1,240,51,88,58,22,39,56.4,29,49,59.18,8,12,66.7,4,33,37,38,8,4,13,17
1311,BKN,1,240,38,77,49.4,18,39,46.2,20,38,52.63,15,24,62.5,8,31,39,23,9,3,14,18
1312,LAL,0,240,40,83,48.2,8,30,26.7,32,53,60.38,10,14,71.4,10,29,39,21,7,4,16,16
1313,TOR,1,240,38,78,48.7,12,35,34.3,26,43,60.47,22,23,95.7,2,35,37,26,6,6,9,21
1314,SAC,0,240,43,93,46.2,15,41,36.6,28,52,53.85,9,16,56.3,13,31,44,29,7,3,16,18
1315,MIA,1,240,49,95,51.6,12,34,35.3,37,61,60.66,8,10,80,8,37,45,36,8,2,16,15
1316,MIL,0,240,35,88,39.8,10,34,29.4,25,54,46.3,16,23,69.6,15,37,52,23,6,2,15,23
1317,UTA,1,240,42,98,42.9,13,40,32.5,29,58,50,17,20,85,17,36,53,19,12,3,13,15
1318,OKC,0,240,35,78,44.9,19,41,46.3,16,37,43.24,24,28,85.7,6,33,39,25,5,3,18,25
1319,WAS,1,240,44,86,51.2,15,33,45.5,29,53,54.72,27,34,79.4,9,36,45,31,7,3,14,20
1320,NYK,0,240,33,87,37.9,7,27,25.9,26,60,43.33,16,19,84.2,10,36,46,16,7,5,16,14
1321,PHI,1,240,39,81,48.1,12,26,46.2,27,55,49.09,28,32,87.5,7,40,47,23,12,6,23,21
1322,POR,1,240,46,90,51.1,18,41,43.9,28,49,57.14,16,18,88.9,7,24,31,26,6,7,9,19
1323,ATL,1,240,44,77,57.1,8,24,33.3,36,53,67.92,26,31,83.9,8,29,37,19,8,2,15,18
1324,CHI,1,240,41,85,48.2,8,28,28.6,33,57,57.89,15,24,62.5,8,38,46,29,8,7,13,20
1325,BOS,0,240,40,86,46.5,10,31,32.3,30,55,54.55,24,27,88.9,11,26,37,22,9,3,16,27
1326,DEN,0,240,48,92,52.2,17,38,44.7,31,54,57.41,15,18,83.3,10,32,42,23,7,7,13,26
1327,ORL,1,240,42,92,45.7,16,34,47.1,26,58,44.83,7,10,70,10,40,50,27,10,7,14,15
1328,GSW,1,265,43,95,45.3,18,52,34.6,25,43,58.14,16,21,76.2,9,37,46,32,10,1,16,19
1329,NOP,0,240,43,89,48.3,15,32,46.9,28,57,49.12,23,29,79.3,18,33,51,25,5,1,12,15
1330,HOU,0,240,42,92,45.7,15,47,31.9,27,45,60,14,18,77.8,9,30,39,26,13,6,18,24
1331,MIA,0,265,44,97,45.4,13,36,36.1,31,61,50.82,11,12,91.7,7,42,49,28,8,5,18,22
1332,IND,1,265,49,97,50.5,13,26,50,36,71,50.7,23,27,85.2,10,41,51,31,5,7,15,18
1333,MIN,0,265,45,107,42.1,15,40,37.5,30,67,44.78,23,25,92,11,33,44,37,12,8,11,20
1334,DET,0,240,37,82,45.1,8,28,28.6,29,54,53.7,20,24,83.3,6,34,40,15,9,2,13,21
1335,LAC,0,240,38,86,44.2,9,26,34.6,29,60,48.33,11,17,64.7,9,38,47,18,5,2,17,19
1336,MEM,1,240,42,83,50.6,12,26,46.2,30,57,52.63,26,33,78.8,7,37,44,31,14,4,13,18
1337,POR,1,240,42,96,43.8,20,47,42.6,22,49,44.9,11,17,64.7,15,39,54,26,6,8,10,23
1338,TOR,1,240,46,91,50.5,17,43,39.5,29,48,60.42,15,21,71.4,8,36,44,25,8,6,15,18
1339,BOS,1,240,39,81,48.1,15,42,35.7,24,39,61.54,19,21,90.5,10,33,43,26,7,1,22,22
1340,OKC,0,240,37,85,43.5,10,33,30.3,27,52,51.92,20,27,74.1,7,39,46,23,6,3,11,16
1341,BKN,1,240,47,82,57.3,20,40,50,27,42,64.29,14,15,93.3,4,33,37,28,4,4,10,11
1342,NOP,1,240,56,91,61.5,19,38,50,37,53,69.81,13,17,76.5,11,36,47,33,14,4,19,19
1343,DEN,0,240,38,84,45.2,9,34,26.5,29,50,58,14,15,93.3,11,27,38,25,12,3,17,18
1344,MEM,0,240,42,88,47.7,13,31,41.9,29,57,50.88,16,18,88.9,9,23,32,23,10,0,19,18
1345,MIN,0,240,39,93,41.9,16,34,47.1,23,59,38.98,10,13,76.9,11,27,38,26,11,4,15,27
1346,MIL,0,240,40,83,48.2,14,37,37.8,26,46,56.52,19,25,76,5,36,41,25,10,5,17,17
1347,PHX,0,240,48,88,54.5,16,37,43.2,32,51,62.75,12,12,100,4,30,34,28,7,3,6,15
1348,LAL,1,240,42,77,54.5,11,26,42.3,31,51,60.78,17,21,81,6,32,38,20,8,8,18,14
1349,CHI,1,265,44,102,43.1,13,33,39.4,31,69,44.93,19,22,86.4,13,47,60,25,6,2,19,24
1350,MIA,0,240,46,91,50.5,8,36,22.2,38,55,69.09,18,22,81.8,9,30,39,27,7,6,8,21
1351,BKN,1,240,51,89,57.3,27,47,57.4,24,42,57.14,7,12,58.3,9,26,35,31,7,4,15,16
1352,WAS,1,240,48,92,52.2,12,30,40,36,62,58.06,23,31,74.2,10,37,47,25,14,2,15,24
1353,GSW,1,240,46,88,52.3,17,37,45.9,29,51,56.86,20,21,95.2,5,34,39,34,9,10,14,23
1354,ATL,0,240,36,85,42.4,11,33,33.3,25,52,48.08,29,32,90.6,11,31,42,17,5,6,11,19
1355,PHI,0,240,47,94,50,8,23,34.8,39,71,54.93,21,24,87.5,12,30,42,19,6,4,12,21
1356,UTA,1,240,45,86,52.3,18,45,40,27,41,65.85,26,31,83.9,7,29,36,18,9,4,11,18
1357,LAC,1,240,47,85,55.3,15,32,46.9,32,53,60.38,16,20,80,7,32,39,31,5,0,12,22
1358,SAC,0,240,51,96,53.1,12,33,36.4,39,63,61.9,11,13,84.6,15,26,41,24,6,6,15,13
1359,CLE,0,240,37,95,38.9,8,30,26.7,29,65,44.62,16,20,80,15,34,49,19,10,3,18,24
1360,NYK,1,240,42,83,50.6,17,34,50,25,49,51.02,22,27,81.5,10,32,42,22,5,6,9,22
1361,HOU,0,240,43,91,47.3,8,37,21.6,35,54,64.81,25,34,73.5,9,32,41,23,9,5,18,22
1362,IND,0,265,39,92,42.4,9,33,27.3,30,59,50.85,25,31,80.6,8,39,47,18,9,14,19,23
1363,BOS,0,240,32,90,35.6,9,35,25.7,23,55,41.82,18,30,60,14,36,50,14,5,2,17,27
1364,PHX,1,240,41,92,44.6,12,37,32.4,29,55,52.73,15,16,93.8,11,48,59,24,6,2,8,17
1365,MEM,1,240,50,94,53.2,9,21,42.9,41,73,56.16,15,19,78.9,9,34,43,31,10,2,11,20
1366,ORL,0,240,33,89,37.1,6,35,17.1,27,54,50,18,22,81.8,9,39,48,13,4,6,10,12
1367,DEN,1,240,39,85,45.9,19,47,40.4,20,38,52.63,25,34,73.5,9,38,47,28,6,4,10,24
1368,CLE,0,240,43,93,46.2,7,25,28,36,68,52.94,18,25,72,11,29,40,25,4,4,15,27
1369,OKC,1,240,45,95,47.4,15,36,41.7,30,59,50.85,9,16,56.3,12,37,49,32,8,1,15,14
1370,DET,1,240,45,84,53.6,17,35,48.6,28,49,57.14,16,20,80,9,28,37,34,3,8,14,23
1371,MIL,0,240,45,97,46.4,13,38,34.2,32,59,54.24,6,9,66.7,12,35,47,24,9,5,15,16
1372,LAL,0,240,40,87,46,6,28,21.4,34,59,57.63,19,29,65.5,8,38,46,27,4,4,10,26
1373,TOR,0,240,38,91,41.8,10,33,30.3,28,58,48.28,26,31,83.9,10,28,38,24,6,3,12,22
1374,POR,1,240,45,85,52.9,18,40,45,27,45,60,13,19,68.4,10,26,36,15,7,2,15,23
1375,SAC,0,240,41,82,50,8,33,24.2,33,49,67.35,20,26,76.9,5,28,33,22,8,5,16,19
1376,CHA,0,240,45,95,47.4,12,34,35.3,33,61,54.1,8,11,72.7,12,37,49,23,6,6,17,20
1377,MIN,1,240,43,82,52.4,16,39,41,27,43,62.79,14,19,73.7,5,35,40,28,6,8,18,26
1378,LAC,1,240,42,88,47.7,13,30,43.3,29,58,50,31,36,86.1,12,35,47,31,8,5,14,21
1379,SAS,1,240,48,96,50,10,34,29.4,38,62,61.29,16,19,84.2,10,33,43,31,13,4,9,13
1380,WAS,1,240,33,83,39.8,7,30,23.3,26,53,49.06,31,36,86.1,9,45,54,24,9,3,18,25
1381,DAL,0,240,40,81,49.4,14,41,34.1,26,40,65,24,25,96,10,25,35,19,5,6,14,21
1382,NOP,0,240,40,90,44.4,9,35,25.7,31,55,56.36,23,28,82.1,18,26,44,23,5,2,11,17
1383,ATL,0,240,43,90,47.8,9,31,29,34,59,57.63,18,23,78.3,7,31,38,35,5,4,11,24
1384,BKN,1,240,50,93,53.8,16,39,41,34,54,62.96,18,20,90,8,37,45,35,9,5,13,15
1385,GSW,0,240,44,90,48.9,9,34,26.5,35,56,62.5,20,25,80,5,32,37,25,6,6,13,15
1386,MIA,0,240,35,86,40.7,12,36,33.3,23,50,46,12,17,70.6,8,35,43,24,11,3,17,21
1387,IND,1,240,45,89,50.6,12,31,38.7,33,58,56.9,23,27,85.2,7,36,43,34,8,6,9,21
1388,PHX,1,240,48,79,60.8,10,25,40,38,54,70.37,14,17,82.4,4,28,32,25,8,3,14,24
1389,UTA,1,240,39,85,45.9,12,46,26.1,27,39,69.23,22,29,75.9,10,38,48,26,11,7,16,21
1390,PHI,0,240,38,73,52.1,7,17,41.2,31,56,55.36,28,33,84.8,8,27,35,19,7,1,13,15
1391,NYK,1,240,45,86,52.3,12,28,42.9,33,58,56.9,19,23,82.6,4,40,44,21,4,4,8,21
1392,HOU,0,240,33,88,37.5,8,43,18.6,25,45,55.56,25,30,83.3,12,34,46,17,5,5,9,17
1393,NOP,0,240,48,90,53.3,17,37,45.9,31,53,58.49,17,23,73.9,9,29,38,31,5,3,10,19
1394,DET,1,240,34,79,43,15,38,39.5,19,41,46.34,25,30,83.3,6,38,44,25,3,6,13,20
1395,CLE,0,240,38,87,43.7,8,23,34.8,30,64,46.88,26,37,70.3,10,31,41,20,6,3,11,21
1396,SAS,1,240,45,85,52.9,12,31,38.7,33,54,61.11,23,28,82.1,8,38,46,27,6,6,14,25
1397,CHI,0,240,40,85,47.1,12,32,37.5,28,53,52.83,14,15,93.3,8,33,41,23,4,3,13,16
1398,MIN,0,240,45,99,45.5,16,41,39,29,58,50,8,14,57.1,9,31,40,28,10,4,8,18
1399,POR,1,240,43,83,51.8,13,35,37.1,30,48,62.5,30,33,90.9,9,36,45,16,3,4,14,29
1400,NYK,1,240,44,98,44.9,6,24,25,38,74,51.35,15,22,68.2,15,50,65,22,11,4,12,22
1401,LAC,1,240,50,86,58.1,13,30,43.3,37,56,66.07,12,15,80,4,33,37,20,11,7,9,13
1402,BOS,0,240,36,82,43.9,8,27,29.6,28,55,50.91,22,30,73.3,7,37,44,15,9,2,10,25
1403,SAC,0,240,43,83,51.8,12,33,36.4,31,50,62,14,19,73.7,8,34,42,33,8,1,18,18
1404,OKC,0,240,36,90,40,10,32,31.3,26,58,44.83,13,17,76.5,12,38,50,26,8,3,14,19
1405,LAL,1,240,43,85,50.6,6,30,20,37,55,67.27,23,33,69.7,13,34,47,26,9,4,18,16
1406,DAL,1,240,51,88,58,25,45,55.6,26,43,60.47,16,21,76.2,5,32,37,30,4,2,6,22
1407,UTA,1,240,43,82,52.4,14,38,36.8,29,44,65.91,29,34,85.3,7,39,46,22,4,5,17,22
1408,MEM,0,240,39,80,48.8,12,29,41.4,27,51,52.94,15,19,78.9,6,27,33,31,9,2,17,25
1409,CHA,1,240,44,90,48.9,13,36,36.1,31,54,57.41,19,19,100,12,43,55,20,4,3,20,17
1410,ORL,1,240,46,91,50.5,15,34,44.1,31,57,54.39,16,20,80,10,32,42,25,8,2,10,15
1411,WAS,0,240,34,89,38.2,9,34,26.5,25,55,45.45,14,20,70,9,37,46,20,5,5,14,18
1412,DEN,1,240,40,87,46,10,40,25,30,47,63.83,7,10,70,7,34,41,24,6,6,13,14
1413,ATL,0,240,39,90,43.3,11,32,34.4,28,58,48.28,25,33,75.8,10,31,41,22,10,4,12,17
1414,MIL,0,240,42,92,45.7,12,33,36.4,30,59,50.85,19,27,70.4,6,27,33,19,8,6,10,28
1415,TOR,0,240,41,83,49.4,9,28,32.1,32,55,58.18,15,19,78.9,3,29,32,26,7,8,13,26
1416,MIA,1,240,34,79,43,15,42,35.7,19,37,51.35,18,20,90,8,41,49,24,6,3,21,21
1417,HOU,0,240,32,83,38.6,15,50,30,17,33,51.52,15,20,75,8,34,42,24,7,1,15,20
1418,PHI,0,240,42,86,48.8,6,27,22.2,36,59,61.02,24,29,82.8,11,35,46,20,6,5,9,20
1419,BOS,1,240,39,86,45.3,20,39,51.3,19,47,40.43,22,28,78.6,14,35,49,30,8,6,19,22
1420,GSW,1,240,41,88,46.6,20,50,40,21,38,55.26,9,12,75,9,37,46,29,6,6,17,20
1421,ORL,0,240,38,97,39.2,15,33,45.5,23,64,35.94,14,18,77.8,13,36,49,19,7,6,15,17
1422,POR,1,240,40,93,43,17,38,44.7,23,55,41.82,21,23,91.3,15,32,47,15,5,2,8,21
1423,IND,1,240,44,86,51.2,14,31,45.2,30,55,54.55,9,10,90,10,31,41,26,10,5,9,18
1424,DET,0,240,38,85,44.7,5,28,17.9,33,57,57.89,14,19,73.7,15,28,43,21,5,5,12,13
1425,DEN,1,240,51,85,60,16,36,44.4,35,49,71.43,15,21,71.4,4,35,39,31,12,9,12,18
1426,WAS,0,240,42,93,45.2,12,41,29.3,30,52,57.69,19,23,82.6,12,34,46,26,7,3,14,20
1427,CHI,1,240,48,81,59.3,25,47,53.2,23,34,67.65,8,11,72.7,7,28,35,36,4,6,17,20
1428,LAL,1,265,42,89,47.2,10,35,28.6,32,54,59.26,20,24,83.3,6,37,43,22,6,6,17,15
1429,CLE,0,240,36,94,38.3,8,37,21.6,28,57,49.12,15,20,75,18,31,49,25,7,7,17,18
1430,MEM,1,240,47,94,50,23,49,46.9,24,45,53.33,13,18,72.2,19,27,46,34,10,2,17,18
1431,OKC,0,265,47,100,47,7,31,22.6,40,69,57.97,12,14,85.7,7,39,46,32,11,4,13,23
1432,NOP,0,240,41,81,50.6,13,36,36.1,28,45,62.22,21,26,80.8,9,26,35,27,11,1,12,12
1433,CHA,0,240,45,82,54.9,14,29,48.3,31,53,58.49,10,12,83.3,8,27,35,23,11,4,19,14
1434,BKN,1,240,32,76,42.1,9,31,29,23,45,51.11,31,35,88.6,9,37,46,20,2,5,13,20
1435,ATL,0,240,40,88,45.5,14,39,35.9,26,49,53.06,23,28,82.1,9,33,42,27,7,4,9,20
1436,TOR,1,240,49,93,52.7,19,32,59.4,30,61,49.18,20,23,87,9,37,46,28,5,5,12,17
1437,MIL,0,240,43,85,50.6,16,37,43.2,27,48,56.25,22,30,73.3,10,29,39,23,6,0,10,21
1438,LAC,1,240,41,82,50,12,23,52.2,29,59,49.15,25,29,86.2,11,37,48,23,9,4,16,20
1439,MIN,0,240,41,95,43.2,15,41,36.6,26,54,48.15,15,19,78.9,16,27,43,29,8,8,15,24
1440,PHX,1,240,46,87,52.9,15,31,48.4,31,56,55.36,18,25,72,12,35,47,25,7,2,11,19
1441,DAL,1,240,43,84,51.2,14,35,40,29,49,59.18,18,20,90,4,33,37,25,3,3,11,24
1442,IND,0,240,36,92,39.1,15,38,39.5,21,54,38.89,7,11,63.6,10,33,43,26,4,5,10,21
1443,ORL,0,240,37,88,42,11,35,31.4,26,53,49.06,12,22,54.5,10,43,53,22,7,3,11,11
1444,NYK,0,240,37,87,42.5,10,28,35.7,27,59,45.76,12,16,75,11,35,46,22,8,5,14,25
1445,BKN,0,240,43,86,50,11,30,36.7,32,56,57.14,14,16,87.5,8,26,34,30,8,6,15,22
1446,GSW,1,240,42,91,46.2,17,40,42.5,25,51,49.02,13,19,68.4,10,40,50,26,8,4,11,19
1447,MIA,1,240,26,70,37.1,14,33,42.4,12,37,32.43,32,39,82.1,6,32,38,21,5,6,11,14
1448,HOU,0,240,38,91,41.8,13,43,30.2,25,48,52.08,12,21,57.1,12,25,37,24,5,4,12,23
1449,PHI,1,240,41,85,48.2,9,20,45,32,65,49.23,28,35,80,12,47,59,24,4,5,17,22
1450,SAS,0,240,32,86,37.2,8,24,33.3,24,62,38.71,19,21,90.5,8,37,45,20,2,5,14,16
1451,POR,1,240,35,90,38.9,18,46,39.1,17,44,38.64,18,19,94.7,9,45,54,18,6,6,9,17
1452,DET,1,240,47,84,56,13,29,44.8,34,55,61.82,15,21,71.4,7,30,37,28,10,6,13,16
1453,NOP,1,240,47,92,51.1,12,31,38.7,35,61,57.38,24,28,85.7,15,40,55,31,7,6,12,20
1454,UTA,1,240,40,84,47.6,18,48,37.5,22,36,61.11,24,27,88.9,10,31,41,28,4,7,11,22
1455,BOS,0,240,38,86,44.2,13,29,44.8,25,57,43.86,19,23,82.6,11,24,35,18,2,2,9,25
1456,SAC,0,240,43,99,43.4,14,42,33.3,29,57,50.88,11,19,57.9,8,31,39,24,6,8,11,28
1457,GSW,0,240,38,86,44.2,13,37,35.1,25,49,51.02,11,15,73.3,6,43,49,29,4,6,20,19
1458,DEN,0,240,41,94,43.6,15,36,41.7,26,58,44.83,15,16,93.8,8,30,38,22,5,4,9,15
1459,HOU,0,240,35,86,40.7,13,47,27.7,22,39,56.41,11,16,68.8,8,31,39,20,9,4,12,18
1460,WAS,1,240,36,86,41.9,6,26,23.1,30,60,50,27,36,75,10,37,47,23,8,4,13,21
1461,MIL,1,240,45,89,50.6,16,40,40,29,49,59.18,19,22,86.4,11,39,50,24,7,7,11,19
1462,LAL,1,265,44,95,46.3,9,38,23.7,35,57,61.4,22,29,75.9,10,49,59,28,7,12,15,19
1463,PHX,1,240,47,90,52.2,11,24,45.8,36,66,54.55,14,19,73.7,14,27,41,29,7,6,11,20
1464,SAS,1,240,39,96,40.6,11,31,35.5,28,65,43.08,16,19,84.2,10,36,46,24,12,6,11,16
1465,DAL,1,240,45,87,51.7,12,34,35.3,33,53,62.26,25,30,83.3,10,38,48,30,4,6,14,22
1466,CHA,1,240,44,90,48.9,19,41,46.3,25,49,51.02,12,13,92.3,11,40,51,28,5,6,15,15
1467,TOR,1,240,42,77,54.5,20,37,54.1,22,40,55,24,26,92.3,7,30,37,28,11,2,16,24
1468,MEM,0,240,37,87,42.5,13,39,33.3,24,48,50,26,29,89.7,19,23,42,27,7,4,15,18
1469,OKC,0,265,43,110,39.1,12,38,31.6,31,72,43.06,14,19,73.7,15,40,55,23,6,4,13,23
1470,MIN,0,240,42,91,46.2,18,42,42.9,24,49,48.98,20,28,71.4,7,34,41,27,9,5,9,27
1471,CLE,0,240,44,86,51.2,8,24,33.3,36,62,58.06,17,25,68,9,30,39,23,5,5,10,20
1472,CHI,0,240,36,85,42.4,9,30,30,27,55,49.09,20,24,83.3,10,40,50,23,6,3,16,26
1473,IND,0,240,37,93,39.8,8,29,27.6,29,64,45.31,13,18,72.2,8,37,45,23,9,6,9,22
1474,PHX,1,240,40,82,48.8,8,29,27.6,32,53,60.38,12,12,100,9,41,50,25,4,5,10,15
1475,MIA,1,240,40,83,48.2,13,35,37.1,27,48,56.25,16,20,80,6,38,44,25,6,1,11,15
1476,CHA,1,240,42,99,42.4,15,36,41.7,27,63,42.86,20,26,76.9,18,41,59,21,6,6,11,25
1477,BOS,0,240,33,93,35.5,17,44,38.6,16,49,32.65,8,12,66.7,13,28,41,19,6,2,6,11
1478,UTA,1,240,38,92,41.3,13,42,31,25,50,50,14,21,66.7,16,44,60,22,2,4,14,17
1479,WAS,0,240,34,90,37.8,9,40,22.5,25,50,50,20,28,71.4,12,36,48,22,6,5,14,18
1480,SAC,1,240,46,94,48.9,10,29,34.5,36,65,55.38,11,15,73.3,11,41,52,25,5,4,12,18
1481,NYK,0,240,38,85,44.7,16,42,38.1,22,43,51.16,11,15,73.3,10,34,44,23,8,2,13,20
1482,LAC,0,240,41,99,41.4,8,28,28.6,33,71,46.48,20,23,87,16,37,53,19,8,5,10,16
1483,DEN,0,240,45,97,46.4,13,35,37.1,32,62,51.61,11,14,78.6,13,34,47,30,3,9,10,18
1484,ATL,1,240,42,74,56.8,19,36,52.8,23,38,60.53,29,33,87.9,4,39,43,31,1,10,19,25
1485,OKC,1,240,46,90,51.1,12,33,36.4,34,57,59.65,16,20,80,8,35,43,25,8,1,16,19
1486,CHI,1,240,47,91,51.6,15,30,50,32,61,52.46,9,13,69.2,11,36,47,28,6,10,12,12
1487,ORL,0,240,37,95,38.9,6,27,22.2,31,68,45.59,12,12,100,15,32,47,17,5,10,13,10
1488,DET,0,290,45,94,47.9,16,42,38.1,29,52,55.77,23,28,82.1,9,26,35,31,13,4,23,31
1489,LAL,1,290,51,91,56,9,19,47.4,42,72,58.33,24,28,85.7,9,32,41,32,12,5,24,24
1490,BKN,0,240,39,88,44.3,15,41,36.6,24,47,51.06,15,17,88.2,8,26,34,21,6,3,17,18
1491,NOP,1,240,45,87,51.7,15,33,45.5,30,54,55.56,13,21,61.9,8,34,42,27,3,9,10,15
1492,MEM,0,240,40,90,44.4,13,39,33.3,27,51,52.94,16,19,84.2,11,34,45,27,5,5,10,17
1493,MIN,0,240,47,93,50.5,12,36,33.3,35,57,61.4,12,22,54.5,13,27,40,27,12,3,14,15
1494,SAS,1,240,37,87,42.5,8,25,32,29,62,46.77,29,36,80.6,7,37,44,22,6,7,10,18
1495,TOR,0,240,41,97,42.3,13,38,34.2,28,59,47.46,26,34,76.5,14,24,38,24,9,5,7,27
1496,SAC,1,240,44,91,48.4,14,35,40,30,56,53.57,17,24,70.8,10,35,45,30,5,7,7,11
1497,PHI,1,240,48,94,51.1,10,27,37,38,67,56.72,18,22,81.8,13,38,51,27,12,4,16,15
1498,DAL,1,240,44,96,45.8,21,47,44.7,23,49,46.94,25,30,83.3,15,32,47,27,5,0,14,19
1499,NYK,1,240,44,88,50,13,30,43.3,31,58,53.45,9,13,69.2,8,43,51,20,5,5,14,19
1500,POR,0,240,37,89,41.6,17,47,36.2,20,42,47.62,8,16,50,11,30,41,15,7,7,11,15
1501,HOU,0,240,38,88,43.2,12,38,31.6,26,50,52,18,25,72,6,40,46,21,5,6,14,25
1502,MIL,1,240,47,86,54.7,16,34,47.1,31,52,59.62,14,23,60.9,6,37,43,25,10,2,9,20
1503,GSW,0,240,46,86,53.5,20,45,44.4,26,41,63.41,20,23,87,6,34,40,27,11,4,16,24
1504,CLE,0,240,39,86,45.3,6,28,21.4,33,58,56.9,15,21,71.4,8,32,40,21,4,1,15,19
1505,ORL,1,240,42,81,51.9,11,27,40.7,31,54,57.41,28,37,75.7,10,39,49,27,5,2,16,22
1506,CLE,0,240,41,92,44.6,11,32,34.4,30,60,50,12,16,75,6,30,36,23,7,9,11,19
1507,PHX,1,240,42,85,49.4,12,32,37.5,30,53,56.6,13,16,81.3,10,40,50,26,7,3,22,26
1508,OKC,0,240,39,85,45.9,13,34,38.2,26,51,50.98,12,17,70.6,8,36,44,28,10,7,17,7
1509,IND,0,240,41,93,44.1,20,42,47.6,21,51,41.18,11,16,68.8,10,27,37,31,9,6,10,21
1510,UTA,1,240,48,87,55.2,26,50,52,22,37,59.46,16,18,88.9,6,38,44,32,5,9,16,19
1511,WAS,0,240,33,89,37.1,8,33,24.2,25,56,44.64,21,24,87.5,12,28,40,19,7,9,18,20
1512,CHA,0,240,48,104,46.2,11,35,31.4,37,69,53.62,14,17,82.4,14,26,40,26,9,2,7,17
1513,BKN,0,240,39,80,48.8,17,42,40.5,22,38,57.89,22,29,75.9,8,32,40,29,5,6,18,19
1514,CHI,0,240,46,96,47.9,9,30,30,37,66,56.06,18,20,90,10,30,40,27,9,5,8,22
1515,NOP,1,240,41,76,53.9,13,25,52,28,51,54.9,19,26,73.1,11,39,50,23,5,6,20,17
1516,TOR,1,240,49,97,50.5,13,32,40.6,36,65,55.38,12,14,85.7,12,29,41,22,10,6,10,25
1517,LAC,0,240,42,81,51.9,14,32,43.8,28,49,57.14,17,21,81,10,37,47,26,5,4,16,17
1518,MIN,1,240,41,94,43.6,16,40,40,25,54,46.3,8,9,88.9,10,33,43,27,10,4,17,15
1519,MIA,1,240,43,86,50,16,36,44.4,27,50,54,20,23,87,9,39,48,27,9,7,17,20
1520,DET,0,240,34,91,37.4,7,36,19.4,27,55,49.09,17,28,60.7,17,28,45,20,8,6,13,16
1521,MIL,1,240,50,97,51.5,7,22,31.8,43,75,57.33,16,22,72.7,13,41,54,28,6,7,13,18
1522,BOS,1,240,43,90,47.8,16,38,42.1,27,52,51.92,17,21,81,9,25,34,21,8,1,7,16
1523,DEN,0,240,36,92,39.1,8,28,28.6,28,64,43.75,13,15,86.7,16,26,42,19,9,2,17,23
1524,ATL,0,240,32,98,32.7,9,31,29,23,67,34.33,18,19,94.7,18,31,49,19,8,1,11,15
1525,LAL,1,240,46,81,56.8,8,24,33.3,38,57,66.67,14,22,63.6,8,32,40,29,10,7,16,19
1526,HOU,1,240,41,87,47.1,19,45,42.2,22,42,52.38,14,17,82.4,8,36,44,26,8,3,15,19
1527,POR,1,240,45,98,45.9,13,31,41.9,32,67,47.76,18,23,78.3,19,34,53,17,8,5,12,18
1528,DAL,0,240,38,92,41.3,20,50,40,18,42,42.86,20,23,87,10,32,42,26,2,3,10,24
1529,UTA,1,240,44,91,48.4,13,27,48.1,31,64,48.44,11,13,84.6,12,40,52,19,7,4,14,20
1530,GSW,1,240,51,89,57.3,22,43,51.2,29,46,63.04,23,27,85.2,4,41,45,37,6,6,10,19
1531,PHI,0,240,39,81,48.1,7,27,25.9,32,54,59.26,20,24,83.3,8,29,37,19,6,3,18,15
1532,MEM,0,240,37,87,42.5,12,35,34.3,25,52,48.08,17,24,70.8,11,32,43,28,10,6,13,15
1533,MIN,0,240,43,94,45.7,13,33,39.4,30,61,49.18,9,11,81.8,9,40,49,22,6,9,10,21
1534,SAC,1,240,42,92,45.7,13,37,35.1,29,55,52.73,19,23,82.6,12,32,44,23,7,2,11,19
1535,PHI,1,240,41,79,51.9,10,24,41.7,31,55,56.36,26,32,81.3,10,30,40,23,9,6,19,21
1536,OKC,1,240,36,83,43.4,10,33,30.3,26,50,52,22,26,84.6,5,46,51,19,13,5,21,14
1537,PHX,0,240,38,82,46.3,8,35,22.9,30,47,63.83,17,20,85,11,28,39,26,3,6,15,18
1538,LAC,1,240,44,79,55.7,20,34,58.8,24,45,53.33,13,17,76.5,8,38,46,22,4,6,16,20
1539,IND,0,240,43,95,45.3,11,34,32.4,32,61,52.46,13,15,86.7,8,38,46,28,7,6,14,13
1540,MIA,0,240,36,83,43.4,12,35,34.3,24,48,50,16,22,72.7,9,35,44,24,11,2,16,21
1541,BOS,0,240,39,86,45.3,11,33,33.3,28,53,52.83,22,29,75.9,11,34,45,28,9,3,13,21
1542,DAL,1,240,43,93,46.2,13,40,32.5,30,53,56.6,23,25,92,13,32,45,27,8,7,10,19
1543,CLE,0,240,41,92,44.6,4,10,40,37,82,45.12,13,17,76.5,11,26,37,21,8,6,8,14
1544,CHA,0,240,39,87,44.8,14,37,37.8,25,50,50,19,23,82.6,10,27,37,28,5,4,19,22
1545,SAS,1,240,43,96,44.8,7,26,26.9,36,70,51.43,18,24,75,7,38,45,28,5,6,7,13
1546,HOU,0,240,33,86,38.4,12,46,26.1,21,40,52.5,9,13,69.2,5,36,41,21,11,4,21,18
1547,NYK,1,240,43,89,48.3,11,22,50,32,67,47.76,10,15,66.7,11,36,47,19,5,4,17,18
1548,NOP,1,240,46,90,51.1,14,33,42.4,32,57,56.14,17,21,81,12,32,44,30,7,3,7,20
1549,CHI,0,240,43,88,48.9,6,36,16.7,37,52,71.15,11,16,68.8,6,32,38,25,11,3,9,14
1550,MIL,1,240,48,102,47.1,21,48,43.8,27,54,50,13,14,92.9,11,42,53,33,13,7,13,11
1551,WAS,1,240,35,84,41.7,15,37,40.5,20,47,42.55,18,25,72,14,35,49,20,6,5,17,17
1552,ATL,0,240,45,90,50,14,38,36.8,31,52,59.62,12,17,70.6,13,33,46,31,6,4,16,20
1553,IND,1,240,49,82,59.8,16,29,55.2,33,53,62.26,20,29,69,9,33,42,30,8,8,18,19
1554,DET,0,240,39,93,41.9,9,27,33.3,30,66,45.45,18,20,90,12,34,46,18,7,5,15,21
1555,WAS,0,240,46,83,55.4,16,40,40,30,43,69.77,13,17,76.5,6,33,39,32,2,5,14,21
1556,UTA,1,240,38,82,46.3,16,42,38.1,22,40,55,25,29,86.2,8,36,44,23,9,6,13,17
1557,ORL,0,240,41,89,46.1,14,38,36.8,27,51,52.94,12,14,85.7,9,37,46,24,4,4,17,22
1558,TOR,1,240,40,83,48.2,20,45,44.4,20,38,52.63,23,25,92,6,34,40,32,14,4,11,18
1559,GSW,0,240,38,83,45.8,15,37,40.5,23,46,50,16,23,69.6,6,30,36,30,9,4,11,23
1560,LAC,0,240,45,99,45.5,15,36,41.7,30,63,47.62,15,17,88.2,11,28,39,21,12,5,8,18
1561,POR,1,240,44,95,46.3,21,46,45.7,23,49,46.94,23,23,100,14,30,44,19,6,1,9,19
1562,MEM,0,240,42,93,45.2,9,25,36,33,68,48.53,23,24,95.8,10,26,36,27,11,7,16,22
1563,BKN,1,240,45,79,57,13,31,41.9,32,48,66.67,21,26,80.8,6,38,44,25,6,4,17,17
1564,BOS,1,240,39,84,46.4,13,34,38.2,26,50,52,20,27,74.1,12,39,51,16,3,4,16,20
1565,MIL,1,240,53,96,55.2,21,42,50,32,54,59.26,7,12,58.3,9,44,53,38,10,7,13,13
1566,LAL,1,240,40,77,51.9,7,23,30.4,33,54,61.11,20,24,83.3,4,27,31,24,10,7,13,20
1567,HOU,1,240,49,102,48,28,52,53.8,21,50,42,10,11,90.9,10,40,50,30,8,6,13,20
1568,MEM,1,240,52,93,55.9,15,30,50,37,63,58.73,14,18,77.8,10,43,53,37,11,11,11,16
1569,NOP,0,240,40,101,39.6,9,30,30,31,71,43.66,20,24,83.3,17,29,46,22,11,5,10,22
1570,CLE,1,240,35,84,41.7,7,22,31.8,28,62,45.16,23,31,74.2,15,37,52,26,4,12,15,12
1571,SAC,1,240,42,88,47.7,14,43,32.6,28,45,62.22,20,26,76.9,13,39,52,31,3,8,20,18
1572,DAL,0,240,37,86,43,10,32,31.3,27,54,50,24,25,96,7,35,42,16,9,7,14,17
1573,MIA,0,265,43,91,47.3,19,46,41.3,24,45,53.33,16,25,64,10,38,48,28,8,7,17,26
1574,CHA,1,265,43,95,45.3,21,41,51.2,22,54,40.74,22,26,84.6,13,31,44,31,6,4,12,22
1575,NYK,0,240,37,87,42.5,6,29,20.7,31,58,53.45,22,26,84.6,11,34,45,21,6,6,12,19
1576,CHI,1,240,42,88,47.7,11,34,32.4,31,54,57.41,15,20,75,7,33,40,30,3,1,12,19
1577,POR,0,240,39,104,37.5,15,42,35.7,24,62,38.71,13,13,100,14,31,45,19,8,6,11,10
1578,ATL,0,240,37,78,47.4,11,29,37.9,26,49,53.06,14,17,82.4,6,30,36,27,8,3,19,21
1579,SAS,0,240,37,89,41.6,13,37,35.1,24,52,46.15,15,22,68.2,10,32,42,28,8,7,15,13
1580,PHX,1,240,43,92,46.7,13,35,37.1,30,57,52.63,10,12,83.3,11,34,45,19,7,3,16,24
1581,MIN,0,240,40,102,39.2,11,38,28.9,29,64,45.31,7,11,63.6,15,30,45,20,4,1,8,21
1582,OKC,0,240,39,89,43.8,13,34,38.2,26,55,47.27,15,19,78.9,8,37,45,21,8,8,17,13
1583,DEN,1,240,47,87,54,18,28,64.3,29,59,49.15,16,19,84.2,7,32,39,28,8,2,8,27
1584,IND,0,240,41,84,48.8,10,28,35.7,31,56,55.36,18,22,81.8,9,32,41,21,6,7,18,25
1585,TOR,1,240,41,90,45.6,12,39,30.8,29,51,56.86,21,22,95.5,9,39,48,27,8,5,11,22
1586,ORL,0,240,33,82,40.2,13,36,36.1,20,46,43.48,23,28,82.1,6,36,42,22,8,5,11,18
1587,LAC,1,240,44,81,54.3,17,38,44.7,27,43,62.79,24,28,85.7,7,31,38,26,2,4,7,14
1588,CLE,0,240,41,84,48.8,4,16,25,37,68,54.41,18,23,78.3,10,45,55,20,3,3,19,14
1589,UTA,0,240,32,75,42.7,20,47,42.6,12,28,42.86,33,39,84.6,10,28,38,28,3,4,15,21
1590,NYK,0,240,41,85,48.2,10,27,37,31,58,53.45,23,28,82.1,10,26,36,21,5,5,8,20
1591,PHI,1,240,45,92,48.9,8,26,30.8,37,66,56.06,21,31,67.7,14,30,44,20,9,8,12,21
1592,BKN,0,240,50,88,56.8,19,36,52.8,31,52,59.62,27,33,81.8,7,38,45,33,6,5,17,24
1593,WAS,1,240,56,108,51.9,12,39,30.8,44,69,63.77,25,32,78.1,11,28,39,24,10,2,7,22
1594,MIN,1,240,41,91,45.1,16,40,40,25,51,49.02,11,15,73.3,7,27,34,24,10,11,10,25
1595,MEM,1,240,51,91,56,17,35,48.6,34,56,60.71,10,15,66.7,10,35,45,34,7,7,15,23
1596,SAS,0,240,39,83,47,13,29,44.8,26,54,48.15,21,26,80.8,8,30,38,25,7,5,14,16
1597,LAL,1,240,37,84,44,9,31,29,28,53,52.83,13,19,68.4,13,32,45,20,8,4,14,15
1598,PHX,1,240,37,81,45.7,10,22,45.5,27,59,45.76,27,31,87.1,9,33,42,22,9,0,13,19
1599,MIL,0,240,40,82,48.8,18,45,40,22,37,59.46,16,24,66.7,8,38,46,22,6,6,16,17
1600,GSW,1,240,47,89,52.8,17,36,47.2,30,53,56.6,7,10,70,8,39,47,34,6,5,14,23
1601,POR,1,240,45,88,51.1,17,42,40.5,28,46,60.87,16,19,84.2,9,26,35,20,11,1,8,17
1602,DET,0,240,29,77,37.7,9,36,25,20,41,48.78,24,32,75,7,31,38,17,7,4,16,14
1603,CHA,1,240,44,92,47.8,21,44,47.7,23,48,47.92,17,20,85,7,34,41,32,8,5,9,20
1604,CHI,0,240,43,85,50.6,21,45,46.7,22,40,55,15,15,100,11,32,43,31,5,2,15,14
1605,SAC,0,240,41,85,48.2,17,45,37.8,24,40,60,5,11,45.5,12,29,41,22,12,3,17,21
1606,BOS,0,240,40,82,48.8,6,21,28.6,34,61,55.74,9,14,64.3,9,33,42,24,10,6,15,16
1607,HOU,1,240,45,92,48.9,20,46,43.5,25,46,54.35,16,20,80,7,38,45,32,8,5,16,24
1608,NOP,0,240,41,91,45.1,12,41,29.3,29,50,58,18,29,62.1,10,38,48,27,11,7,15,14
1609,DAL,0,240,44,83,53,9,29,31,35,54,64.81,8,14,57.1,5,32,37,22,5,4,16,26
1610,MIA,1,240,36,77,46.8,11,32,34.4,25,45,55.56,22,26,84.6,9,30,39,25,5,4,16,14
1611,SAC,1,240,43,78,55.1,16,36,44.4,27,42,64.29,24,31,77.4,11,27,38,31,7,5,22,25
1612,PHI,1,240,39,87,44.8,8,16,50,31,71,43.66,32,38,84.2,12,39,51,20,11,6,10,17
1613,LAC,1,240,46,94,48.9,13,37,35.1,33,57,57.89,11,11,100,9,40,49,25,8,5,11,15
1614,ORL,0,240,32,89,36,10,33,30.3,22,56,39.29,16,18,88.9,12,37,49,20,6,2,17,12
1615,IND,0,240,42,87,48.3,11,35,31.4,31,52,59.62,10,13,76.9,9,30,39,30,7,4,16,13
1616,NYK,1,240,39,80,48.8,10,27,37,29,53,54.72,14,16,87.5,8,33,41,20,8,6,14,24
1617,SAS,1,240,44,81,54.3,10,23,43.5,34,58,58.62,21,26,80.8,9,32,41,29,8,1,13,18
1618,UTA,1,240,38,87,43.7,20,48,41.7,18,39,46.15,24,26,92.3,17,39,56,21,8,5,15,25
1619,DAL,0,240,37,86,43,9,33,27.3,28,53,52.83,18,27,66.7,8,32,40,20,6,4,11,27
1620,DEN,0,240,41,78,52.6,14,31,45.2,27,47,57.45,13,20,65,7,30,37,25,8,5,16,15
1621,BKN,1,240,57,100,57,19,45,42.2,38,55,69.09,14,16,87.5,10,40,50,33,7,4,11,25
1622,ATL,1,240,39,87,44.8,12,37,32.4,27,50,54,26,34,76.5,12,35,47,16,5,4,13,30
1623,WAS,0,240,31,85,36.5,7,28,25,24,57,42.11,31,38,81.6,13,34,47,13,6,4,13,27
1624,MIL,0,240,48,96,50,13,35,37.1,35,61,57.38,17,22,77.3,12,37,49,29,5,5,12,19
1625,OKC,0,240,40,86,46.5,16,38,42.1,24,48,50,29,34,85.3,6,30,36,23,4,4,12,12
1626,CHA,1,240,43,85,50.6,16,37,43.2,27,48,56.25,6,9,66.7,9,33,42,35,7,5,17,13
1627,CLE,0,240,29,84,34.5,8,26,30.8,21,58,36.21,15,18,83.3,14,29,43,15,8,5,14,20
1628,MIN,0,240,35,82,42.7,10,33,30.3,25,49,51.02,14,18,77.8,4,34,38,20,3,4,18,29
1629,TOR,0,240,42,86,48.8,13,32,40.6,29,54,53.7,27,33,81.8,12,23,35,20,14,2,15,27
1630,NOP,1,240,45,96,46.9,21,48,43.8,24,48,50,20,28,71.4,12,33,45,32,7,3,9,16
1631,LAL,0,240,36,88,40.9,12,28,42.9,24,60,40,8,12,66.7,12,32,44,25,2,3,11,16
1632,HOU,1,240,38,90,42.2,13,47,27.7,25,43,58.14,15,18,83.3,10,37,47,19,8,7,14,12
1633,GSW,0,240,38,99,38.4,11,38,28.9,27,61,44.26,6,8,75,12,36,48,21,8,1,13,19
1634,POR,0,240,39,93,41.9,17,41,41.5,22,52,42.31,6,8,75,10,39,49,16,6,7,15,16
1635,MIA,0,240,40,90,44.4,13,33,39.4,27,57,47.37,12,15,80,8,37,45,24,5,1,14,18
1636,PHX,1,240,41,88,46.6,11,32,34.4,30,56,53.57,21,23,91.3,9,48,57,34,7,1,14,14
1637,DET,1,240,40,87,46,14,36,38.9,26,51,50.98,13,13,100,5,33,38,27,4,2,9,18
1638,LAC,1,240,36,87,41.4,17,42,40.5,19,45,42.22,20,22,90.9,13,42,55,22,11,4,12,20
1639,ORL,0,240,40,96,41.7,10,26,38.5,30,70,42.86,17,18,94.4,17,30,47,25,8,8,14,23
1640,SAS,1,240,46,82,56.1,8,28,28.6,38,54,70.37,10,16,62.5,9,37,46,22,5,4,20,16
1641,MIN,0,240,37,87,42.5,14,36,38.9,23,51,45.1,23,33,69.7,11,28,39,23,12,7,17,22
1642,BOS,0,240,42,98,42.9,10,30,33.3,32,68,47.06,12,14,85.7,13,26,39,15,10,4,12,14
1643,NOP,1,240,46,89,51.7,17,43,39.5,29,46,63.04,15,24,62.5,12,38,50,27,7,4,15,17
1644,UTA,1,240,42,91,46.2,16,41,39,26,50,52,16,21,76.2,11,39,50,20,7,7,10,18
1645,IND,1,240,45,88,51.1,16,40,40,29,48,60.42,10,12,83.3,11,36,47,34,1,9,12,19
1646,PHI,1,240,41,85,48.2,9,25,36,32,60,53.33,16,26,61.5,7,31,38,24,10,7,14,24
1647,OKC,1,240,38,85,44.7,16,40,40,22,45,48.89,10,14,71.4,5,43,48,21,7,8,14,19
1648,MIL,1,240,40,93,43,16,44,36.4,24,49,48.98,19,26,73.1,14,45,59,30,9,3,15,14
1649,DAL,0,240,42,91,46.2,12,35,34.3,30,56,53.57,8,9,88.9,4,32,36,22,4,7,8,12
1650,CLE,1,240,47,87,54,11,21,52.4,36,66,54.55,17,23,73.9,8,29,37,24,14,7,17,22
1651,DET,0,240,37,82,45.1,11,27,40.7,26,55,47.27,22,29,75.9,13,27,40,29,7,5,22,21
1652,CHA,0,240,37,90,41.1,13,38,34.2,24,52,46.15,19,21,90.5,11,28,39,28,3,3,11,14
1653,ATL,0,265,45,94,47.9,13,33,39.4,32,61,52.46,25,28,89.3,12,25,37,29,3,7,11,18
1654,BKN,1,265,52,98,53.1,11,32,34.4,41,66,62.12,17,20,85,11,25,36,29,7,10,11,25
1655,DEN,1,240,42,92,45.7,14,43,32.6,28,49,57.14,11,11,100,12,37,49,29,14,4,14,12
1656,WAS,0,240,37,92,40.2,13,38,34.2,24,54,44.44,19,21,90.5,11,28,39,29,11,2,11,20
1657,MIA,0,240,30,80,37.5,13,45,28.9,17,35,48.57,9,11,81.8,6,32,38,24,6,3,17,13
1658,GSW,1,240,45,85,52.9,15,34,44.1,30,51,58.82,18,23,78.3,11,35,46,32,11,5,21,28
1659,SAC,1,240,45,92,48.9,14,33,42.4,31,59,52.54,17,26,65.4,17,33,50,30,8,3,15,18
1660,PHX,0,240,36,95,37.9,15,43,34.9,21,52,40.38,10,12,83.3,9,40,49,19,7,3,15,16
1661,LAL,0,240,41,86,47.7,8,24,33.3,33,62,53.23,16,25,64,6,31,37,20,5,2,12,20
1662,TOR,0,240,38,94,40.4,22,55,40,16,39,41.03,10,12,83.3,10,36,46,26,8,8,12,20
1663,ATL,1,240,37,80,46.3,10,26,38.5,27,54,50,24,25,96,9,37,46,20,7,9,14,17
1664,UTA,1,240,37,92,40.2,15,48,31.3,22,44,50,19,22,86.4,17,36,53,24,6,5,6,14
1665,NYK,0,240,36,83,43.4,10,27,37,26,56,46.43,12,17,70.6,9,35,44,15,6,4,12,21
1666,HOU,1,240,37,88,42,12,37,32.4,25,51,49.02,21,29,72.4,8,36,44,16,13,4,14,17
1667,LAC,0,240,36,89,40.4,8,26,30.8,28,63,44.44,19,22,86.4,13,33,46,23,11,4,12,19
1668,WAS,0,240,33,85,38.8,5,26,19.2,28,59,47.46,17,23,73.9,12,38,50,19,7,3,21,22
1669,CLE,0,240,40,86,46.5,9,21,42.9,31,65,47.69,19,22,86.4,15,29,44,19,8,3,17,25
1670,PHI,0,240,40,94,42.6,9,28,32.1,31,66,46.97,15,20,75,13,23,36,15,12,3,9,26
1671,IND,1,240,40,78,51.3,12,29,41.4,28,49,57.14,37,45,82.2,7,38,45,26,5,8,15,25
1672,ORL,1,240,42,88,47.7,19,37,51.4,23,51,45.1,14,22,63.6,10,39,49,31,10,3,16,21
1673,GSW,1,240,44,89,49.4,14,30,46.7,30,59,50.85,28,37,75.7,15,31,46,21,13,10,15,19
1674,MIN,0,240,39,94,41.5,8,24,33.3,31,70,44.29,22,25,88,16,31,47,26,8,5,18,28
1675,POR,0,240,46,98,46.9,14,41,34.1,32,57,56.14,16,21,76.2,15,35,50,17,6,3,9,23
1676,BKN,1,240,34,85,40,11,38,28.9,23,47,48.94,19,22,86.4,6,43,49,24,6,5,9,18
1677,OKC,1,240,43,84,51.2,18,40,45,25,44,56.82,21,35,60,9,34,43,25,5,6,8,19
1678,DAL,0,240,41,84,48.8,11,32,34.4,30,52,57.69,20,24,83.3,8,26,34,26,11,4,11,22
1679,DET,1,240,35,70,50,17,38,44.7,18,32,56.25,32,38,84.2,11,36,47,22,6,6,19,20
1680,TOR,0,240,38,93,40.9,14,38,36.8,24,55,43.64,24,27,88.9,13,26,39,24,9,6,12,25
1681,LAL,1,240,42,87,48.3,10,32,31.3,32,55,58.18,21,28,75,15,25,40,21,7,7,14,23
1682,CHA,0,240,39,89,43.8,11,38,28.9,28,51,54.9,19,27,70.4,11,30,41,22,5,6,14,20
1683,CHI,0,240,41,88,46.6,17,39,43.6,24,49,48.98,4,10,40,9,32,41,28,4,7,19,16
1684,MIA,0,240,31,84,36.9,11,43,25.6,20,41,48.78,12,17,70.6,8,37,45,20,3,7,14,21
1685,DEN,1,240,40,79,50.6,15,35,42.9,25,44,56.82,22,28,78.6,14,35,49,25,9,4,18,20
1686,BOS,1,240,44,87,50.6,15,29,51.7,29,58,50,16,20,80,6,38,44,28,9,6,13,18
1687,IND,0,240,35,87,40.2,13,39,33.3,22,48,45.83,19,22,86.4,12,35,47,23,10,8,19,23
1688,NYK,0,240,39,86,45.3,12,29,41.4,27,57,47.37,23,25,92,13,34,47,20,9,0,12,20
1689,ORL,0,240,39,87,44.8,17,38,44.7,22,49,44.9,9,13,69.2,11,32,43,27,4,4,16,18
1690,CHA,1,240,42,88,47.7,14,36,38.9,28,52,53.85,9,16,56.3,9,34,43,28,10,5,12,17
1691,MIL,1,240,50,91,54.9,10,31,32.3,40,60,66.67,19,27,70.4,16,36,52,32,4,2,17,16
1692,BOS,1,240,52,93,55.9,14,28,50,38,65,58.46,23,27,85.2,13,42,55,26,14,8,16,23
1693,LAC,1,240,41,92,44.6,14,46,30.4,27,46,58.7,12,16,75,8,38,46,26,4,2,10,10
1694,POR,1,240,39,83,47,17,46,37,22,37,59.46,21,23,91.3,9,30,39,19,5,8,11,16
1695,ATL,0,240,42,83,50.6,14,39,35.9,28,44,63.64,17,22,77.3,5,22,27,27,8,4,9,23
1696,CLE,0,240,34,85,40,10,33,30.3,24,52,46.15,25,34,73.5,11,23,34,24,10,8,17,23
1697,WAS,0,240,39,92,42.4,14,42,33.3,25,50,50,9,14,64.3,12,38,50,23,5,5,14,14
1698,TOR,1,240,37,90,41.1,15,35,42.9,22,55,40,18,26,69.2,12,33,45,24,12,8,17,18
1699,OKC,0,240,42,95,44.2,7,35,20,35,60,58.33,9,14,64.3,12,39,51,22,7,2,13,19
1700,SAS,1,240,48,96,50,15,31,48.4,33,65,50.77,10,11,90.9,5,39,44,27,11,5,9,14
1701,DEN,1,290,40,97,41.2,15,36,41.7,25,61,40.98,25,32,78.1,12,53,65,22,4,3,18,20
1702,GSW,0,240,42,93,45.2,14,39,35.9,28,54,51.85,10,15,66.7,4,31,35,30,6,8,11,21
1703,DAL,0,240,37,83,44.6,5,25,20,32,58,55.17,29,40,72.5,10,26,36,15,7,4,10,23
1704,DET,0,240,37,86,43,14,33,42.4,23,53,43.4,22,30,73.3,8,35,43,25,9,8,16,28
1705,PHI,1,240,38,83,45.8,8,23,34.8,30,60,50,30,38,78.9,12,37,49,14,10,7,15,24
1706,HOU,1,240,47,86,54.7,16,37,43.2,31,49,63.27,23,29,79.3,13,39,52,28,5,5,14,28
1707,MIA,0,240,42,89,47.2,13,46,28.3,29,43,67.44,27,32,84.4,2,29,31,29,7,1,8,23
1708,CHI,0,240,33,84,39.3,8,25,32,25,59,42.37,16,22,72.7,10,35,45,18,8,1,19,28
1709,MIN,1,240,39,91,42.9,12,34,35.3,27,57,47.37,30,37,81.1,14,36,50,23,14,4,13,22
1710,NOP,0,240,40,87,46,10,33,30.3,30,54,55.56,20,28,71.4,10,32,42,21,5,4,21,24
1711,LAL,1,240,36,79,45.6,4,19,21.1,32,60,53.33,25,31,80.6,5,37,42,20,7,4,19,18
1712,UTA,1,240,45,94,47.9,20,50,40,25,44,56.82,17,22,77.3,14,43,57,28,6,4,16,20
1713,PHX,0,290,41,102,40.2,16,53,30.2,25,49,51.02,14,18,77.8,7,43,50,26,8,4,10,31
1714,BKN,1,240,44,83,53,19,37,51.4,25,46,54.35,21,26,80.8,9,38,47,34,0,6,17,26
1715,TOR,1,240,39,84,46.4,17,40,42.5,22,44,50,6,9,66.7,12,33,45,22,11,3,22,16
1716,PHX,0,265,47,94,50,17,44,38.6,30,50,60,15,15,100,9,36,45,30,7,4,16,23
1717,OKC,0,240,41,87,47.1,14,42,33.3,27,45,60,10,13,76.9,4,25,29,24,8,1,11,21
1718,CHA,0,240,42,85,49.4,7,32,21.9,35,53,66.04,19,25,76,12,34,46,22,8,1,21,12
1719,DAL,1,240,45,93,48.4,14,39,35.9,31,54,57.41,18,20,90,7,35,42,23,3,2,6,21
1720,CLE,1,240,45,87,51.7,8,25,32,37,62,59.68,27,32,84.4,13,37,50,24,7,3,15,18
1721,DET,0,240,31,82,37.8,15,32,46.9,16,50,32,25,37,67.6,14,41,55,17,5,8,19,21
1722,PHI,1,240,45,81,55.6,12,28,42.9,33,53,62.26,20,24,83.3,10,35,45,23,9,7,20,23
1723,MIN,0,240,40,93,43,8,32,25,32,61,52.46,10,12,83.3,10,30,40,30,14,8,13,21
1724,HOU,1,240,37,95,38.9,14,41,34.1,23,54,42.59,15,20,75,14,37,51,24,7,11,14,28
1725,DEN,1,265,53,103,51.5,6,26,23.1,47,77,61.04,18,19,94.7,10,33,43,32,12,1,9,15
1726,MIA,0,240,33,77,42.9,7,31,22.6,26,46,56.52,8,10,80,4,28,32,19,13,4,19,14
1727,LAC,1,240,43,84,51.2,10,33,30.3,33,51,64.71,24,25,96,9,39,48,21,8,7,13,19
1728,ATL,1,240,38,83,45.8,15,35,42.9,23,48,47.92,25,30,83.3,13,42,55,21,9,12,17,16
1729,SAC,1,240,38,91,41.8,12,34,35.3,26,57,45.61,15,21,71.4,12,43,55,21,6,14,6,25
1730,SAS,0,240,41,89,46.1,12,28,42.9,29,61,47.54,23,30,76.7,9,40,49,21,3,5,7,18
1731,NYK,0,240,36,94,38.3,5,22,22.7,31,72,43.06,17,25,68,16,41,57,19,2,6,12,21
1732,BOS,0,240,41,90,45.6,12,30,40,29,60,48.33,16,20,80,10,22,32,23,10,5,13,21
1733,BKN,0,240,42,87,48.3,14,43,32.6,28,44,63.64,15,17,88.2,6,23,29,23,5,8,11,25
1734,CHI,1,240,49,96,51,15,43,34.9,34,53,64.15,10,12,83.3,15,28,43,33,11,4,16,21
1735,IND,1,265,46,93,49.5,12,34,35.3,34,59,57.63,16,18,88.9,8,36,44,28,9,5,10,19
1736,ORL,0,265,43,94,45.7,17,37,45.9,26,57,45.61,15,24,62.5,13,36,49,29,7,3,14,14
1737,NOP,0,240,42,85,49.4,11,25,44,31,60,51.67,23,30,76.7,10,31,41,27,9,2,18,19
1738,MIL,0,240,44,87,50.6,9,28,32.1,35,59,59.32,9,12,75,5,41,46,27,5,5,15,18
1739,LAL,1,240,41,88,46.6,19,37,51.4,22,51,43.14,12,15,80,6,32,38,25,8,8,10,14
1740,NYK,1,240,38,82,46.3,11,24,45.8,27,58,46.55,32,41,78,11,44,55,24,5,9,11,29
1741,UTA,1,240,44,88,50,17,39,43.6,27,49,55.1,24,25,96,8,31,39,27,8,8,15,27
1742,GSW,0,240,33,86,38.4,9,38,23.7,24,48,50,29,39,74.4,9,37,46,27,5,3,10,26
1743,PHX,1,240,42,89,47.2,8,34,23.5,34,55,61.82,17,19,89.5,8,37,45,25,6,11,17,21
1744,HOU,0,240,37,88,42,10,31,32.3,27,57,47.37,19,22,86.4,7,32,39,17,11,5,16,19
1745,DAL,1,240,51,97,52.6,8,27,29.6,43,70,61.43,14,17,82.4,9,40,49,32,5,6,8,17
1746,TOR,0,240,35,88,39.8,16,49,32.7,19,39,48.72,16,18,88.9,12,29,41,27,8,3,13,21
1747,MIA,1,240,39,80,48.8,18,40,45,21,40,52.5,15,17,88.2,8,38,46,29,4,5,19,19
1748,DET,0,265,44,97,45.4,10,31,32.3,34,66,51.52,17,19,89.5,7,35,42,22,9,3,13,28
1749,ORL,1,240,36,92,39.1,10,31,32.3,26,61,42.62,15,21,71.4,13,35,48,26,5,8,12,17
1750,BKN,0,290,48,106,45.3,15,41,36.6,33,65,50.77,24,27,88.9,13,39,52,30,8,11,16,24
1751,CLE,1,290,56,109,51.4,20,40,50,36,69,52.17,15,21,71.4,12,38,50,29,10,6,15,21
1752,BOS,0,240,42,89,47.2,12,33,36.4,30,56,53.57,13,20,65,10,35,45,22,3,0,16,29
1753,ATL,1,265,44,100,44,9,23,39.1,35,77,45.45,26,38,68.4,23,40,63,21,6,10,14,15
1754,LAC,1,240,41,86,47.7,16,35,45.7,25,51,49.02,17,18,94.4,6,42,48,24,14,6,17,15
1755,PHI,1,240,36,78,46.2,9,27,33.3,27,51,52.94,36,45,80,11,30,41,20,12,3,9,20
1756,GSW,1,240,46,91,50.5,15,38,39.5,31,53,58.49,14,20,70,10,44,54,31,6,2,15,22
1757,MIN,0,240,36,85,42.4,15,35,42.9,21,50,42,9,14,64.3,8,35,43,25,5,12,16,20
1758,SAS,0,240,35,94,37.2,4,33,12.1,31,61,50.82,25,31,80.6,12,31,43,17,7,2,10,15
1759,IND,0,240,41,92,44.6,16,39,41,25,53,47.17,14,21,66.7,8,30,38,21,6,3,10,20
1760,SAC,0,240,39,86,45.3,13,28,46.4,26,58,44.83,5,12,41.7,4,35,39,25,11,4,18,15
1761,UTA,1,240,43,85,50.6,21,47,44.7,22,38,57.89,11,17,64.7,11,43,54,28,4,7,16,17
1762,DEN,1,240,46,105,43.8,14,42,33.3,32,63,50.79,13,14,92.9,18,40,58,29,11,3,15,22
1763,OKC,0,240,36,86,41.9,14,43,32.6,22,43,51.16,15,23,65.2,9,32,41,22,8,4,19,15
1764,NOP,0,240,43,95,45.3,6,26,23.1,37,69,53.62,10,15,66.7,10,28,38,17,8,3,8,15
1765,DET,0,240,38,82,46.3,13,37,35.1,25,45,55.56,18,24,75,10,22,32,24,8,3,18,23
1766,ATL,1,240,37,79,46.8,11,28,39.3,26,51,50.98,23,25,92,7,41,48,32,15,8,26,17
1767,MIA,1,240,43,75,57.3,12,30,40,31,45,68.89,15,19,78.9,5,31,36,23,8,6,18,27
1768,GSW,1,240,44,87,50.6,12,37,32.4,32,50,64,15,20,75,5,27,32,31,8,3,13,27
1769,LAL,0,240,40,83,48.2,9,29,31,31,54,57.41,24,33,72.7,12,38,50,23,6,5,19,22
1770,MEM,1,240,41,83,49.4,11,26,42.3,30,57,52.63,15,20,75,9,31,40,31,13,3,15,15
1771,NYK,1,240,31,87,35.6,5,27,18.5,26,60,43.33,24,34,70.6,13,40,53,15,6,4,8,16
1772,BKN,1,240,46,84,54.8,15,31,48.4,31,53,58.49,18,21,85.7,7,42,49,26,2,5,17,19
1773,TOR,1,240,44,88,50,12,33,36.4,32,55,58.18,16,18,88.9,9,37,46,23,9,6,15,23
1774,MIL,0,240,46,105,43.8,11,38,28.9,35,67,52.24,20,24,83.3,11,30,41,21,9,2,6,15
1775,DAL,0,240,31,82,37.8,9,36,25,22,46,47.83,22,27,81.5,8,30,38,21,6,4,17,16
1776,ORL,0,240,29,86,33.7,12,38,31.6,17,48,35.42,14,16,87.5,10,41,51,18,4,9,12,24
1777,SAS,1,240,48,90,53.3,15,33,45.5,33,57,57.89,14,16,87.5,12,36,48,33,6,6,13,17
1778,POR,0,240,39,90,43.3,10,35,28.6,29,55,52.73,16,19,84.2,8,26,34,20,9,6,13,15
1779,PHX,0,240,40,88,45.5,15,36,41.7,25,52,48.08,9,16,56.3,12,32,44,30,8,4,18,20
1780,CHI,1,240,43,92,46.7,20,45,44.4,23,47,48.94,19,21,90.5,10,37,47,23,10,3,19,19
1781,MIN,0,240,36,91,39.6,14,37,37.8,22,54,40.74,11,16,68.8,9,30,39,22,16,6,18,21
1782,HOU,0,240,46,88,52.3,17,40,42.5,29,48,60.42,11,17,64.7,2,34,36,25,8,1,17,20
1783,IND,0,240,37,89,41.6,11,38,28.9,26,51,50.98,11,16,68.8,6,27,33,28,13,2,16,19
1784,UTA,1,240,39,76,51.3,15,37,40.5,24,39,61.54,16,28,57.1,7,29,36,24,7,6,13,21
1785,LAC,1,240,48,87,55.2,19,39,48.7,29,48,60.42,14,20,70,9,43,52,27,4,3,18,19
1786,CHI,1,240,43,85,50.6,7,25,28,36,60,60,24,33,72.7,5,42,47,32,14,6,14,23
1787,NYK,1,240,38,80,47.5,12,31,38.7,26,49,53.06,17,21,81,10,43,53,22,11,7,17,28
1788,BOS,0,240,25,84,29.8,7,46,15.2,18,38,47.37,18,29,62.1,14,29,43,15,10,2,18,22
1789,DEN,0,240,40,100,40,14,37,37.8,26,63,41.27,11,15,73.3,23,29,52,25,6,6,10,23
1790,SAC,0,240,47,91,51.6,13,39,33.3,34,52,65.38,16,18,88.9,8,25,33,23,7,7,11,24
1791,DAL,0,240,41,93,44.1,8,31,25.8,33,62,53.23,11,19,57.9,12,35,47,18,6,2,17,23
1792,NOP,1,240,45,85,52.9,11,22,50,34,63,53.97,27,34,79.4,14,34,48,24,5,1,14,15
1793,TOR,1,240,36,86,41.9,21,49,42.9,15,37,40.54,23,26,88.5,7,36,43,28,5,8,15,22
1794,CHA,0,240,38,87,43.7,15,36,41.7,23,51,45.1,22,29,75.9,12,36,48,26,6,5,15,20
1795,ORL,0,240,44,95,46.3,14,46,30.4,30,49,61.22,13,16,81.3,9,29,38,28,13,4,12,19
1796,SAS,1,240,40,100,40,5,24,20.8,35,76,46.05,18,23,78.3,17,41,58,19,10,7,12,21
1797,MEM,1,240,43,99,43.4,8,29,27.6,35,70,50,12,18,66.7,11,32,43,27,15,3,11,25
1798,BKN,1,240,42,78,53.8,16,35,45.7,26,43,60.47,22,25,88,4,37,41,24,9,5,19,14
1799,MIA,0,240,32,67,47.8,12,29,41.4,20,38,52.63,24,27,88.9,5,26,31,25,1,5,23,21
1800,ATL,0,240,38,87,43.7,6,30,20,32,57,56.14,24,28,85.7,7,41,48,24,4,6,13,22
1801,HOU,0,240,31,84,36.9,12,32,37.5,19,52,36.54,17,27,63,12,39,51,20,6,9,23,20
1802,PHI,0,240,37,84,44,7,25,28,30,59,50.85,23,32,71.9,15,38,53,23,5,11,23,17
1803,POR,1,240,40,103,38.8,15,44,34.1,25,59,42.37,17,20,85,17,38,55,18,6,8,8,20
1804,DET,1,240,46,91,50.5,18,46,39.1,28,45,62.22,10,15,66.7,10,29,39,34,9,8,13,28
1805,LAC,1,240,52,89,58.4,18,35,51.4,34,54,62.96,16,20,80,12,35,47,29,10,3,11,19
1806,OKC,1,265,48,105,45.7,15,45,33.3,33,60,55,16,24,66.7,7,37,44,26,12,2,13,23
1807,ORL,0,240,38,94,40.4,7,28,25,31,66,46.97,14,22,63.6,15,31,46,14,5,1,13,16
1808,LAL,1,240,39,93,41.9,15,37,40.5,24,56,42.86,19,26,73.1,13,31,44,31,11,6,8,16
1809,MIL,1,240,43,96,44.8,14,37,37.8,29,59,49.15,12,25,48,16,41,57,22,5,3,11,14
1810,NOP,0,240,41,86,47.7,9,29,31,32,57,56.14,4,8,50,10,37,47,22,3,5,20,21
1811,NYK,0,240,40,82,48.8,9,25,36,31,57,54.39,14,16,87.5,7,32,39,20,9,10,13,21
1812,CLE,1,240,36,79,45.6,9,27,33.3,27,52,51.92,25,34,73.5,14,34,48,26,9,6,16,18
1813,CHI,0,265,43,91,47.3,21,46,45.7,22,45,48.89,18,25,72,9,47,56,27,5,8,24,25
1814,BOS,1,240,45,88,51.1,17,42,40.5,28,46,60.87,17,19,89.5,6,39,45,25,7,4,11,18
1815,DAL,0,240,45,97,46.4,13,36,36.1,32,61,52.46,6,13,46.2,11,40,51,22,5,6,9,23
1816,SAC,0,240,40,85,47.1,8,26,30.8,32,59,54.24,12,17,70.6,9,23,32,23,4,2,14,16
1817,ATL,0,240,38,92,41.3,5,28,17.9,33,64,51.56,11,15,73.3,8,33,41,21,6,1,15,16
1818,UTA,1,240,43,92,46.7,20,44,45.5,23,48,47.92,10,14,71.4,12,41,53,27,7,6,19,18
1819,MIA,0,240,40,81,49.4,12,34,35.3,28,47,59.57,16,26,61.5,9,32,41,28,4,1,20,19
1820,SAS,0,240,42,92,45.7,9,31,29,33,61,54.1,12,16,75,10,31,41,26,10,4,10,17
1821,CHA,0,240,42,87,48.3,15,35,42.9,27,52,51.92,9,12,75,14,30,44,32,11,5,20,15
1822,GSW,0,240,38,81,46.9,11,29,37.9,27,52,51.92,17,24,70.8,5,38,43,29,9,4,19,25
1823,HOU,1,240,42,86,48.8,13,33,39.4,29,53,54.72,12,19,63.2,10,39,49,25,6,6,18,16
1824,IND,1,240,44,92,47.8,9,30,30,35,62,56.45,14,18,77.8,13,37,50,29,11,5,14,13
1825,PHI,1,240,44,82,53.7,17,37,45.9,27,45,60,20,24,83.3,5,30,35,27,15,3,18,22
1826,TOR,1,240,40,88,45.5,20,50,40,20,38,52.63,11,13,84.6,13,27,40,33,13,6,18,16
1827,POR,0,240,32,87,36.8,13,43,30.2,19,44,43.18,10,10,100,14,29,43,16,8,5,18,22
1828,DEN,1,240,41,90,45.6,11,37,29.7,30,53,56.6,21,27,77.8,10,40,50,29,11,5,14,23
1829,LAC,1,240,35,74,47.3,18,37,48.6,17,37,45.95,23,27,85.2,3,33,36,26,4,6,10,16
1830,DET,0,240,36,92,39.1,14,35,40,22,57,38.6,15,22,68.2,13,34,47,25,8,3,16,19
1831,NYK,0,240,44,92,47.8,11,28,39.3,33,64,51.56,10,12,83.3,12,31,43,22,4,3,9,16
1832,CHA,0,240,38,100,38,10,38,26.3,28,62,45.16,7,14,50,15,38,53,26,8,7,14,17
1833,LAL,1,240,47,95,49.5,17,37,45.9,30,58,51.72,17,22,77.3,12,38,50,26,6,6,10,16
1834,POR,1,240,44,90,48.9,23,48,47.9,21,42,50,21,27,77.8,12,26,38,28,9,8,8,24
1835,MIN,0,240,39,90,43.3,9,37,24.3,30,53,56.6,20,24,83.3,11,37,48,27,3,6,13,18
1836,MEM,1,240,50,106,47.2,8,25,32,42,81,51.85,10,13,76.9,15,32,47,33,11,5,7,24
1837,OKC,0,240,37,86,43,10,31,32.3,27,55,49.09,15,19,78.9,9,33,42,23,4,6,12,21
1838,SAC,0,240,44,84,52.4,19,38,50,25,46,54.35,19,26,73.1,8,34,42,35,4,2,13,18
1839,DAL,1,240,40,96,41.7,15,46,32.6,25,50,50,9,16,56.3,13,41,54,22,8,12,10,15
1840,NOP,0,240,42,88,47.7,10,28,35.7,32,60,53.33,12,16,75,12,36,48,18,4,4,11,19
1841,BKN,1,240,44,91,48.4,16,40,40,28,51,54.9,12,17,70.6,12,34,46,29,3,5,6,12
1842,MIL,1,240,41,85,48.2,19,43,44.2,22,42,52.38,9,14,64.3,10,38,48,31,10,9,14,20
1843,GSW,0,240,34,89,38.2,13,38,34.2,21,51,41.18,14,22,63.6,10,36,46,25,8,8,16,21
1844,LAL,1,240,42,84,50,14,32,43.8,28,52,53.85,19,27,70.4,11,44,55,26,10,12,21,18
1845,OKC,0,240,36,83,43.4,7,26,26.9,29,57,50.88,23,29,79.3,7,45,52,18,1,5,13,20
1846,PHI,1,265,50,102,49,19,55,34.5,31,47,65.96,18,25,72,16,36,52,32,10,6,19,21
1847,CLE,0,240,35,90,38.9,8,31,25.8,27,59,45.76,9,14,64.3,12,28,40,23,7,4,14,13
1848,HOU,0,240,38,97,39.2,12,40,30,26,57,45.61,12,16,75,10,32,42,23,14,5,15,19
1849,MIA,0,265,48,104,46.2,19,56,33.9,29,48,60.42,19,24,79.2,14,32,46,27,6,4,18,21
1850,IND,1,240,39,88,44.3,9,28,32.1,30,60,50,17,25,68,10,40,50,26,9,9,15,17
1851,SAS,1,240,41,95,43.2,10,35,28.6,31,60,51.67,20,22,90.9,7,39,46,26,8,5,4,20
1852,UTA,1,240,42,84,50,24,45,53.3,18,39,46.15,9,12,75,10,38,48,26,8,8,18,16
1853,DEN,0,240,44,88,50,18,37,48.6,26,51,50.98,10,16,62.5,9,23,32,28,12,5,13,18
1854,BKN,1,240,48,79,60.8,16,32,50,32,47,68.09,10,15,66.7,8,33,41,31,6,6,19,18
1855,ATL,1,240,37,99,37.4,17,44,38.6,20,55,36.36,21,27,77.8,14,44,58,20,7,3,8,13
1856,POR,1,240,38,83,45.8,14,42,33.3,24,41,58.54,22,25,88,8,34,42,18,9,6,13,14
1857,WAS,1,240,48,92,52.2,15,34,44.1,33,58,56.9,17,28,60.7,14,39,53,29,3,3,8,23
1858,ORL,0,240,39,91,42.9,11,31,35.5,28,60,46.67,10,13,76.9,15,29,44,24,5,4,19,13
1859,CHA,1,240,38,78,48.7,13,32,40.6,25,46,54.35,20,23,87,5,32,37,28,8,8,10,13
1860,SAC,1,240,47,84,56,15,32,46.9,32,52,61.54,18,23,78.3,7,37,44,29,6,9,19,17
1861,PHX,0,240,39,87,44.8,4,27,14.8,35,60,58.33,25,30,83.3,8,34,42,21,3,6,6,22
1862,PHI,0,240,37,92,40.2,8,36,22.2,29,56,51.79,12,13,92.3,9,41,50,20,2,12,9,17
1863,MEM,1,240,40,78,51.3,5,20,25,35,58,60.34,16,21,76.2,7,33,40,32,10,6,15,17
1864,CLE,0,240,37,82,45.1,11,26,42.3,26,56,46.43,6,14,42.9,10,30,40,20,11,7,21,21
1865,MIL,1,240,46,91,50.5,13,35,37.1,33,56,58.93,16,20,80,11,32,43,25,15,7,15,17
1866,NYK,0,240,34,87,39.1,9,37,24.3,25,50,50,11,17,64.7,17,32,49,20,6,6,17,23
1867,TOR,0,240,40,89,44.9,19,47,40.4,21,42,50,12,12,100,7,36,43,27,6,5,15,22
1868,IND,0,240,47,97,48.5,13,39,33.3,34,58,58.62,15,18,83.3,10,27,37,26,14,3,13,21
1869,SAS,0,240,36,94,38.3,8,30,26.7,28,64,43.75,8,14,57.1,9,36,45,21,4,5,10,16
1870,BKN,0,240,43,85,50.6,10,34,29.4,33,51,64.71,20,24,83.3,6,37,43,23,3,2,17,18
1871,LAC,1,240,45,92,48.9,20,38,52.6,25,54,46.3,20,25,80,12,23,35,28,13,5,10,19
1872,NYK,0,240,32,74,43.2,6,21,28.6,26,53,49.06,19,25,76,8,28,36,19,4,1,16,15
1873,LAL,1,240,46,91,50.5,10,29,34.5,36,62,58.06,18,24,75,10,39,49,28,13,8,17,23
1874,DEN,1,240,45,84,53.6,15,35,42.9,30,49,61.22,9,12,75,8,35,43,23,11,4,12,25
1875,CHI,0,240,47,77,61,18,33,54.5,29,44,65.91,15,17,88.2,3,35,38,30,6,2,23,19
1876,MIN,1,240,34,81,42,9,26,34.6,25,55,45.45,19,23,82.6,9,43,52,19,6,3,14,17
1877,UTA,1,240,35,82,42.7,11,35,31.4,24,47,51.06,15,22,68.2,16,47,63,17,3,5,16,17
1878,HOU,0,240,37,90,41.1,12,41,29.3,25,49,51.02,16,23,69.6,13,30,43,22,7,8,21,22
1879,OKC,1,240,49,90,54.4,15,39,38.5,34,51,66.67,16,17,94.1,3,31,34,24,12,4,11,22
1880,GSW,1,240,38,93,40.9,13,46,28.3,25,47,53.19,17,19,89.5,12,39,51,30,2,10,15,18
1881,TOR,0,240,39,96,40.6,13,38,34.2,26,58,44.83,14,22,63.6,13,35,48,20,8,10,12,22
1882,DET,0,240,29,87,33.3,10,42,23.8,19,45,42.22,18,21,85.7,11,28,39,21,10,7,8,23
1883,DAL,1,240,39,79,49.4,20,40,50,19,39,48.72,14,18,77.8,6,38,44,25,5,8,18,17
1884,IND,0,240,44,92,47.8,12,29,41.4,32,63,50.79,17,24,70.8,13,39,52,23,2,4,10,19
1885,MIL,1,240,37,84,44,12,36,33.3,25,48,52.08,14,18,77.8,11,34,45,25,11,4,16,14
1886,CLE,0,240,36,87,41.4,7,26,26.9,29,61,47.54,11,16,68.8,14,33,47,16,6,4,18,18
1887,PHI,0,240,43,103,41.7,11,35,31.4,32,68,47.06,6,10,60,20,28,48,23,8,4,17,19
1888,DEN,1,240,45,90,50,12,33,36.4,33,57,57.89,13,15,86.7,15,30,45,28,11,7,17,12
1889,POR,1,240,44,100,44,17,41,41.5,27,59,45.76,20,23,87,9,41,50,26,10,5,8,27
1890,WAS,0,240,44,99,44.4,15,40,37.5,29,59,49.15,21,28,75,7,32,39,25,9,2,6,24
1891,PHX,1,240,46,94,48.9,16,41,39,30,53,56.6,17,17,100,4,36,40,33,6,2,3,17
1892,SAS,1,265,44,101,43.6,13,32,40.6,31,69,44.93,24,29,82.8,12,36,48,22,8,3,6,19
1893,ORL,0,240,38,89,42.7,6,31,19.4,32,58,55.17,16,22,72.7,10,33,43,17,11,2,10,16
1894,SAC,0,240,33,81,40.7,8,30,26.7,25,51,49.02,25,35,71.4,6,41,47,21,4,5,15,20
1895,MIA,1,240,46,93,49.5,16,43,37.2,30,50,60,20,26,76.9,10,51,61,32,3,5,16,24
1896,ATL,0,240,34,89,38.2,14,45,31.1,20,44,45.45,23,28,82.1,17,30,47,25,10,4,14,22
1897,MIN,0,265,48,96,50,15,30,50,33,66,50,11,17,64.7,11,42,53,29,1,7,17,20
1898,CHA,1,240,40,77,51.9,15,33,45.5,25,44,56.82,18,24,75,6,35,41,27,11,7,15,19
1899,OKC,1,240,38,87,43.7,11,34,32.4,27,53,50.94,14,21,66.7,11,51,62,16,2,7,11,19
1900,SAC,0,240,46,81,56.8,15,34,44.1,31,47,65.96,16,28,57.1,3,23,26,36,9,8,12,18
1901,ORL,0,240,34,89,38.2,8,29,27.6,26,60,43.33,14,16,87.5,9,33,42,17,5,2,13,13
1902,NOP,0,240,38,77,49.4,15,38,39.5,23,39,58.97,19,26,73.1,10,26,36,29,6,4,19,17
1903,TOR,1,240,53,91,58.2,20,39,51.3,33,52,63.46,18,22,81.8,12,32,44,30,8,5,13,20
1904,WAS,0,240,41,88,46.6,11,29,37.9,30,59,50.85,14,16,87.5,7,31,38,22,9,4,17,24
1905,HOU,1,240,51,91,56,22,47,46.8,29,44,65.91,8,11,72.7,7,42,49,34,6,8,8,18
1906,MIL,0,240,44,98,44.9,13,42,31,31,56,55.36,17,21,81,9,36,45,18,5,5,12,19
1907,LAL,1,240,41,81,50.6,12,29,41.4,29,52,55.77,23,27,85.2,10,32,42,21,3,8,15,15
1908,LAC,0,240,40,83,48.2,14,31,45.2,26,52,50,11,13,84.6,10,27,37,23,6,5,19,16
1909,NYK,0,240,34,96,35.4,9,27,33.3,25,69,36.23,12,20,60,11,38,49,19,8,7,5,19
1910,CHI,0,240,46,91,50.5,10,26,38.5,36,65,55.38,13,14,92.9,9,32,41,26,10,3,13,23
1911,GSW,1,240,40,82,48.8,20,41,48.8,20,41,48.78,15,18,83.3,9,29,38,25,13,3,16,19
1912,MEM,1,240,45,98,45.9,13,32,40.6,32,66,48.48,12,14,85.7,12,34,46,29,14,6,14,18
1913,BKN,0,240,38,81,46.9,14,31,45.2,24,50,48,20,21,95.2,4,38,42,26,6,4,21,13
1914,CHA,1,240,41,87,47.1,16,42,38.1,25,45,55.56,20,25,80,16,29,45,33,10,4,15,20
1915,PHX,0,265,41,91,45.1,17,52,32.7,24,39,61.54,6,13,46.2,9,41,50,24,10,7,21,25
1916,DET,1,265,37,90,41.1,11,34,32.4,26,56,46.43,25,29,86.2,9,37,46,23,13,4,17,14
1917,BOS,1,240,41,86,47.7,12,32,37.5,29,54,53.7,22,30,73.3,11,38,49,21,11,4,21,22
1918,UTA,1,240,49,97,50.5,25,53,47.2,24,44,54.55,8,13,61.5,10,40,50,31,6,8,10,18
1919,PHI,0,240,41,87,47.1,9,26,34.6,32,61,52.46,18,20,90,4,43,47,23,6,6,20,25
1920,LAL,0,240,43,86,50,10,30,33.3,33,56,58.93,13,21,61.9,9,39,48,21,2,4,13,20
1921,CLE,1,240,36,79,45.6,13,30,43.3,23,49,46.94,9,16,56.3,7,30,37,24,11,3,16,14
1922,MIN,0,240,39,93,41.9,14,41,34.1,25,52,48.08,25,33,75.8,15,33,48,24,11,4,16,19
1923,SAS,1,240,43,92,46.7,16,35,45.7,27,57,47.37,16,17,94.1,6,34,40,28,4,3,8,15
1924,POR,1,240,49,90,54.4,18,41,43.9,31,49,63.27,19,23,82.6,6,38,44,25,10,6,15,23
1925,BKN,1,240,44,97,45.4,15,37,40.5,29,60,48.33,19,29,65.5,11,37,48,30,11,7,13,17
1926,MEM,0,240,36,83,43.4,11,31,35.5,25,52,48.08,7,8,87.5,11,37,48,27,13,6,18,17
1927,DEN,0,265,43,97,44.3,15,44,34.1,28,53,52.83,16,21,76.2,9,38,47,25,8,1,14,27
1928,DAL,1,265,42,87,48.3,16,40,40,26,47,55.32,24,31,77.4,7,37,44,27,12,7,13,21
1929,PHX,1,240,40,83,48.2,21,40,52.5,19,43,44.19,22,24,91.7,8,33,41,30,4,3,12,23
1930,UTA,0,240,40,91,44,14,44,31.8,26,47,55.32,6,11,54.5,10,32,42,20,5,9,15,15
1931,TOR,0,240,39,79,49.4,14,35,40,25,44,56.82,23,32,71.9,10,32,42,18,6,5,12,19
1932,CHI,0,240,49,93,52.7,14,40,35,35,53,66.04,12,15,80,10,33,43,27,3,2,16,21
1933,SAC,1,240,47,91,51.6,14,37,37.8,33,54,61.11,20,27,74.1,12,27,39,30,8,3,7,16
1934,ORL,1,240,40,81,49.4,12,29,41.4,28,52,53.85,13,18,72.2,8,35,43,20,4,4,16,22
1935,LAC,1,240,36,81,44.4,11,34,32.4,25,47,53.19,25,25,100,12,36,48,19,6,3,20,26
1936,MIL,1,240,49,90,54.4,19,43,44.2,30,47,63.83,13,21,61.9,9,38,47,35,5,4,14,22
1937,NYK,1,240,45,87,51.7,8,22,36.4,37,65,56.92,14,19,73.7,11,37,48,22,10,5,13,17
1938,MIA,0,240,35,81,43.2,13,36,36.1,22,45,48.89,22,26,84.6,6,36,42,26,2,7,9,15
1939,BOS,1,240,42,99,42.4,12,35,34.3,30,64,46.88,11,12,91.7,16,37,53,22,7,5,7,23
1940,DET,0,240,38,97,39.2,13,41,31.7,25,56,44.64,26,30,86.7,15,32,47,20,6,3,9,20
1941,PHI,1,240,50,81,61.7,18,29,62.1,32,52,61.54,23,33,69.7,1,34,35,33,9,6,18,21
1942,CLE,0,240,36,85,42.4,4,26,15.4,32,59,54.24,18,26,69.2,13,32,45,24,9,4,10,19
1943,CHA,1,240,32,85,37.6,11,36,30.6,21,49,42.86,27,33,81.8,8,41,49,22,11,7,10,14
1944,NOP,0,240,44,89,49.4,4,22,18.2,40,67,59.7,18,23,78.3,9,43,52,25,11,0,15,18
1945,ATL,0,240,36,96,37.5,7,40,17.5,29,56,51.79,15,18,83.3,12,45,57,25,6,1,13,25
1946,OKC,1,240,40,87,46,19,46,41.3,21,41,51.22,12,16,75,4,34,38,28,10,5,14,18
1947,GSW,0,240,39,86,45.3,8,30,26.7,31,56,55.36,15,19,78.9,8,27,35,25,10,2,13,21
1948,IND,1,240,42,89,47.2,9,23,39.1,33,66,50,21,26,80.8,7,31,38,21,10,9,14,21
1949,WAS,0,240,47,94,50,16,37,43.2,31,57,54.39,26,35,74.3,9,26,35,27,9,2,13,27
1950,HOU,0,240,39,81,48.1,8,30,26.7,31,51,60.78,21,26,80.8,5,34,39,19,7,12,16,22
1951,DEN,1,240,41,79,51.9,8,25,32,33,54,61.11,33,45,73.3,10,32,42,22,9,2,16,27
1952,CHI,1,240,40,91,44,16,41,39,24,50,48,15,18,83.3,11,41,52,27,5,5,15,19
1953,BKN,1,240,52,93,55.9,14,36,38.9,38,57,66.67,12,16,75,8,43,51,31,11,5,13,22
1954,LAC,0,240,43,86,50,15,35,42.9,28,51,54.9,12,13,92.3,7,38,45,29,6,7,13,16
1955,POR,0,240,39,94,41.5,19,51,37.3,20,43,46.51,11,17,64.7,10,36,46,23,8,3,11,16
1956,SAS,1,240,44,96,45.8,20,40,50,24,56,42.86,8,11,72.7,11,33,44,23,9,3,11,13
1957,LAL,1,240,38,87,43.7,9,31,29,29,56,51.79,9,11,81.8,9,43,52,24,7,8,17,14
1958,MIN,0,240,42,91,46.2,11,34,32.4,31,57,54.39,21,27,77.8,10,32,42,24,8,4,14,31
1959,UTA,0,240,33,86,38.4,11,34,32.4,22,52,42.31,19,27,70.4,9,32,41,17,6,3,15,18
1960,MEM,0,240,36,87,41.4,10,26,38.5,26,61,42.62,10,13,76.9,5,33,38,24,14,4,13,14
1961,BOS,1,240,41,84,48.8,15,29,51.7,26,55,47.27,29,34,85.3,12,44,56,19,3,9,20,29
1962,OKC,0,240,29,79,36.7,13,48,27.1,16,31,51.61,19,27,70.4,6,32,38,20,6,4,18,15
1963,DAL,1,240,39,82,47.6,16,39,41,23,43,53.49,19,20,95,10,41,51,24,4,3,18,31
1964,CLE,0,240,33,85,38.8,10,28,35.7,23,57,40.35,7,12,58.3,9,26,35,20,12,4,16,14
1965,NYK,1,240,43,85,50.6,7,21,33.3,36,64,56.25,20,25,80,11,34,45,26,9,6,16,21
1966,TOR,0,240,36,90,40,13,37,35.1,23,53,43.4,29,38,76.3,8,29,37,20,13,4,10,26
1967,ATL,0,240,40,87,46,10,31,32.3,30,56,53.57,18,23,78.3,10,30,40,24,4,2,13,21
1968,HOU,0,240,30,77,39,11,40,27.5,19,37,51.35,29,36,80.6,7,28,35,17,5,4,12,19
1969,IND,1,265,45,93,48.4,19,45,42.2,26,48,54.17,9,13,69.2,5,37,42,32,10,8,14,27
1970,MIA,1,240,46,81,56.8,16,34,47.1,30,47,63.83,10,18,55.6,4,43,47,34,7,0,16,20
1971,GSW,1,240,51,97,52.6,23,43,53.5,28,54,51.85,12,14,85.7,3,45,48,41,4,6,11,28
1972,DET,0,240,43,98,43.9,17,40,42.5,26,58,44.83,12,12,100,6,25,31,27,9,5,9,17
1973,PHI,1,240,46,95,48.4,11,32,34.4,35,63,55.56,15,23,65.2,14,41,55,34,7,5,10,21
1974,MIL,1,240,49,85,57.6,14,34,41.2,35,51,68.63,13,16,81.3,7,42,49,32,6,4,19,18
1975,SAC,0,240,34,90,37.8,10,35,28.6,24,55,43.64,28,39,71.8,11,41,52,20,5,6,15,20
1976,CHA,0,240,36,86,41.9,13,39,33.3,23,47,48.94,16,22,72.7,8,39,47,30,4,4,17,24
1977,NOP,0,265,44,101,43.6,9,27,33.3,35,74,47.3,19,24,79.2,16,41,57,26,5,4,18,20
1978,ORL,1,240,38,88,43.2,15,34,44.1,23,54,42.59,12,13,92.3,18,36,54,22,9,7,21,15
1979,GSW,1,240,49,88,55.7,13,34,38.2,36,54,66.67,26,34,76.5,11,42,53,23,4,7,15,24
1980,LAL,1,240,41,89,46.1,12,35,34.3,29,54,53.7,14,19,73.7,12,37,49,24,9,5,10,15
1981,MEM,0,240,39,95,41.1,9,33,27.3,30,62,48.39,7,8,87.5,14,36,50,23,6,3,13,18
1982,PHX,0,240,37,75,49.3,10,33,30.3,27,42,64.29,23,28,82.1,7,33,40,23,4,3,14,22
1983,DAL,0,240,39,89,43.8,11,42,26.2,28,47,59.57,19,27,70.4,11,30,41,23,6,4,15,27
1984,POR,0,240,41,98,41.8,14,43,32.6,27,55,49.09,26,33,78.8,12,28,40,16,7,2,12,27
1985,BOS,1,240,49,87,56.3,15,33,45.5,34,54,62.96,9,13,69.2,12,29,41,35,4,5,18,22
1986,WAS,1,240,43,104,41.3,12,33,36.4,31,71,43.66,25,34,73.5,13,36,49,27,9,3,7,22
1987,BKN,0,240,40,81,49.4,14,32,43.8,26,49,53.06,28,31,90.3,7,44,51,25,5,9,20,24
1988,DEN,1,240,45,92,48.9,19,45,42.2,26,47,55.32,15,21,71.4,13,30,43,34,6,4,15,11
1989,MIN,0,240,44,85,51.8,10,31,32.3,34,54,62.96,11,16,68.8,9,27,36,30,11,6,14,17
1990,CHI,1,240,39,85,45.9,13,37,35.1,26,48,54.17,27,30,90,11,37,48,16,11,2,16,24
1991,LAC,1,240,40,83,48.2,17,29,58.6,23,54,42.59,15,19,78.9,8,29,37,24,5,2,10,22
1992,DET,0,240,41,86,47.7,16,36,44.4,25,50,50,22,25,88,8,25,33,29,8,7,10,16
1993,SAS,0,240,44,105,41.9,6,19,31.6,38,86,44.19,15,21,71.4,14,31,45,23,13,4,7,16
1994,UTA,1,240,49,89,55.1,21,41,51.2,28,48,58.33,11,19,57.9,9,48,57,29,4,11,20,18
1995,OKC,1,240,38,86,44.2,13,41,31.7,25,45,55.56,19,21,90.5,6,46,52,22,5,5,12,17
1996,PHI,1,240,47,79,59.5,16,35,45.7,31,44,70.45,17,24,70.8,7,38,45,35,10,7,22,17
1997,NOP,1,240,35,83,42.2,14,38,36.8,21,45,46.67,36,47,76.6,14,36,50,26,6,7,13,18
1998,TOR,0,240,38,91,41.8,14,48,29.2,24,43,55.81,26,27,96.3,10,30,40,21,6,4,10,29
1999,NYK,1,240,42,83,50.6,12,27,44.4,30,56,53.57,10,13,76.9,10,41,51,23,4,3,16,16
2000,ORL,0,240,40,108,37,10,38,26.3,30,70,42.86,9,12,75,15,40,55,21,7,1,6,18
2001,CHA,0,240,38,92,41.3,13,35,37.1,25,57,43.86,23,26,88.5,14,26,40,34,15,5,12,18
2002,IND,0,240,34,84,40.5,19,50,38,15,34,44.12,15,18,83.3,5,27,32,22,6,4,9,21
2003,HOU,1,240,36,81,44.4,13,41,31.7,23,40,57.5,17,23,73.9,6,42,48,15,10,10,14,22
2004,CLE,1,240,38,91,41.8,7,29,24.1,31,62,50,13,17,76.5,15,31,46,19,10,2,15,21
2005,ATL,0,240,35,85,41.2,11,32,34.4,24,53,45.28,10,19,52.6,15,33,48,22,9,5,22,20
2006,SAC,0,240,35,90,38.9,9,28,32.1,26,62,41.94,15,21,71.4,14,33,47,11,5,4,15,21
2007,ATL,1,240,43,93,46.2,16,39,41,27,54,50,12,14,85.7,10,38,48,24,8,3,11,20
2008,BOS,0,240,39,83,47,8,31,25.8,31,52,59.62,7,14,50,7,37,44,20,12,11,21,20
2009,PHX,1,240,37,76,48.7,13,35,37.1,24,41,58.54,19,21,90.5,8,29,37,24,1,4,17,20
2010,MIL,1,240,42,85,49.4,22,45,48.9,20,40,50,20,30,66.7,5,39,44,27,16,6,17,19
2011,GSW,0,240,31,79,39.2,7,35,20,24,44,54.55,29,33,87.9,3,41,44,19,4,9,15,28
2012,POR,1,240,40,92,43.5,20,43,46.5,20,49,40.82,23,30,76.7,8,43,51,23,11,3,10,27
2013,DET,1,240,36,88,40.9,11,34,32.4,25,54,46.3,13,20,65,12,36,48,18,9,2,20,16
2014,BKN,0,240,35,86,40.7,7,37,18.9,28,49,57.14,19,23,82.6,10,35,45,19,6,6,15,16
2015,MIN,0,240,42,88,47.7,13,36,36.1,29,52,55.77,12,21,57.1,11,32,43,17,9,3,20,22
2016,DEN,0,240,39,86,45.3,12,29,41.4,27,57,47.37,13,16,81.3,8,30,38,28,7,1,12,25
2017,WAS,1,240,49,89,55.1,16,33,48.5,33,56,58.93,16,21,76.2,8,35,43,35,9,3,16,19
2018,SAS,0,240,36,85,42.4,13,34,38.2,23,51,45.1,18,26,69.2,8,37,45,23,3,8,13,20
2019,LAC,0,240,33,85,38.8,13,33,39.4,20,52,38.46,21,24,87.5,12,31,43,19,6,8,10,16
2020,MIA,0,240,29,78,37.2,7,33,21.2,22,45,48.89,18,25,72,5,36,41,20,10,2,16,24
2021,CHA,0,240,35,86,40.7,9,31,29,26,55,47.27,14,21,66.7,10,32,42,23,9,4,19,15
2022,MEM,1,240,43,90,47.8,14,39,35.9,29,51,56.86,8,10,80,10,38,48,34,10,6,17,18
2023,DAL,1,240,32,78,41,12,37,32.4,20,41,48.78,17,23,73.9,4,45,49,18,9,3,17,25
2024,CHI,0,240,38,87,43.7,6,26,23.1,32,61,52.46,14,20,70,6,36,42,18,10,6,21,21
2025,UTA,1,240,41,89,46.1,15,42,35.7,26,47,55.32,9,14,64.3,13,33,46,28,3,3,14,20
2026,LAL,1,240,41,101,40.6,14,33,42.4,27,68,39.71,13,16,81.3,16,42,58,27,8,7,13,20
2027,WAS,0,240,42,84,50,14,29,48.3,28,55,50.91,32,41,78,9,28,37,27,8,4,14,27
2028,NYK,0,240,32,88,36.4,3,36,8.3,29,52,55.77,16,20,80,9,39,48,21,6,3,16,21
2029,ORL,0,240,33,95,34.7,7,28,25,26,67,38.81,19,21,90.5,10,38,48,17,2,5,11,15
2030,PHX,1,240,41,84,48.8,17,33,51.5,24,51,47.06,7,10,70,5,36,41,26,5,6,15,17
2031,HOU,1,240,45,86,52.3,13,36,36.1,32,50,64,19,25,76,10,35,45,26,10,6,18,14
2032,UTA,0,240,35,84,41.7,12,34,35.3,23,50,46,13,19,68.4,10,36,46,16,8,3,14,15
2033,OKC,0,240,30,80,37.5,15,48,31.3,15,32,46.88,5,15,33.3,7,33,40,24,6,3,19,20
2034,CHI,1,240,50,92,54.3,14,36,38.9,36,56,64.29,19,25,76,9,35,44,34,9,3,17,27
2035,CLE,0,240,37,82,45.1,12,23,52.2,25,59,42.37,13,24,54.2,11,32,43,22,5,6,18,22
2036,IND,1,240,42,87,48.3,16,35,45.7,26,52,50,19,24,79.2,9,35,44,28,12,1,14,22
2037,PHI,1,240,44,91,48.4,15,33,45.5,29,58,50,13,15,86.7,7,47,54,23,7,10,15,23
2038,TOR,1,240,34,83,41,17,52,32.7,17,31,54.84,15,21,71.4,9,44,53,21,7,6,18,22
2039,SAC,0,240,45,96,46.9,11,33,33.3,34,63,53.97,18,24,75,14,31,45,23,11,5,15,21
2040,NOP,1,240,44,91,48.4,13,36,36.1,31,55,56.36,12,19,63.2,14,44,58,23,9,4,13,16
2041,MEM,0,240,40,93,43,9,33,27.3,31,60,51.67,18,25,72,14,32,46,26,8,3,22,13
2042,CHA,1,240,43,84,51.2,15,34,44.1,28,50,56,17,21,81,12,38,50,30,6,6,24,28
2043,POR,0,240,32,76,42.1,12,38,31.6,20,38,52.63,29,34,85.3,5,36,41,14,5,4,19,17
2044,ATL,0,240,47,99,47.5,18,46,39.1,29,53,54.72,29,35,82.9,17,37,54,27,5,2,12,19
2045,LAL,1,240,46,82,56.1,14,26,53.8,32,56,57.14,15,20,75,7,40,47,25,4,3,17,24
2046,SAS,0,240,40,87,46,10,24,41.7,30,63,47.62,17,23,73.9,7,32,39,25,8,4,11,18
2047,BOS,1,240,49,91,53.8,16,39,41,33,52,63.46,12,14,85.7,10,32,42,27,17,11,16,21
2048,MIL,0,240,40,102,39.2,16,41,39,24,61,39.34,12,13,92.3,16,31,47,26,14,6,13,25
2049,DAL,0,240,34,87,39.1,12,42,28.6,22,45,48.89,19,33,57.6,13,26,39,24,10,6,14,16
2050,MIA,1,240,40,82,48.8,15,39,38.5,25,43,58.14,24,29,82.8,10,42,52,25,5,5,22,18
2051,LAC,1,240,47,95,49.5,18,38,47.4,29,57,50.88,16,22,72.7,11,36,47,30,13,6,11,25
2052,BKN,1,240,54,100,54,19,41,46.3,35,59,59.32,18,23,78.3,9,31,40,30,6,3,9,24
2053,MIL,1,240,51,92,55.4,29,51,56.9,22,41,53.66,13,15,86.7,10,35,45,32,14,2,17,22
2054,DET,0,240,35,92,38,13,35,37.1,22,57,38.6,23,29,79.3,16,29,45,21,8,6,15,26
2055,LAC,1,240,47,88,53.4,16,31,51.6,31,57,54.39,14,16,87.5,7,39,46,32,6,10,15,21
2056,NOP,0,240,37,77,48.1,3,24,12.5,34,53,64.15,9,18,50,7,34,41,18,8,3,18,14
2057,MIN,0,240,37,89,41.6,13,38,34.2,24,51,47.06,14,17,82.4,11,28,39,22,7,6,14,15
2058,IND,0,240,43,84,51.2,12,33,36.4,31,51,60.78,13,16,81.3,4,32,36,27,9,5,15,25
2059,PHI,1,240,32,84,38.1,8,31,25.8,24,53,45.28,28,33,84.8,9,45,54,21,10,10,20,15
2060,MIA,0,240,37,79,46.8,11,37,29.7,26,42,61.9,12,18,66.7,3,27,30,23,9,6,22,18
2061,GSW,1,240,38,76,50,14,33,42.4,24,43,55.81,26,36,72.2,4,36,40,21,8,8,19,28
2062,OKC,0,240,43,87,49.4,11,34,32.4,32,53,60.38,10,19,52.6,10,37,47,20,3,7,20,18
2063,TOR,0,240,32,90,35.6,17,45,37.8,15,45,33.33,12,14,85.7,10,37,47,21,12,7,20,28
2064,NYK,1,240,34,79,43,14,25,56,20,54,37.04,13,21,61.9,14,41,55,23,9,6,27,21
2065,ORL,1,240,49,96,51,7,22,31.8,42,74,56.76,13,16,81.3,12,34,46,26,12,2,11,23
2066,WAS,0,240,37,84,44,10,37,27,27,47,57.45,23,26,88.5,8,39,47,25,6,6,21,28
2067,SAC,1,240,46,94,48.9,16,33,48.5,30,61,49.18,17,22,77.3,12,25,37,33,9,2,11,18
2068,BOS,1,240,40,80,50,9,22,40.9,31,58,53.45,27,37,73,12,31,43,21,10,3,14,16
2069,CHI,1,240,38,87,43.7,15,36,41.7,23,51,45.1,24,32,75,5,32,37,26,7,1,14,23
2070,PHX,1,240,37,84,44,19,47,40.4,18,37,48.65,18,19,94.7,12,31,43,24,7,4,12,18
2071,CLE,0,240,32,88,36.4,7,32,21.9,25,56,44.64,15,22,68.2,14,29,43,22,13,10,13,17
2072,DEN,0,240,44,81,54.3,11,28,39.3,33,53,62.26,16,20,80,7,32,39,27,7,5,20,18
2073,BKN,0,265,41,100,41,14,42,33.3,27,58,46.55,15,17,88.2,13,37,50,28,13,6,17,20
2074,POR,1,240,43,92,46.7,16,46,34.8,27,46,58.7,13,15,86.7,7,38,45,27,9,6,10,16
2075,DET,0,240,43,98,43.9,13,41,31.7,30,57,52.63,21,24,87.5,17,31,48,24,7,4,8,25
2076,LAL,0,240,41,87,47.1,10,27,37,31,60,51.67,15,18,83.3,6,35,41,20,6,5,15,14
2077,OKC,0,240,40,86,46.5,15,38,39.5,25,48,52.08,14,19,73.7,7,30,37,21,9,5,17,16
2078,HOU,0,240,39,86,45.3,16,39,41,23,47,48.94,17,23,73.9,5,33,38,25,8,3,16,25
2079,DEN,1,240,46,87,52.9,14,31,45.2,32,56,57.14,18,32,56.3,11,41,52,31,8,7,16,18
2080,UTA,1,240,43,86,50,13,36,36.1,30,50,60,11,14,78.6,8,35,43,24,9,6,17,19
2081,ATL,1,240,40,82,48.8,20,42,47.6,20,40,50,28,32,87.5,8,37,45,30,5,7,13,22
2082,MEM,1,265,42,98,42.9,10,29,34.5,32,69,46.38,22,29,75.9,16,40,56,20,10,4,19,17
2083,MIL,0,240,41,95,43.2,7,38,18.4,34,57,59.65,21,29,72.4,17,27,44,24,7,5,11,21
2084,IND,1,240,45,88,51.1,7,26,26.9,38,62,61.29,11,15,73.3,8,29,37,23,11,7,16,20
2085,NOP,1,240,36,94,38.3,5,24,20.8,31,70,44.29,21,29,72.4,13,43,56,15,11,4,8,16
2086,LAC,0,240,26,76,34.2,4,33,12.1,22,43,51.16,17,20,85,5,31,36,13,2,2,14,19
2087,PHI,0,240,33,79,41.8,12,37,32.4,21,42,50,16,22,72.7,8,31,39,24,9,5,22,19
2088,CHI,0,240,44,86,51.2,17,41,41.5,27,45,60,23,31,74.2,7,47,54,27,4,6,24,21
2089,MIN,0,240,38,103,36.9,6,35,17.1,32,68,47.06,9,14,64.3,17,31,48,24,11,6,18,24
2090,WAS,0,240,47,97,48.5,8,32,25,39,65,60,11,13,84.6,13,34,47,27,6,4,13,26
2091,BOS,0,240,40,79,50.6,9,23,39.1,31,56,55.36,18,24,75,6,34,40,21,13,7,18,17
2092,CLE,1,240,48,91,52.7,9,23,39.1,39,68,57.35,13,16,81.3,11,34,45,31,13,6,16,22
2093,SAS,0,240,38,89,42.7,11,36,30.6,27,53,50.94,8,8,100,4,43,47,26,5,10,15,23
2094,GSW,1,240,42,104,40.4,18,47,38.3,24,57,42.11,27,30,90,10,31,41,25,17,4,12,23
2095,SAC,0,240,36,76,47.4,10,23,43.5,26,53,49.06,18,25,72,3,36,39,21,5,4,15,23
2096,DAL,1,240,43,87,49.4,14,41,34.1,29,46,63.04,24,27,88.9,11,43,54,25,10,2,8,14
2097,LAL,1,240,50,90,55.6,13,35,37.1,37,55,67.27,14,18,77.8,5,41,46,32,6,14,17,19
2098,PHX,1,240,46,94,48.9,14,35,40,32,59,54.24,10,11,90.9,8,36,44,34,6,3,9,20
2099,BKN,0,240,35,82,42.7,17,47,36.2,18,35,51.43,17,25,68,6,40,46,23,4,5,19,17
2100,NYK,1,240,46,85,54.1,16,27,59.3,30,58,51.72,22,27,81.5,8,38,46,27,5,4,16,23
2101,ORL,1,240,37,85,43.5,9,25,36,28,60,46.67,37,38,97.4,11,34,45,19,6,3,10,14
2102,CHA,1,240,43,96,44.8,10,34,29.4,33,62,53.23,10,17,58.8,13,39,52,35,8,3,15,25
2103,DET,0,290,40,98,40.8,16,45,35.6,24,53,45.28,23,32,71.9,10,47,57,24,9,5,24,20
2104,UTA,0,240,36,94,38.3,10,34,29.4,26,60,43.33,29,37,78.4,19,38,57,15,5,4,19,20
2105,CHI,0,240,34,91,37.4,16,39,41,18,52,34.62,22,25,88,13,28,41,23,7,7,20,16
2106,OKC,1,240,40,88,45.5,10,36,27.8,30,52,57.69,19,24,79.2,9,45,54,25,10,7,17,21
2107,IND,1,240,52,93,55.9,9,26,34.6,43,67,64.18,12,19,63.2,9,40,49,34,15,4,16,26
2108,POR,1,265,47,102,46.1,19,45,42.2,28,57,49.12,15,23,65.2,11,34,45,27,10,5,14,20
2109,ATL,1,240,38,89,42.7,13,36,36.1,25,53,47.17,33,38,86.8,13,41,54,23,4,5,15,20
2110,SAS,1,240,47,100,47,14,34,41.2,33,66,50,11,16,68.8,14,39,53,36,4,3,16,20
2111,PHX,0,240,41,98,41.8,11,44,25,30,54,55.56,10,13,76.9,10,30,40,25,8,5,11,23
2112,TOR,0,240,44,96,45.8,15,41,36.6,29,55,52.73,11,15,73.3,10,36,46,32,8,9,12,23
2113,SAC,1,240,39,86,45.3,5,23,21.7,34,63,53.97,23,33,69.7,15,41,56,20,4,9,18,22
2114,PHI,1,240,41,88,46.6,11,31,35.5,30,57,52.63,16,22,72.7,12,35,47,20,9,6,12,19
2115,ORL,1,240,48,95,50.5,11,31,35.5,37,64,57.81,23,29,79.3,11,43,54,25,8,0,14,21
2116,CHA,0,240,37,93,39.8,13,32,40.6,24,61,39.34,20,32,62.5,13,34,47,27,11,8,13,22
2117,NYK,0,240,32,83,38.6,8,29,27.6,24,54,44.44,17,23,73.9,13,30,43,19,6,4,16,23
2118,MEM,0,240,37,93,39.8,13,43,30.2,24,50,48,25,29,86.2,9,37,46,20,5,6,10,27
2119,MIN,1,240,45,101,44.6,13,29,44.8,32,72,44.44,13,18,72.2,12,28,40,21,9,5,10,28
2120,WAS,0,240,46,95,48.4,13,37,35.1,33,58,56.9,15,28,53.6,7,36,43,28,5,3,14,25
2121,CLE,1,290,48,99,48.5,13,30,43.3,35,69,50.72,19,30,63.3,7,44,51,29,13,4,19,24
2122,HOU,0,265,45,87,51.7,11,35,31.4,34,52,65.38,25,32,78.1,10,32,42,27,5,5,16,22
2123,MIL,1,240,50,90,55.6,20,36,55.6,30,54,55.56,18,26,69.2,11,49,60,25,6,4,18,17
2124,BOS,0,240,37,98,37.8,8,27,29.6,29,71,40.85,13,19,68.4,20,27,47,23,6,5,15,27
2125,LAC,1,240,41,74,55.4,19,38,50,22,36,61.11,20,24,83.3,9,29,38,32,9,4,21,32
2126,LAL,1,240,51,91,56,19,39,48.7,32,52,61.54,17,24,70.8,17,36,53,33,9,4,17,23
2127,NOP,0,240,31,78,39.7,10,35,28.6,21,43,48.84,26,33,78.8,11,30,41,18,8,2,19,20
2128,DAL,0,240,41,83,49.4,13,32,40.6,28,51,54.9,20,26,76.9,3,24,27,20,13,3,9,22
2129,MIA,1,240,38,75,50.7,16,37,43.2,22,38,57.89,19,23,82.6,4,31,35,29,11,2,17,25
2130,GSW,0,240,34,99,34.3,10,45,22.2,24,54,44.44,21,25,84,10,33,43,14,5,6,11,22
2131,DEN,0,240,37,81,45.7,11,36,30.6,26,45,57.78,23,31,74.2,10,22,32,25,7,1,13,20
2132,BKN,1,240,41,76,53.9,15,29,51.7,26,47,55.32,26,31,83.9,9,34,43,21,5,10,16,22
2133,MIL,0,240,46,90,51.1,14,35,40,32,55,58.18,15,18,83.3,11,41,52,19,4,6,16,20
2134,CHA,0,240,45,90,50,16,44,36.4,29,46,63.04,8,15,53.3,8,24,32,29,10,4,15,17
2135,ATL,1,240,43,80,53.8,14,35,40,29,45,64.44,24,29,82.8,8,38,46,24,6,3,23,29
2136,TOR,0,240,38,89,42.7,14,46,30.4,24,43,55.81,9,12,75,7,28,35,26,10,5,21,22
2137,MIA,0,240,42,83,50.6,7,20,35,35,63,55.56,16,19,84.2,7,36,43,25,11,2,22,21
2138,PHI,1,240,41,87,47.1,8,28,28.6,33,59,55.93,23,30,76.7,10,37,47,22,11,8,18,25
2139,MEM,0,240,49,95,51.6,10,27,37,39,68,57.35,11,18,61.1,5,37,42,27,6,8,11,20
2140,SAC,1,265,45,102,44.1,10,31,32.3,35,71,49.3,24,31,77.4,18,36,54,27,5,7,15,29
2141,DET,0,240,45,93,48.4,8,35,22.9,37,58,63.79,3,8,37.5,7,37,44,29,5,2,15,20
2142,NYK,0,240,39,85,45.9,12,28,42.9,27,57,47.37,17,23,73.9,5,35,40,25,8,8,16,27
2143,MIN,1,240,38,88,43.2,11,41,26.8,27,47,57.45,24,28,85.7,12,36,48,25,6,5,12,16
2144,CLE,1,240,46,87,52.9,14,30,46.7,32,57,56.14,15,20,75,10,40,50,34,12,3,21,22
2145,CHI,0,240,36,87,41.4,8,35,22.9,28,52,53.85,24,28,85.7,8,29,37,20,10,3,17,22
2146,DAL,0,240,36,85,42.4,9,37,24.3,27,48,56.25,21,26,80.8,6,33,39,17,6,0,12,23
2147,BOS,1,240,48,101,47.5,18,40,45,30,61,49.18,8,11,72.7,10,27,37,23,8,6,7,17
2148,IND,1,240,46,94,48.9,8,34,23.5,38,60,63.33,21,29,72.4,10,40,50,28,6,9,13,24
2149,PHX,1,240,38,79,48.1,11,30,36.7,27,49,55.1,19,27,70.4,6,42,48,21,7,7,19,26
2150,UTA,1,240,43,94,45.7,19,50,38,24,44,54.55,15,19,78.9,12,47,59,24,3,3,11,16
2151,ORL,1,240,42,88,47.7,10,28,35.7,32,60,53.33,19,30,63.3,11,30,41,23,15,3,18,19
2152,POR,0,240,37,92,40.2,12,33,36.4,25,59,42.37,14,17,82.4,6,34,40,23,6,3,6,18
2153,NOP,1,240,42,80,52.5,19,42,45.2,23,38,60.53,10,20,50,8,37,45,30,13,7,27,17
2154,DEN,0,265,47,98,48,8,29,27.6,39,69,56.52,20,24,83.3,10,36,46,28,6,11,15,25
2155,WAS,0,240,39,85,45.9,13,27,48.1,26,58,44.83,16,23,69.6,5,35,40,28,7,4,20,26
2156,SAS,1,240,48,95,50.5,10,25,40,38,70,54.29,25,29,86.2,8,40,48,28,8,8,11,18
2157,LAL,0,240,38,81,46.9,9,29,31,29,52,55.77,24,31,77.4,8,37,45,22,4,2,19,20
2158,BKN,1,240,42,92,45.7,15,35,42.9,27,57,47.37,26,32,81.3,13,44,57,24,11,7,20,22
2159,GSW,0,240,37,99,37.4,10,33,30.3,27,66,40.91,15,23,65.2,13,34,47,26,6,6,18,24
2160,LAC,1,240,44,93,47.3,14,40,35,30,53,56.6,14,19,73.7,11,29,40,22,10,3,16,29
1,WAS,0,48,42,94,44.7,8,23,34.8,34,71,47.89,16,26,61.5,17,26,43,25,11,12,3,16
2,POR,0,48,31,83,37.3,9,34,26.5,22,49,44.9,9,12,75,5,27,32,21,16,11,8,27
3,MEM,0,48,39,102,38.2,15,47,31.9,24,55,43.64,17,27,63,19,26,45,27,10,11,6,16
4,IND,0,48,47,104,45.2,19,46,41.3,28,58,48.28,13,19,68.4,11,19,30,32,7,16,1,23
5,CLE,1,48,51,94,54.3,19,38,50,32,56,57.14,12,17,70.6,10,38,48,39,12,5,5,26
6,PHX,0,48,42,103,40.8,14,47,29.8,28,56,50,11,15,73.3,18,32,50,27,11,9,7,25
7,CHI,1,48,44,83,53,10,21,47.6,34,62,54.84,26,33,78.8,16,32,48,22,23,9,3,22
8,ATL,1,48,45,87,51.7,21,38,55.3,24,49,48.98,19,24,79.2,13,37,50,29,13,4,4,19
9,CHA,1,48,48,89,53.9,18,33,54.5,30,56,53.57,10,14,71.4,11,37,48,34,20,6,9,20
10,MIA,0,48,40,94,42.6,19,50,38,21,44,47.73,12,16,75,10,37,47,20,10,5,4,13
11,TOR,0,48,36,92,39.1,12,42,28.6,24,50,48,10,11,90.9,9,34,43,27,14,10,2,17
12,HOU,0,48,41,89,46.1,17,46,37,24,43,55.81,15,20,75,6,28,34,24,8,4,4,19
13,ORL,1,48,45,91,49.5,23,58,39.7,22,33,66.67,12,14,85.7,6,42,48,33,10,4,3,16
14,SAC,1,48,40,76,52.6,14,26,53.8,26,50,52,22,30,73.3,2,38,40,26,15,9,7,18
15,GSW,1,48,49,81,60.5,19,33,57.6,30,48,62.5,11,13,84.6,7,34,41,33,17,5,2,15
16,LAL,1,53,44,94,46.8,16,43,37.2,28,51,54.9,42,47,89.4,13,37,50,26,13,4,6,24
17,SAS,0,48,43,89,48.3,11,31,35.5,32,58,55.17,23,23,100,7,28,35,26,8,15,3,17
18,BOS,1,48,54,99,54.5,18,48,37.5,36,51,70.59,13,13,100,14,42,56,34,15,5,2,20
19,PHI,1,48,46,88,52.3,5,25,20,41,63,65.08,21,23,91.3,10,32,42,25,11,13,6,23
20,NOP,0,48,42,99,42.4,14,40,35,28,59,47.46,9,12,75,18,24,42,24,12,10,0,17
21,DEN,0,53,49,100,49,15,47,31.9,34,53,64.15,28,36,77.8,11,34,45,33,14,10,7,34
22,BKN,1,48,52,81,64.2,8,22,36.4,44,59,74.58,22,25,88,8,42,50,30,21,5,6,16
23,DET,0,48,38,83,45.8,11,34,32.4,27,49,55.1,19,29,65.5,15,27,42,26,20,4,4,16
24,MIN,0,48,46,91,50.5,11,31,35.5,35,60,58.33,17,22,77.3,9,23,32,30,13,7,9,23
25,UTA,1,48,37,82,45.1,9,36,25,28,46,60.87,28,38,73.7,15,45,60,23,17,8,6,16
26,NYK,1,48,40,87,46,15,43,34.9,25,44,56.82,10,12,83.3,10,38,48,32,17,6,5,17
27,MIL,0,48,39,88,44.3,12,30,40,27,58,46.55,25,32,78.1,8,33,41,27,12,7,2,14
28,DAL,1,48,46,85,54.1,20,36,55.6,26,49,53.06,18,23,78.3,10,33,43,34,16,5,3,16
29,LAC,1,48,54,97,55.7,18,35,51.4,36,62,58.06,12,14,85.7,12,45,57,34,9,4,8,11
30,OKC,0,48,37,98,37.8,9,34,26.5,28,64,43.75,5,9,55.6,12,28,40,17,10,6,2,16
31,MEM,1,48,53,90,58.9,18,35,51.4,35,55,63.64,17,23,73.9,13,35,48,41,19,6,9,24
32,GSW,1,48,33,81,40.7,8,32,25,25,49,51.02,26,33,78.8,13,38,51,23,12,8,1,22
33,IND,0,48,41,78,52.6,10,23,43.5,31,55,56.36,28,36,77.8,7,24,31,28,17,8,6,22
34,LAC,1,48,42,86,48.8,21,43,48.8,21,43,48.84,12,15,80,10,38,48,29,17,7,3,22
35,SAS,0,48,32,80,40,10,31,32.3,22,49,44.9,20,27,74.1,4,37,41,19,12,5,3,24
36,NOP,0,48,41,91,45.1,6,30,20,35,61,57.38,26,35,74.3,9,20,29,23,16,10,3,22
37,PHI,1,48,50,90,55.6,12,34,35.3,38,56,67.86,21,27,77.8,14,28,42,37,15,14,3,24
38,SAC,0,48,38,86,44.2,7,28,25,31,58,53.45,15,24,62.5,7,35,42,24,13,12,2,16
39,UTA,0,48,35,88,39.8,11,38,28.9,24,50,48,24,33,72.7,15,29,44,20,11,8,4,18
40,HOU,0,48,43,81,53.1,10,29,34.5,33,52,63.46,19,24,79.2,7,34,41,24,19,6,3,19
41,POR,0,48,31,83,37.3,7,32,21.9,24,51,47.06,9,12,75,5,24,29,20,17,9,2,23
42,BKN,1,48,43,92,46.7,12,32,37.5,31,60,51.67,20,21,95.2,13,32,45,30,11,5,8,20
43,OKC,0,48,40,88,45.5,6,29,20.7,34,59,57.63,15,19,78.9,9,35,44,21,14,5,3,26
44,CHA,1,48,52,86,60.5,19,40,47.5,33,46,71.74,10,10,100,8,30,38,34,11,7,4,21
45,PHX,1,48,46,92,50,6,19,31.6,40,73,54.79,13,15,86.7,11,35,46,27,13,7,3,25
46,ATL,0,48,42,88,47.7,8,34,23.5,34,54,62.96,17,19,89.5,13,30,43,17,15,9,0,23
47,TOR,1,48,44,96,45.8,7,29,24.1,37,67,55.22,22,23,95.7,13,28,41,20,10,13,4,18
48,DAL,1,48,42,79,53.2,20,45,44.4,22,34,64.71,24,31,77.4,9,42,51,25,15,9,5,19
49,CLE,0,48,40,82,48.8,8,27,29.6,32,55,58.18,19,24,79.2,10,21,31,19,9,4,4,20
50,MIL,1,48,50,101,49.5,11,37,29.7,39,64,60.94,20,23,87,10,41,51,29,8,7,1,20
51,CHI,0,48,44,82,53.7,13,24,54.2,31,58,53.45,16,20,80,6,25,31,25,12,7,1,12
52,LAL,1,48,41,82,50,9,31,29,32,51,62.75,29,39,74.4,7,38,45,23,10,8,4,17
53,NYK,1,48,41,88,46.6,16,39,41,25,49,51.02,16,20,80,10,32,42,27,10,13,3,19
54,MIA,1,48,40,72,55.6,11,26,42.3,29,46,63.04,22,28,78.6,4,29,33,20,17,9,1,17
55,DET,0,48,35,90,38.9,10,48,20.8,25,42,59.52,21,23,91.3,9,34,43,27,14,6,5,22
56,WAS,0,48,35,69,50.7,9,28,32.1,26,41,63.41,13,17,76.5,2,35,37,21,22,5,5,19
57,DEN,1,48,44,80,55,12,30,40,32,50,64,22,25,88,8,35,43,27,19,7,2,22
58,CHA,1,48,48,92,52.2,12,34,35.3,36,58,62.07,20,27,74.1,10,46,56,29,12,9,10,17
59,TOR,1,48,45,91,49.5,15,33,45.5,30,58,51.72,14,18,77.8,12,29,41,22,11,7,4,17
60,BOS,0,48,43,87,49.4,21,50,42,22,37,59.46,14,19,73.7,8,36,44,30,16,8,4,15
61,POR,0,48,36,69,52.2,11,31,35.5,25,38,65.79,11,13,84.6,3,24,27,28,22,10,4,27
62,GSW,1,48,51,97,52.6,16,32,50,35,65,53.85,10,10,100,9,36,45,39,15,10,5,26
63,PHI,0,48,37,75,49.3,19,36,52.8,18,39,46.15,21,25,84,6,31,37,26,17,7,3,18
64,SAS,0,48,43,89,48.3,10,28,35.7,33,61,54.1,25,34,73.5,8,37,45,31,12,5,5,22
65,ORL,0,48,38,95,40,15,48,31.3,23,47,48.94,10,13,76.9,8,35,43,27,16,6,4,22
66,MEM,0,48,42,89,47.2,11,28,39.3,31,61,50.82,14,19,73.7,10,24,34,30,13,8,3,21
67,MIL,1,48,49,97,50.5,14,38,36.8,35,59,59.32,15,21,71.4,14,34,48,27,11,13,5,19
68,LAL,0,48,37,83,44.6,9,32,28.1,28,51,54.9,29,38,76.3,8,34,42,14,19,8,4,13
69,NOP,1,48,44,93,47.3,13,37,35.1,31,56,55.36,26,31,83.9,23,26,49,31,12,15,1,14
70,MIN,1,48,41,96,42.7,20,53,37.7,21,43,48.84,25,31,80.6,13,34,47,25,11,8,2,29
71,ATL,1,48,43,92,46.7,16,39,41,27,53,50.94,16,19,84.2,7,32,39,26,6,11,1,13
72,WAS,0,48,42,86,48.8,10,35,28.6,32,51,62.75,9,11,81.8,6,38,44,26,14,4,4,17
73,LAC,1,48,33,75,44,12,34,35.3,21,41,51.22,35,44,79.5,9,46,55,20,17,7,9,17
74,CHI,0,48,35,80,43.8,7,23,30.4,28,57,49.12,17,23,73.9,7,33,40,19,17,7,4,22
75,OKC,0,48,37,90,41.1,16,37,43.2,21,53,39.62,11,17,64.7,11,21,32,27,10,9,1,22
76,DAL,1,48,45,80,56.3,15,33,45.5,30,47,63.83,26,34,76.5,8,33,41,28,10,8,1,24
77,BOS,1,48,43,88,48.9,17,37,45.9,26,51,50.98,14,22,63.6,8,34,42,29,13,11,6,18
78,NYK,0,48,32,83,38.6,13,38,34.2,19,45,42.22,21,36,58.3,10,32,42,22,11,4,7,19
79,UTA,1,48,49,84,58.3,15,36,41.7,34,48,70.83,24,32,75,16,39,55,29,13,7,10,13
80,DET,0,48,35,82,42.7,11,30,36.7,24,52,46.15,32,35,91.4,11,31,42,26,11,7,5,21
81,BKN,1,48,41,93,44.1,14,41,34.1,27,52,51.92,14,18,77.8,13,36,49,28,14,7,6,26
82,PHX,0,48,42,108,38.9,17,48,35.4,25,60,41.67,8,12,66.7,18,36,54,29,12,11,2,26
83,MEM,0,53,39,101,38.6,13,31,41.9,26,70,37.14,24,29,82.8,10,41,51,26,13,13,7,29
84,SAC,0,48,39,76,51.3,11,30,36.7,28,46,60.87,20,22,90.9,3,31,34,28,15,4,3,20
85,NOP,1,48,45,88,51.1,12,25,48,33,63,52.38,21,26,80.8,14,30,44,26,13,13,2,20
86,PHI,1,48,47,87,54,23,40,57.5,24,47,51.06,14,18,77.8,5,31,36,34,16,8,3,14
87,PHX,1,48,50,102,49,14,39,35.9,36,63,57.14,7,9,77.8,11,42,53,38,14,10,4,22
88,MIN,0,48,41,91,45.1,14,41,34.1,27,50,54,18,25,72,6,32,38,27,10,6,3,16
89,IND,0,48,45,95,47.4,12,40,30,33,55,60,20,21,95.2,16,32,48,29,16,8,10,18
90,LAL,0,48,39,86,45.3,9,29,31,30,57,52.63,23,30,76.7,7,39,46,22,16,7,3,14
91,POR,0,48,35,83,42.2,11,32,34.4,24,51,47.06,13,16,81.3,10,30,40,24,17,10,6,19
92,BKN,1,48,39,86,45.3,15,37,40.5,24,49,48.98,25,27,92.6,12,40,52,22,17,6,9,23
93,CHA,0,48,45,85,52.9,12,38,31.6,33,47,70.21,13,18,72.2,7,24,31,34,15,8,3,18
94,CHI,0,48,42,98,42.9,9,33,27.3,33,65,50.77,13,13,100,13,29,42,22,15,8,2,21
95,WAS,1,48,56,101,55.4,13,30,43.3,43,71,60.56,7,14,50,9,43,52,38,10,4,4,25
96,UTA,1,53,40,96,41.7,12,38,31.6,28,58,48.28,29,43,67.4,13,48,61,23,17,8,8,21
97,SAS,1,48,44,89,49.4,12,26,46.2,32,63,50.79,16,24,66.7,5,43,48,31,11,6,3,14
98,TOR,1,48,44,101,43.6,9,35,25.7,35,66,53.03,21,31,67.7,20,40,60,20,8,6,5,14
99,ATL,0,48,43,94,45.7,14,37,37.8,29,57,50.88,8,12,66.7,10,33,43,31,7,5,4,22
100,HOU,0,48,40,99,40.4,11,43,25.6,29,56,51.79,14,25,56,18,30,48,18,11,8,6,20
101,DEN,0,48,41,98,41.8,7,33,21.2,34,65,52.31,8,12,66.7,10,41,51,22,11,4,2,19
102,OKC,1,48,39,81,48.1,9,29,31,30,52,57.69,11,22,50,13,34,47,15,17,12,12,10
103,ORL,1,48,47,93,50.5,16,35,45.7,31,58,53.45,10,15,66.7,8,35,43,31,7,9,8,19
104,MIA,1,48,48,84,57.1,23,42,54.8,25,42,59.52,25,29,86.2,8,33,41,29,15,10,1,19
105,CLE,0,48,42,86,48.8,16,36,44.4,26,50,52,15,22,68.2,9,38,47,25,12,6,4,11
106,MIL,1,48,46,87,52.9,12,35,34.3,34,52,65.38,23,25,92,8,39,47,32,14,8,8,19
107,GSW,1,48,41,79,51.9,16,34,47.1,25,45,55.56,11,15,73.3,7,40,47,29,17,8,8,28
108,LAC,1,48,45,95,47.4,21,44,47.7,24,51,47.06,8,10,80,12,29,41,33,10,10,5,21
109,PHI,1,48,33,80,41.3,11,31,35.5,22,49,44.9,35,42,83.3,12,38,50,23,14,7,8,19
110,WAS,0,48,38,82,46.3,8,21,38.1,30,61,49.18,18,20,90,7,25,32,21,12,4,2,14
111,DEN,1,48,47,82,57.3,12,31,38.7,35,51,68.63,23,29,79.3,6,32,38,33,12,10,5,18
112,DET,1,48,43,99,43.4,21,41,51.2,22,58,37.93,14,18,77.8,10,28,38,31,12,11,4,19
113,SAC,0,48,31,81,38.3,7,33,21.2,24,48,50,21,24,87.5,6,29,35,19,13,5,1,15
114,POR,0,48,33,84,39.3,16,45,35.6,17,39,43.59,10,15,66.7,7,32,39,22,14,7,4,22
115,ORL,0,48,30,85,35.3,12,44,27.3,18,41,43.9,16,27,59.3,8,32,40,18,11,5,2,12
116,OKC,1,48,43,87,49.4,17,41,41.5,26,46,56.52,14,18,77.8,12,42,54,33,18,7,4,18
117,SAS,1,48,38,84,45.2,14,42,33.3,24,42,57.14,23,30,76.7,10,41,51,25,13,9,1,18
118,MIA,1,48,41,79,51.9,18,38,47.4,23,41,56.1,14,22,63.6,8,30,38,30,17,9,4,21
119,HOU,0,48,48,85,56.5,16,40,40,32,45,71.11,20,29,69,11,25,36,28,24,8,4,24
120,MIN,1,48,51,86,59.3,17,41,41.5,34,45,75.56,20,25,80,7,25,32,32,19,13,6,27
121,MIL,0,48,42,95,44.2,15,40,37.5,27,55,49.09,13,18,72.2,10,26,36,25,9,9,1,22
122,NYK,1,48,45,93,48.4,15,44,34.1,30,49,61.22,13,16,81.3,13,43,56,29,10,9,7,22
123,TOR,0,48,35,83,42.2,12,39,30.8,23,44,52.27,27,34,79.4,10,28,38,19,17,12,1,20
124,LAL,0,48,49,92,53.3,6,20,30,43,72,59.72,14,21,66.7,6,34,40,31,13,4,5,25
125,CLE,0,48,35,78,44.9,15,33,45.5,20,45,44.44,23,31,74.2,7,34,41,24,12,10,3,28
126,IND,0,48,45,94,47.9,12,38,31.6,33,56,58.93,15,19,78.9,17,41,58,33,19,6,11,21
127,DAL,1,48,39,76,51.3,16,38,42.1,23,38,60.53,24,27,88.9,2,36,38,28,14,7,3,20
128,PHX,0,48,37,89,41.6,7,38,18.4,30,51,58.82,15,17,88.2,6,27,33,22,11,14,4,17
129,NOP,0,48,35,87,40.2,9,24,37.5,26,63,41.27,21,27,77.8,19,35,54,22,16,4,5,13
130,BOS,1,48,56,91,61.5,23,44,52.3,33,47,70.21,9,13,69.2,7,32,39,39,8,6,5,20
131,NYK,0,48,31,77,40.3,13,30,43.3,18,47,38.3,26,34,76.5,6,29,35,19,11,6,4,19
132,UTA,0,48,38,89,42.7,15,46,32.6,23,43,53.49,16,22,72.7,12,35,47,19,13,8,2,17
133,CHA,0,48,42,87,48.3,11,30,36.7,31,57,54.39,19,24,79.2,7,25,32,34,17,14,1,18
134,CHI,0,48,37,86,43,9,34,26.5,28,52,53.85,26,29,89.7,11,28,39,21,6,5,4,19
135,PHI,1,48,53,87,60.9,21,43,48.8,32,44,72.73,17,21,81,10,37,47,38,19,10,5,18
136,MIA,1,48,44,82,53.7,17,34,50,27,48,56.25,22,27,81.5,5,36,41,28,9,4,1,21
137,CLE,1,48,44,81,54.3,15,34,44.1,29,47,61.7,16,21,76.2,7,36,43,26,12,6,3,24
138,BKN,0,48,42,99,42.4,17,37,45.9,25,62,40.32,14,19,73.7,10,42,52,17,13,5,3,29
139,GSW,1,48,40,84,47.6,20,48,41.7,20,36,55.56,11,12,91.7,6,35,41,30,11,5,6,22
140,ATL,1,48,36,86,41.9,13,41,31.7,23,45,51.11,37,49,75.5,10,44,54,18,7,10,4,18
141,MEM,1,48,46,102,45.1,7,24,29.2,39,78,50,23,28,82.1,16,32,48,30,11,7,2,18
142,LAC,1,48,56,92,60.9,23,43,53.5,33,49,67.35,18,24,75,8,28,36,34,10,9,7,17
143,IND,0,48,42,81,51.9,17,36,47.2,25,45,55.56,22,23,95.7,8,22,30,25,16,9,3,30
144,MIL,0,48,50,94,53.2,8,25,32,42,69,60.87,11,18,61.1,13,25,38,30,15,6,5,19
145,SAS,1,48,46,81,56.8,16,37,43.2,30,44,68.18,22,28,78.6,8,36,44,34,15,9,6,16
146,ORL,0,48,34,79,43,11,35,31.4,23,44,52.27,10,11,90.9,9,36,45,24,22,6,4,14
147,LAL,0,48,39,82,47.6,11,27,40.7,28,55,50.91,22,31,71,7,33,40,24,17,10,1,24
148,TOR,1,48,36,86,41.9,13,42,31,23,44,52.27,17,20,85,10,31,41,21,10,13,3,14
149,OKC,0,48,36,84,42.9,11,34,32.4,25,50,50,18,29,62.1,12,42,54,24,17,1,8,15
150,HOU,0,48,41,97,42.3,17,45,37.8,24,52,46.15,18,26,69.2,15,30,45,26,11,9,7,25
151,NOP,1,48,41,79,51.9,7,26,26.9,34,53,64.15,25,29,86.2,4,33,37,23,15,8,4,21
152,PHX,0,48,47,86,54.7,10,27,37,37,59,62.71,10,17,58.8,2,37,39,27,20,8,4,25
153,POR,0,48,41,92,44.6,15,35,42.9,26,57,45.61,14,20,70,12,30,42,27,12,12,2,20
154,DET,1,48,40,94,42.6,15,48,31.3,25,46,54.35,15,18,83.3,8,36,44,29,8,9,8,20
155,MIN,1,48,43,86,50,19,40,47.5,24,46,52.17,31,36,86.1,10,28,38,26,12,14,4,23
156,DAL,0,48,34,78,43.6,11,38,28.9,23,40,57.5,24,26,92.3,5,31,36,14,13,3,3,16
157,SAC,1,48,42,81,51.9,12,28,42.9,30,53,56.6,26,34,76.5,8,39,47,29,13,6,11,19
158,WAS,1,48,49,90,54.4,17,33,51.5,32,57,56.14,20,22,90.9,8,37,45,33,9,7,4,19
159,BOS,1,48,45,83,54.2,12,33,36.4,33,50,66,26,28,92.9,11,29,40,29,16,7,4,19
160,DEN,0,48,46,86,53.5,12,35,34.3,34,51,66.67,26,29,89.7,10,34,44,36,18,7,2,23
161,LAC,0,53,45,90,50,16,36,44.4,29,54,53.7,24,26,92.3,4,36,40,26,12,7,5,24
162,CLE,0,48,39,90,43.3,7,30,23.3,32,60,53.33,22,28,78.6,15,32,47,19,14,6,5,20
163,LAL,0,48,41,83,49.4,7,25,28,34,58,58.62,20,28,71.4,9,31,40,18,11,5,3,21
164,BKN,0,53,45,97,46.4,18,37,48.6,27,60,45,11,16,68.8,5,36,41,31,16,12,7,25
165,ATL,1,48,45,91,49.5,17,39,43.6,28,52,53.85,24,28,85.7,12,36,48,27,9,7,4,22
166,MIL,1,53,40,89,44.9,12,41,29.3,28,48,58.33,28,34,82.4,11,46,57,17,23,12,3,14
167,UTA,1,48,46,90,51.1,15,44,34.1,31,46,67.39,15,24,62.5,9,32,41,25,8,7,2,20
168,CHI,1,53,50,102,49,10,29,34.5,40,73,54.79,25,32,78.1,13,37,50,24,8,6,3,17
169,DET,1,48,41,82,50,10,35,28.6,31,47,65.96,10,15,66.7,5,33,38,26,10,11,4,21
170,PHI,0,48,31,69,44.9,7,26,26.9,24,43,55.81,25,28,89.3,4,35,39,22,15,8,9,17
171,DAL,1,48,46,88,52.3,16,42,38.1,30,46,65.22,12,15,80,9,29,38,28,12,6,6,17
172,NOP,1,48,40,78,51.3,6,24,25,34,54,62.96,31,39,79.5,12,28,40,26,14,16,6,16
173,MIA,1,48,38,79,48.1,13,34,38.2,25,45,55.56,17,25,68,4,38,42,27,18,9,6,23
174,POR,0,48,39,85,45.9,14,42,33.3,25,43,58.14,15,18,83.3,13,28,41,30,22,7,4,27
175,GSW,0,48,35,83,42.2,13,38,34.2,22,45,48.89,20,25,80,10,38,48,26,21,7,4,24
176,MIN,0,48,37,92,40.2,11,37,29.7,26,55,47.27,17,23,73.9,17,31,48,26,22,11,9,19
177,OKC,0,48,41,87,47.1,17,41,41.5,24,46,52.17,19,27,70.4,10,32,42,31,18,5,2,17
178,DEN,1,48,50,80,62.5,12,28,42.9,38,52,73.08,13,14,92.9,8,35,43,33,20,6,4,20
179,CHA,1,48,49,90,54.4,12,35,34.3,37,55,67.27,15,17,88.2,8,32,40,39,12,7,3,21
180,ATL,1,48,49,91,53.8,18,39,46.2,31,52,59.62,20,22,90.9,6,37,43,28,13,10,4,19
181,WAS,1,48,47,92,51.1,13,36,36.1,34,56,60.71,20,26,76.9,12,39,51,35,12,5,8,15
182,HOU,0,48,43,94,45.7,13,42,31,30,52,57.69,19,25,76,12,39,51,23,18,7,4,34
183,NYK,0,48,40,85,47.1,16,44,36.4,24,41,58.54,18,26,69.2,11,32,43,23,14,5,5,19
184,SAS,0,48,42,83,50.6,14,35,40,28,48,58.33,13,16,81.3,7,30,37,26,15,8,1,13
185,PHX,1,48,38,92,41.3,7,28,25,31,64,48.44,24,30,80,12,34,46,20,14,9,1,19
186,ORL,0,48,40,96,41.7,11,34,32.4,29,62,46.77,19,22,86.4,11,31,42,21,12,8,5,23
187,IND,0,48,44,97,45.4,12,40,30,32,57,56.14,18,23,78.3,18,19,37,29,8,11,4,21
188,SAC,1,48,44,95,46.3,7,26,26.9,37,69,53.62,26,36,72.2,13,31,44,21,9,7,10,21
189,BOS,0,48,35,85,41.2,11,37,29.7,24,48,50,17,23,73.9,8,36,44,27,18,9,1,22
190,CLE,0,48,42,83,50.6,11,25,44,31,58,53.45,17,22,77.3,9,30,39,24,15,7,3,15
191,TOR,1,48,48,96,50,18,36,50,30,60,50,11,15,73.3,11,36,47,32,19,9,4,23
192,MEM,1,48,44,91,48.4,16,39,41,28,52,53.85,8,11,72.7,12,28,40,26,14,8,5,15
193,MIL,1,48,44,88,50,14,38,36.8,30,50,60,16,23,69.6,9,39,48,26,11,5,4,17
194,WAS,0,48,38,79,48.1,6,26,23.1,32,53,60.38,12,17,70.6,7,30,37,25,14,6,7,17
195,LAL,0,48,40,89,44.9,12,44,27.3,28,45,62.22,18,22,81.8,14,34,48,20,9,7,2,22
196,DET,0,48,48,99,48.5,16,38,42.1,32,61,52.46,11,13,84.6,16,23,39,28,14,11,4,25
197,CHI,1,48,43,85,50.6,6,18,33.3,37,67,55.22,15,18,83.3,6,30,36,26,9,9,1,14
198,DAL,1,48,45,87,51.7,20,46,43.5,25,41,60.98,18,23,78.3,11,35,46,27,8,5,1,14
199,PHI,0,48,43,89,48.3,16,41,39,27,48,56.25,14,18,77.8,5,35,40,28,9,7,3,19
200,LAC,1,48,41,83,49.4,15,36,41.7,26,47,55.32,24,28,85.7,10,23,33,21,11,8,4,23
201,BKN,1,48,42,76,55.3,15,28,53.6,27,48,56.25,31,34,91.2,8,33,41,24,19,9,6,19
202,UTA,0,48,43,78,55.1,12,31,38.7,31,47,65.96,17,29,58.6,10,28,38,23,15,5,5,24
203,POR,0,53,51,112,45.5,20,50,40,31,62,50,9,13,69.2,19,28,47,28,11,17,5,23
204,MIA,1,48,49,90,54.4,19,40,47.5,30,50,60,6,6,100,10,38,48,30,16,7,1,20
205,HOU,0,48,38,92,41.3,20,49,40.8,18,43,41.86,24,28,85.7,10,34,44,26,12,5,9,24
206,GSW,0,48,33,81,40.7,9,29,31,24,52,46.15,20,26,76.9,7,33,40,18,17,6,7,27
207,DEN,1,48,40,86,46.5,12,33,36.4,28,53,52.83,21,28,75,17,34,51,29,16,7,3,17
208,BOS,0,53,39,95,41.1,12,40,30,27,55,49.09,22,28,78.6,16,41,57,23,17,5,7,15
209,TOR,1,53,46,106,43.4,10,39,25.6,36,67,53.73,13,18,72.2,16,36,52,16,10,10,11,28
210,IND,0,48,45,87,51.7,17,36,47.2,28,51,54.9,16,18,88.9,8,20,28,32,14,7,6,22
211,ATL,1,48,47,86,54.7,17,35,48.6,30,51,58.82,21,26,80.8,13,27,40,32,15,11,4,19
212,ORL,0,48,42,87,48.3,10,37,27,32,50,64,7,13,53.8,8,37,45,31,17,6,1,24
213,OKC,1,53,48,90,53.3,20,45,44.4,28,45,62.22,18,25,72,11,38,49,32,21,7,3,15
214,NYK,1,48,38,89,42.7,12,35,34.3,26,54,48.15,21,35,60,13,33,46,19,6,4,4,22
215,SAS,1,48,47,100,47,7,29,24.1,40,71,56.34,22,28,78.6,17,39,56,28,13,11,5,20
216,CLE,1,48,37,83,44.6,13,41,31.7,24,42,57.14,20,23,87,6,35,41,26,15,11,4,13
217,MEM,1,48,43,92,46.7,12,30,40,31,62,50,25,35,71.4,13,39,52,26,14,11,3,21
218,CHI,0,48,34,79,43,6,23,26.1,28,56,50,30,33,90.9,6,41,47,16,14,6,3,24
219,SAC,0,48,37,81,45.7,12,35,34.3,25,46,54.35,14,18,77.8,5,27,32,21,14,6,2,12
220,CHA,0,48,44,93,47.3,13,42,31,31,51,60.78,8,12,66.7,8,32,40,33,15,11,3,21
221,BKN,0,48,43,97,44.3,7,34,20.6,36,63,57.14,17,26,65.4,14,36,50,30,11,9,11,20
222,PHX,1,48,45,87,51.7,13,27,48.1,32,60,53.33,11,17,64.7,5,35,40,24,13,5,5,21
223,LAL,0,48,42,80,52.5,14,35,40,28,45,62.22,10,16,62.5,7,32,39,26,15,5,2,20
224,NYK,1,48,34,85,40,13,41,31.7,21,44,47.73,23,29,79.3,13,38,51,19,14,8,8,16
225,DET,0,48,39,85,45.9,8,29,27.6,31,56,55.36,16,18,88.9,9,28,37,23,10,8,5,21
226,DAL,1,48,40,77,51.9,17,34,50,23,43,53.49,17,24,70.8,10,35,45,21,10,3,2,13
227,WAS,1,48,44,84,52.4,16,28,57.1,28,56,50,19,22,86.4,5,37,42,33,12,5,8,24
228,PHI,0,48,37,89,41.6,10,36,27.8,27,53,50.94,20,26,76.9,12,33,45,22,12,6,4,19
229,MIN,0,48,45,84,53.6,14,32,43.8,31,52,59.62,8,12,66.7,4,26,30,26,14,7,3,21
230,CHA,1,48,42,98,42.9,17,32,53.1,25,66,37.88,18,23,78.3,17,36,53,26,12,6,2,22
231,BOS,1,48,49,87,56.3,17,39,43.6,32,48,66.67,19,21,90.5,10,35,45,27,13,7,5,20
232,UTA,0,48,41,89,46.1,12,34,35.3,29,55,52.73,6,10,60,7,29,36,23,6,5,1,20
233,GSW,0,48,38,89,42.7,8,33,24.2,30,56,53.57,31,39,79.5,13,33,46,20,10,8,2,24
234,NOP,1,48,44,91,48.4,9,27,33.3,35,64,54.69,19,24,79.2,12,29,41,25,7,10,1,13
235,SAS,1,48,39,92,42.4,7,26,26.9,32,66,48.48,22,25,88,16,33,49,22,10,4,6,17
236,ORL,0,53,45,106,42.5,13,36,36.1,32,70,45.71,7,7,100,15,42,57,27,13,9,3,20
237,HOU,1,48,44,84,52.4,15,35,42.9,29,49,59.18,12,18,66.7,8,30,38,34,21,12,8,14
238,TOR,1,48,51,84,60.7,15,32,46.9,36,52,69.23,14,19,73.7,9,33,42,34,6,9,3,16
239,SAC,1,53,42,98,42.9,11,36,30.6,31,62,50,19,24,79.2,18,41,59,24,14,4,4,12
240,OKC,0,48,39,84,46.4,14,36,38.9,25,48,52.08,15,16,93.8,5,31,36,29,17,8,5,19
241,DEN,1,48,41,85,48.2,8,31,25.8,33,54,61.11,23,24,95.8,10,37,47,33,15,11,5,19
242,CLE,0,48,34,82,41.5,7,31,22.6,27,51,52.94,19,27,70.4,15,31,46,17,13,7,3,23
243,MEM,1,48,49,102,48,13,37,35.1,36,65,55.38,16,23,69.6,16,38,54,30,8,10,9,19
244,IND,0,48,33,79,41.8,11,36,30.6,22,43,51.16,14,20,70,9,26,35,23,14,5,3,14
245,CHI,1,48,36,75,48,5,21,23.8,31,54,57.41,21,25,84,6,31,37,23,15,6,1,21
246,MIL,0,48,37,93,39.8,7,32,21.9,30,61,49.18,21,26,80.8,14,32,46,19,14,4,7,21
247,NOP,0,48,40,90,44.4,10,32,31.3,30,58,51.72,13,19,68.4,12,30,42,23,8,4,11,19
248,MIA,0,48,33,75,44,10,34,29.4,23,41,56.1,19,26,73.1,6,33,39,20,24,7,5,23
249,POR,0,48,37,93,39.8,12,40,30,25,53,47.17,12,17,70.6,21,30,51,21,23,14,4,19
250,BKN,1,48,39,83,47,11,33,33.3,28,50,56,21,26,80.8,11,29,40,26,17,15,5,22
251,GSW,0,48,43,90,47.8,14,41,34.1,29,49,59.18,10,13,76.9,14,33,47,27,16,4,1,22
252,DAL,0,48,35,90,38.9,10,43,23.3,25,47,53.19,15,19,78.9,10,35,45,21,11,4,5,19
253,PHI,1,48,43,92,46.7,15,35,42.9,28,57,49.12,21,24,87.5,12,40,52,23,13,12,8,18
254,MIA,0,48,35,70,50,12,33,36.4,23,37,62.16,21,25,84,8,27,35,18,15,6,3,25
255,DET,0,48,39,95,41.1,6,32,18.8,33,63,52.38,13,14,92.9,10,38,48,19,15,9,8,20
256,WAS,1,48,36,83,43.4,9,30,30,27,53,50.94,19,21,90.5,5,40,45,23,17,6,7,15
257,UTA,0,48,38,84,45.2,17,47,36.2,21,37,56.76,8,11,72.7,9,29,38,25,12,7,2,16
258,POR,0,48,43,85,50.6,3,20,15,40,65,61.54,17,23,73.9,13,25,38,28,17,6,3,21
259,MIN,1,48,43,84,51.2,11,32,34.4,32,52,61.54,19,24,79.2,6,39,45,26,9,4,2,21
260,CHA,1,48,41,88,46.6,13,34,38.2,28,54,51.85,12,17,70.6,16,29,45,26,10,7,3,17
261,HOU,1,48,43,83,51.8,19,45,42.2,24,38,63.16,20,23,87,9,28,37,27,16,12,3,22
262,ATL,1,48,46,89,51.7,14,37,37.8,32,52,61.54,15,19,78.9,12,32,44,27,12,11,4,18
263,LAC,0,48,34,85,40,8,25,32,26,60,43.33,21,25,84,9,30,39,19,16,7,7,18
264,NYK,1,48,36,82,43.9,17,50,34,19,32,59.38,22,28,78.6,17,25,42,23,11,8,2,24
265,CHI,0,48,40,78,51.3,14,34,41.2,26,44,59.09,15,19,78.9,4,29,33,25,15,5,4,24
266,DEN,0,48,48,81,59.3,15,32,46.9,33,49,67.35,19,27,70.4,10,27,37,27,17,5,2,22
267,WAS,0,48,43,92,46.7,11,38,28.9,32,54,59.26,5,9,55.6,12,29,41,25,11,9,1,17
268,NOP,1,48,41,83,49.4,12,29,41.4,29,54,53.7,32,34,94.1,10,33,43,23,11,10,2,17
269,TOR,1,48,42,89,47.2,16,37,43.2,26,52,50,17,19,89.5,13,27,40,26,9,9,5,22
270,CLE,0,48,37,79,46.8,12,30,40,25,49,51.02,18,22,81.8,9,27,36,24,13,4,3,14
271,IND,0,48,39,92,42.4,9,33,27.3,30,59,50.85,16,23,69.6,9,22,31,20,11,7,8,19
272,PHX,1,48,52,86,60.5,13,27,48.1,39,59,66.1,23,29,79.3,5,24,29,32,9,7,3,23
273,MIL,1,48,42,81,51.9,16,35,45.7,26,46,56.52,14,16,87.5,4,37,41,23,16,5,2,17
274,MEM,1,48,50,93,53.8,21,42,50,29,51,56.86,12,17,70.6,16,39,55,34,17,8,9,22
275,MIA,0,48,37,85,43.5,14,36,38.9,23,49,46.94,16,21,76.2,8,26,34,26,10,8,1,19
276,ORL,0,48,36,93,38.7,17,51,33.3,19,42,45.24,13,16,81.3,9,36,45,24,11,3,3,22
277,SAS,1,48,46,94,48.9,19,44,43.2,27,50,54,22,24,91.7,14,39,53,34,14,8,11,13
278,IND,0,48,42,91,46.2,14,36,38.9,28,55,50.91,11,11,100,10,32,42,34,15,11,3,17
279,HOU,0,48,33,82,40.2,4,28,14.3,29,54,53.7,21,28,75,12,33,45,17,16,8,5,21
280,MEM,1,48,47,101,46.5,19,38,50,28,63,44.44,19,22,86.4,16,30,46,28,13,8,7,22
281,DET,1,48,44,88,50,12,33,36.4,32,55,58.18,22,25,88,9,45,54,30,16,10,4,19
282,GSW,1,48,40,77,51.9,15,36,41.7,25,41,60.98,23,27,85.2,7,38,45,23,13,5,2,24
283,CHA,0,48,42,89,47.2,13,46,28.3,29,43,67.44,9,17,52.9,14,31,45,26,11,5,4,18
284,OKC,1,48,38,79,48.1,17,41,41.5,21,38,55.26,25,30,83.3,5,39,44,21,12,6,6,16
285,DAL,1,48,42,86,48.8,8,33,24.2,34,53,64.15,18,22,81.8,8,34,42,24,13,9,1,24
286,BOS,1,48,50,84,59.5,19,36,52.8,31,48,64.58,6,7,85.7,8,31,39,37,13,8,10,20
287,SAC,1,48,43,82,52.4,12,37,32.4,31,45,68.89,12,17,70.6,4,32,36,26,17,7,3,10
288,LAL,0,48,50,97,51.5,11,30,36.7,39,67,58.21,10,16,62.5,11,34,45,25,12,6,3,19
289,ATL,0,48,37,92,40.2,14,44,31.8,23,48,47.92,13,15,86.7,9,31,40,21,14,8,3,17
290,POR,0,48,36,94,38.3,7,26,26.9,29,68,42.65,17,18,94.4,12,31,43,18,18,5,5,21
291,PHI,1,48,47,91,51.6,10,27,37,37,64,57.81,22,28,78.6,8,35,43,26,7,7,5,13
292,NYK,1,48,43,83,51.8,20,45,44.4,23,38,60.53,15,17,88.2,6,34,40,30,9,5,3,17
293,MIN,0,48,42,95,44.2,13,43,30.2,29,52,55.77,19,22,86.4,15,30,45,27,12,5,5,21
294,PHX,1,48,45,86,52.3,12,33,36.4,33,53,62.26,23,29,79.3,11,32,43,30,13,6,9,20
295,BKN,0,48,43,87,49.4,9,25,36,34,62,54.84,25,27,92.6,10,29,39,18,14,6,10,20
296,UTA,0,48,35,88,39.8,8,36,22.2,27,52,51.92,19,21,90.5,16,24,40,13,14,8,1,14
297,DEN,1,48,45,83,54.2,16,32,50,29,51,56.86,21,23,91.3,6,34,40,31,11,4,5,19
298,LAC,0,48,42,86,48.8,10,32,31.3,32,54,59.26,21,26,80.8,6,29,35,27,6,3,7,19
299,MIL,1,48,50,82,61,12,28,42.9,38,54,70.37,14,20,70,5,48,53,26,15,4,6,12
300,GSW,0,48,34,85,40,11,32,34.4,23,53,43.4,11,16,68.8,12,36,48,21,18,6,3,23
301,ATL,1,48,40,81,49.4,15,36,41.7,25,45,55.56,22,27,81.5,10,33,43,26,14,7,5,18
302,ORL,1,48,34,79,43,10,36,27.8,24,43,55.81,16,20,80,6,33,39,25,14,9,6,14
303,CHI,0,48,39,92,42.4,13,33,39.4,26,59,44.07,7,13,53.8,5,28,33,21,7,9,4,12
304,NYK,0,48,42,86,48.8,13,34,38.2,29,52,55.77,14,26,53.8,14,27,41,20,14,12,4,23
305,LAL,1,48,53,94,56.4,12,32,37.5,41,62,66.13,13,16,81.3,9,32,41,34,8,7,3,19
306,CHA,1,48,40,79,50.6,13,37,35.1,27,42,64.29,13,15,86.7,5,30,35,34,17,5,10,19
307,OKC,0,48,48,93,51.6,17,37,45.9,31,56,55.36,10,14,71.4,10,32,42,23,11,5,4,26
308,DET,0,48,36,85,42.4,9,35,25.7,27,50,54,34,41,82.9,12,36,48,22,20,8,5,34
309,CHI,1,48,44,90,48.9,11,28,39.3,33,62,53.23,14,24,58.3,14,28,42,28,6,6,7,14
310,WAS,0,48,35,85,41.2,6,29,20.7,29,56,51.79,21,24,87.5,10,37,47,24,11,7,6,15
311,CLE,0,48,45,86,52.3,14,39,35.9,31,47,65.96,16,19,84.2,8,30,38,29,12,3,2,19
312,TOR,0,48,40,91,44,6,32,18.8,34,59,57.63,13,15,86.7,14,35,49,26,14,5,6,20
313,PHI,1,48,43,86,50,15,37,40.5,28,49,57.14,12,16,75,11,34,45,26,12,6,4,20
314,POR,1,48,37,88,42,8,28,28.6,29,60,48.33,37,49,75.5,17,30,47,22,9,15,7,26
315,DAL,1,48,40,83,48.2,14,46,30.4,26,37,70.27,16,21,76.2,7,40,47,27,12,5,3,21
316,BKN,1,48,45,83,54.2,11,30,36.7,34,53,64.15,13,15,86.7,7,34,41,31,14,5,4,19
317,UTA,0,48,37,83,44.6,14,39,35.9,23,44,52.27,18,22,81.8,11,26,37,18,14,8,7,16
318,NOP,0,48,40,90,44.4,9,24,37.5,31,66,46.97,14,16,87.5,15,32,47,23,15,9,4,16
319,MIA,0,48,38,80,47.5,10,33,30.3,28,47,59.57,20,20,100,4,30,34,23,12,6,4,16
320,HOU,1,48,42,85,49.4,20,39,51.3,22,46,47.83,11,13,84.6,6,38,44,30,13,5,8,22
321,MIN,0,48,36,91,39.6,13,36,36.1,23,55,41.82,23,29,79.3,15,35,50,21,9,9,3,18
322,BOS,1,48,44,86,51.2,15,40,37.5,29,46,63.04,29,34,85.3,6,36,42,22,9,8,7,18
323,DEN,0,48,35,87,40.2,14,39,35.9,21,48,43.75,20,25,80,13,28,41,22,11,4,3,15
324,ORL,1,48,32,83,38.6,7,31,22.6,25,52,48.08,19,24,79.2,15,45,60,22,21,11,4,17
325,GSW,0,48,41,90,45.6,11,33,33.3,30,57,52.63,15,21,71.4,20,37,57,26,15,5,1,20
326,OKC,0,48,30,92,32.6,13,48,27.1,17,44,38.64,12,18,66.7,14,33,47,19,16,13,7,24
327,POR,0,48,38,81,46.9,9,33,27.3,29,48,60.42,13,18,72.2,10,22,32,23,18,10,3,19
328,UTA,1,48,34,74,45.9,17,46,37,17,28,60.71,23,29,79.3,9,40,49,16,12,9,11,17
329,SAC,0,53,39,91,42.9,16,34,47.1,23,57,40.35,30,36,83.3,9,33,42,27,15,12,2,21
330,SAS,1,48,38,98,38.8,15,40,37.5,23,58,39.66,19,25,76,17,27,44,25,11,7,2,18
331,ATL,0,48,41,87,47.1,10,32,31.3,31,55,56.36,20,23,87,7,33,40,22,16,7,4,22
332,MEM,1,48,46,96,47.9,16,34,47.1,30,62,48.39,14,17,82.4,7,44,51,26,14,14,6,24
333,PHI,0,48,30,73,41.1,7,27,25.9,23,46,50,21,28,75,5,35,40,21,10,7,5,23
334,IND,1,48,48,84,57.1,15,35,42.9,33,49,67.35,18,21,85.7,11,30,41,38,16,10,2,19
335,BOS,1,48,47,82,57.3,19,40,47.5,28,42,66.67,11,11,100,5,33,38,29,9,4,6,18
336,TOR,1,48,35,93,37.6,7,26,26.9,28,67,41.79,16,23,69.6,20,36,56,16,9,5,4,16
337,PHX,1,53,46,92,50,12,28,42.9,34,64,53.12,23,27,85.2,10,40,50,25,18,12,5,30
338,NYK,0,48,31,83,37.3,16,40,40,15,43,34.88,15,21,71.4,10,27,37,20,11,7,2,19
339,NOP,1,48,43,96,44.8,7,21,33.3,36,75,48,24,27,88.9,18,36,54,22,16,12,1,23
340,HOU,0,48,37,86,43,10,31,32.3,27,55,49.09,14,24,58.3,5,40,45,26,17,6,3,16
341,CHA,1,48,44,88,50,20,42,47.6,24,46,52.17,21,27,77.8,10,36,46,33,9,8,8,18
342,MIN,1,48,47,92,51.1,22,47,46.8,25,45,55.56,22,26,84.6,8,36,44,30,11,12,2,19
343,MIL,0,48,43,97,44.3,19,52,36.5,24,45,53.33,14,17,82.4,14,37,51,27,14,6,4,18
344,DAL,0,48,39,89,43.8,14,38,36.8,25,51,49.02,16,20,80,12,32,44,18,15,4,4,26
345,DET,0,48,41,85,48.2,13,30,43.3,28,55,50.91,14,19,73.7,10,28,38,23,16,10,6,22
346,CLE,1,48,45,88,51.1,10,26,38.5,35,62,56.45,13,23,56.5,12,32,44,28,16,7,4,16
347,LAL,0,48,48,91,52.7,13,35,37.1,35,56,62.5,10,11,90.9,9,32,41,25,15,3,1,23
348,WAS,1,48,44,85,51.8,13,31,41.9,31,54,57.41,26,31,83.9,7,29,36,30,8,10,1,13
349,DAL,0,48,37,80,46.3,12,32,37.5,25,48,52.08,15,21,71.4,11,29,40,21,12,4,3,17
350,SAS,0,48,32,89,36,11,44,25,21,45,46.67,16,20,80,8,32,40,22,16,5,4,12
351,MIA,1,48,46,95,48.4,18,51,35.3,28,44,63.64,10,12,83.3,11,35,46,25,6,5,0,19
352,NYK,1,48,31,90,34.4,10,33,30.3,21,57,36.84,28,36,77.8,19,41,60,18,13,9,3,20
353,CLE,1,53,44,98,44.9,14,37,37.8,30,61,49.18,17,26,65.4,15,31,46,31,11,11,4,17
354,TOR,0,53,49,97,50.5,12,37,32.4,37,60,61.67,13,20,65,16,30,46,25,12,8,2,19
355,OKC,0,48,40,84,47.6,10,34,29.4,30,50,60,18,23,78.3,11,36,47,19,12,4,5,10
356,BKN,1,48,45,77,58.4,10,25,40,35,52,67.31,28,33,84.8,13,32,45,24,21,7,4,22
357,NOP,1,48,48,96,50,14,34,41.2,34,62,54.84,14,18,77.8,13,45,58,24,10,13,4,21
358,ATL,1,48,45,91,49.5,13,28,46.4,32,63,50.79,17,21,81,7,33,40,28,10,12,6,20
359,LAC,0,48,31,86,36,11,35,31.4,20,51,39.22,19,21,90.5,8,35,43,23,12,10,8,13
360,SAC,0,48,33,79,41.8,13,36,36.1,20,43,46.51,18,24,75,8,29,37,23,16,5,6,14
361,BOS,1,48,46,82,56.1,22,40,55,24,42,57.14,12,17,70.6,6,37,43,33,13,11,1,23
362,IND,1,48,47,101,46.5,14,43,32.6,33,58,56.9,13,19,68.4,16,30,46,29,13,7,4,26
363,HOU,0,48,39,79,49.4,12,27,44.4,27,52,51.92,28,32,87.5,5,37,42,24,16,9,8,19
364,UTA,1,48,47,97,48.5,16,44,36.4,31,53,58.49,11,14,78.6,15,44,59,30,12,9,5,18
365,DEN,0,53,46,92,50,10,33,30.3,36,59,61.02,14,18,77.8,13,38,51,35,19,6,3,24
366,WAS,0,48,34,79,43,13,34,38.2,21,45,46.67,16,21,76.2,3,35,38,19,13,2,6,27
367,PHX,1,48,47,84,56,11,25,44,36,59,61.02,24,26,92.3,10,39,49,23,13,5,4,20
368,POR,0,48,48,96,50,13,35,37.1,35,61,57.38,14,24,58.3,17,20,37,29,14,14,4,26
369,MEM,0,48,40,86,46.5,8,22,36.4,32,64,50,17,23,73.9,15,33,48,18,17,6,10,18
370,LAL,1,53,47,96,49,19,43,44.2,28,53,52.83,15,21,71.4,13,30,43,33,14,6,4,19
371,PHI,1,48,37,75,49.3,16,38,42.1,21,37,56.76,21,23,91.3,5,33,38,23,12,9,4,21
372,CHI,0,48,35,85,41.2,7,27,25.9,28,58,48.28,25,31,80.6,13,24,37,20,11,6,0,18
373,DET,1,48,47,94,50,20,43,46.5,27,51,52.94,20,31,64.5,10,35,45,34,9,11,3,21
374,ORL,0,48,47,97,48.5,11,30,36.7,36,67,53.73,15,21,71.4,10,35,45,24,14,3,4,21
375,SAC,0,48,46,94,48.9,16,43,37.2,30,51,58.82,18,21,85.7,7,32,39,27,15,8,5,21
376,CHI,0,48,43,91,47.3,12,34,35.3,31,57,54.39,12,17,70.6,5,32,37,28,12,10,2,22
377,GSW,0,48,32,86,37.2,11,48,22.9,21,38,55.26,13,16,81.3,7,31,38,19,8,8,4,21
378,NYK,1,48,40,80,50,16,38,42.1,24,42,57.14,32,39,82.1,9,38,47,31,11,9,8,14
379,PHI,1,48,41,79,51.9,12,32,37.5,29,47,61.7,24,28,85.7,7,32,39,24,11,6,2,25
380,POR,0,48,40,91,44,11,34,32.4,29,57,50.88,7,14,50,10,31,41,26,12,1,3,31
381,WAS,0,48,41,87,47.1,5,23,21.7,36,64,56.25,22,31,71,13,35,48,26,11,7,8,18
382,HOU,0,48,42,85,49.4,16,39,41,26,46,56.52,12,19,63.2,9,24,33,26,12,9,3,13
383,OKC,0,48,43,82,52.4,13,35,37.1,30,47,63.83,21,29,72.4,10,37,47,24,19,11,1,18
384,LAL,0,48,39,93,41.9,10,44,22.7,29,49,59.18,16,23,69.6,13,25,38,23,14,7,4,25
385,ATL,0,48,40,93,43,13,37,35.1,27,56,48.21,13,14,92.9,12,31,43,28,13,6,2,23
386,BKN,0,48,45,91,49.5,9,26,34.6,36,65,55.38,12,15,80,19,26,45,28,11,2,2,21
387,TOR,1,48,38,83,45.8,11,32,34.4,27,51,52.94,16,21,76.2,13,30,43,14,11,5,1,12
388,PHX,1,48,53,95,55.8,13,33,39.4,40,62,64.52,10,13,76.9,13,36,49,32,11,5,4,18
389,DEN,1,48,46,90,51.1,15,37,40.5,31,53,58.49,20,21,95.2,8,33,41,30,10,7,3,25
390,LAC,0,48,38,78,48.7,11,30,36.7,27,48,56.25,13,15,86.7,10,31,41,27,14,7,2,15
391,DAL,1,48,41,83,49.4,12,34,35.3,29,49,59.18,19,19,100,9,28,37,21,11,5,2,17
392,SAS,1,48,43,98,43.9,19,41,46.3,24,57,42.11,17,20,85,15,33,48,31,12,10,2,18
393,CLE,0,48,39,80,48.8,9,28,32.1,30,52,57.69,27,32,84.4,8,31,39,25,9,9,4,17
394,BOS,1,48,38,81,46.9,15,40,37.5,23,41,56.1,19,22,86.4,8,45,53,23,10,4,4,15
395,MIL,1,48,47,89,52.8,18,35,51.4,29,54,53.7,23,32,71.9,8,39,47,21,13,12,3,19
396,CHA,1,48,43,87,49.4,11,35,31.4,32,52,61.54,19,23,82.6,11,32,43,30,9,8,8,18
397,MIN,1,48,40,90,44.4,17,42,40.5,23,48,47.92,27,31,87.1,15,36,51,22,17,7,6,23
398,UTA,1,48,42,83,50.6,19,39,48.7,23,44,52.27,22,29,75.9,10,37,47,20,17,8,6,18
399,MIA,1,48,29,72,40.3,12,33,36.4,17,39,43.59,35,39,89.7,7,37,44,20,13,1,1,21
400,IND,0,48,41,98,41.8,6,30,20,35,68,51.47,14,19,73.7,16,33,49,23,19,4,3,21
401,NOP,0,48,43,86,50,12,34,35.3,31,52,59.62,17,24,70.8,13,32,45,29,17,7,4,19
402,MEM,1,48,54,105,51.4,15,40,37.5,39,65,60,12,20,60,18,33,51,38,10,11,11,16
403,ORL,0,48,36,95,37.9,15,41,36.6,21,54,38.89,21,27,77.8,11,26,37,25,12,2,4,25
404,DET,0,48,37,80,46.3,10,34,29.4,27,46,58.7,14,22,63.6,6,33,39,23,13,6,5,30
405,BKN,1,48,53,88,60.2,16,27,59.3,37,61,60.66,28,34,82.4,7,41,48,35,13,9,4,23
406,PHX,1,48,49,90,54.4,18,34,52.9,31,56,55.36,15,15,100,6,28,34,35,9,9,2,22
407,WAS,0,48,42,82,51.2,10,26,38.5,32,56,57.14,18,23,78.3,5,30,35,28,12,7,1,18
408,TOR,1,48,39,96,40.6,10,37,27,29,59,49.15,26,36,72.2,19,45,64,24,13,8,9,20
409,DEN,1,48,44,82,53.7,13,33,39.4,31,49,63.27,13,20,65,6,36,42,29,14,8,3,24
410,MIL,1,48,40,86,46.5,12,31,38.7,28,55,50.91,25,29,86.2,6,36,42,21,14,10,3,19
411,POR,0,48,44,88,50,10,24,41.7,34,64,53.12,15,21,71.4,11,45,56,25,21,4,9,25
412,OKC,0,48,42,90,46.7,16,44,36.4,26,46,56.52,16,19,84.2,13,36,49,31,18,4,3,19
413,UTA,0,48,37,93,39.8,17,48,35.4,20,45,44.44,20,24,83.3,13,32,45,21,14,7,4,23
414,SAS,0,48,52,97,53.6,13,35,37.1,39,62,62.9,22,26,84.6,9,27,36,33,15,5,11,24
415,GSW,1,48,45,84,53.6,18,45,40,27,39,69.23,18,22,81.8,6,38,44,26,13,7,4,21
416,PHI,0,48,36,84,42.9,12,33,36.4,24,51,47.06,26,32,81.3,11,37,48,25,13,8,6,17
417,CHI,0,48,36,88,40.9,10,34,29.4,26,54,48.15,21,22,95.5,9,31,40,22,15,5,5,20
418,CHA,1,48,49,91,53.8,20,35,57.1,29,56,51.79,16,21,76.2,8,29,37,33,6,12,7,17
419,ATL,1,48,40,109,36.7,12,48,25,28,61,45.9,30,32,93.8,17,32,49,28,4,13,6,15
420,SAC,1,48,39,82,47.6,10,25,40,29,57,50.88,24,26,92.3,7,38,45,25,16,10,3,21
421,LAL,0,48,34,87,39.1,13,42,31,21,45,46.67,22,29,75.9,9,34,43,20,13,7,7,27
422,CLE,1,53,41,86,47.7,15,30,50,26,56,46.43,23,32,71.9,12,37,49,28,12,7,4,19
423,LAC,0,53,43,98,43.9,12,36,33.3,31,62,50,13,17,76.5,12,31,43,29,11,5,8,24
424,MIN,1,48,52,90,57.8,17,33,51.5,35,57,61.4,28,32,87.5,7,33,40,28,16,8,3,20
425,LAL,0,48,36,81,44.4,16,40,40,20,41,48.78,23,31,74.2,7,30,37,24,19,4,2,14
426,BOS,0,48,33,88,37.5,9,37,24.3,24,51,47.06,17,19,89.5,11,34,45,16,11,8,3,12
427,NOP,1,48,48,93,51.6,10,32,31.3,38,61,62.3,24,34,70.6,14,31,45,30,11,17,3,20
428,ORL,0,53,41,91,45.1,18,43,41.9,23,48,47.92,14,20,70,8,42,50,28,12,7,7,27
429,OKC,0,48,41,97,42.3,13,41,31.7,28,56,50,23,28,82.1,14,30,44,25,11,7,8,21
430,BKN,1,48,44,89,49.4,6,29,20.7,38,60,63.33,16,22,72.7,12,27,39,30,14,11,3,19
431,PHX,1,48,58,102,56.9,12,33,36.4,46,69,66.67,12,14,85.7,14,37,51,36,11,12,5,24
432,MEM,1,48,48,102,47.1,11,29,37.9,37,73,50.68,18,20,90,20,37,57,30,13,8,5,20
433,ATL,1,48,46,84,54.8,17,38,44.7,29,46,63.04,22,24,91.7,9,27,36,27,12,9,3,21
434,NYK,0,48,39,83,47,11,29,37.9,28,54,51.85,18,21,85.7,11,29,40,27,17,8,5,21
435,DET,0,48,36,80,45,12,29,41.4,24,51,47.06,18,20,90,8,36,44,23,10,3,4,18
436,PHI,1,53,35,92,38,14,37,37.8,21,55,38.18,32,37,86.5,10,35,45,21,8,7,3,17
437,LAC,1,48,40,89,44.9,10,30,33.3,30,59,50.85,16,20,80,11,35,46,25,6,5,3,15
438,IND,0,48,46,89,51.7,15,35,42.9,31,54,57.41,21,26,80.8,15,28,43,23,15,7,4,21
439,HOU,0,48,39,77,50.6,12,31,38.7,27,46,58.7,15,25,60,9,30,39,24,25,3,4,26
440,DAL,1,48,33,74,44.6,15,37,40.5,18,37,48.65,14,19,73.7,4,38,42,20,18,7,5,16
441,GSW,1,48,45,93,48.4,18,45,40,27,48,56.25,14,15,93.3,12,43,55,33,12,3,7,19
442,UTA,1,48,48,86,55.8,16,41,39,32,45,71.11,22,31,71,10,34,44,21,10,4,5,20
443,TOR,1,48,48,102,47.1,12,31,38.7,36,71,50.7,19,25,76,23,27,50,28,8,12,6,23
444,POR,1,48,48,93,51.6,11,30,36.7,37,63,58.73,20,22,90.9,12,31,43,21,11,10,3,21
445,DEN,0,48,43,78,55.1,11,27,40.7,32,51,62.75,18,24,75,9,30,39,32,19,4,5,23
446,IND,1,48,45,92,48.9,14,36,38.9,31,56,55.36,15,15,100,9,38,47,23,13,6,10,20
447,WAS,0,48,39,83,47,14,34,41.2,25,49,51.02,26,27,96.3,9,26,35,26,15,7,8,16
448,CLE,0,48,36,86,41.9,5,24,20.8,31,62,50,14,17,82.4,5,35,40,19,14,7,4,19
449,MIL,0,48,38,92,41.3,17,44,38.6,21,48,43.75,16,23,69.6,8,31,39,27,5,8,2,16
450,MIA,0,48,35,88,39.8,15,45,33.3,20,43,46.51,19,25,76,11,42,53,23,18,7,1,24
451,SAC,0,48,47,94,50,13,33,39.4,34,61,55.74,18,21,85.7,8,25,33,27,7,6,3,20
452,SAS,0,48,42,102,41.2,11,34,32.4,31,68,45.59,13,16,81.3,15,37,52,28,12,6,3,15
453,MIN,1,48,35,83,42.2,15,42,35.7,20,41,48.78,28,32,87.5,6,40,46,21,15,12,5,19
454,CHI,1,48,39,88,44.3,9,21,42.9,30,67,44.78,14,15,93.3,8,38,46,20,14,12,5,18
455,ATL,1,48,43,90,47.8,9,31,29,34,59,57.63,17,19,89.5,15,32,47,28,10,5,3,19
456,CLE,0,48,35,79,44.3,8,25,32,27,54,50,27,29,93.1,7,33,40,25,18,5,2,23
457,WAS,0,48,39,85,45.9,9,27,33.3,30,58,51.72,22,33,66.7,14,33,47,21,11,6,6,18
458,DET,0,48,35,83,42.2,10,34,29.4,25,49,51.02,23,24,95.8,11,31,42,21,14,4,4,22
459,NOP,0,48,43,86,50,15,39,38.5,28,47,59.57,19,25,76,13,27,40,31,17,9,2,21
460,MIN,0,48,41,90,45.6,15,45,33.3,26,45,57.78,13,13,100,5,32,37,24,9,8,5,24
461,ORL,1,48,40,86,46.5,16,40,40,24,46,52.17,22,25,88,10,39,49,31,12,4,3,11
462,NYK,0,48,38,90,42.2,10,25,40,28,65,43.08,28,37,75.7,15,39,54,23,16,8,6,31
463,MIA,1,48,41,86,47.7,11,35,31.4,30,51,58.82,24,27,88.9,8,34,42,28,9,9,6,26
464,CHA,1,48,52,87,59.8,22,47,46.8,30,40,75,16,20,80,6,32,38,41,14,11,1,23
465,DAL,1,48,40,88,45.5,11,36,30.6,29,52,55.77,22,28,78.6,12,35,47,20,14,6,8,21
466,LAL,1,48,48,91,52.7,14,31,45.2,34,60,56.67,12,17,70.6,7,30,37,25,9,5,3,25
467,LAC,0,48,40,82,48.8,12,32,37.5,28,50,56,14,17,82.4,6,30,36,22,12,7,3,20
468,MEM,1,48,46,104,44.2,9,26,34.6,37,78,47.44,17,29,58.6,19,35,54,23,10,8,16,27
469,SAS,1,48,34,85,40,6,29,20.7,28,56,50,30,43,69.8,14,40,54,15,13,8,6,20
470,TOR,1,48,42,94,44.7,14,32,43.8,28,62,45.16,19,21,90.5,12,36,48,19,17,11,4,19
471,UTA,0,48,37,92,40.2,13,40,32.5,24,52,46.15,15,23,65.2,16,41,57,20,17,10,8,26
472,PHX,0,48,44,88,50,11,36,30.6,33,52,63.46,13,17,76.5,5,35,40,27,16,7,8,23
473,BOS,1,48,42,90,46.7,6,32,18.8,36,58,62.07,24,30,80,13,34,47,23,9,10,3,19
474,HOU,0,48,41,86,47.7,6,30,20,35,56,62.5,12,19,63.2,5,34,39,29,13,9,3,23
475,DEN,0,48,35,84,41.7,7,31,22.6,28,53,52.83,25,32,78.1,12,37,49,19,13,5,6,20
476,GSW,1,48,42,88,47.7,14,42,33.3,28,46,60.87,15,20,75,8,28,36,26,8,9,4,25
477,BKN,1,48,51,91,56,18,40,45,33,51,64.71,9,17,52.9,10,35,45,29,12,13,15,22
478,PHI,0,48,30,93,32.3,14,36,38.9,16,57,28.07,26,30,86.7,17,33,50,19,20,5,5,19
479,ORL,1,48,36,76,47.4,14,37,37.8,22,39,56.41,22,26,84.6,7,38,45,25,19,4,1,20
480,UTA,1,48,42,81,51.9,17,46,37,25,35,71.43,22,27,81.5,6,44,50,31,9,3,5,23
481,SAC,0,48,38,85,44.7,12,34,35.3,26,51,50.98,12,18,66.7,8,30,38,24,16,11,5,22
482,LAL,0,53,47,101,46.5,18,47,38.3,29,54,53.7,18,26,69.2,12,36,48,25,16,10,7,21
483,ATL,0,48,43,86,50,11,38,28.9,32,48,66.67,18,22,81.8,7,37,44,26,9,6,3,20
484,DET,0,48,42,82,51.2,11,31,35.5,31,51,60.78,13,17,76.5,5,27,32,25,16,6,3,25
485,PHX,1,48,45,99,45.5,11,37,29.7,34,62,54.84,10,10,100,14,41,55,26,15,8,5,18
486,POR,0,48,29,89,32.6,9,36,25,20,53,37.74,18,22,81.8,9,27,36,19,10,4,2,23
487,DAL,0,48,27,86,31.4,6,44,13.6,21,42,50,17,25,68,12,25,37,11,8,3,4,24
488,LAC,1,48,43,86,50,16,32,50,27,54,50,13,13,100,7,34,41,21,12,6,10,15
489,OKC,0,48,36,87,41.4,14,43,32.6,22,44,50,16,24,66.7,9,33,42,26,16,8,0,18
490,NYK,1,48,36,84,42.9,9,34,26.5,27,50,54,26,33,78.8,14,41,55,20,13,3,3,25
491,SAS,0,48,38,84,45.2,9,32,28.1,29,52,55.77,19,20,95,7,29,36,24,14,5,4,18
492,NOP,0,48,41,93,44.1,7,31,22.6,34,62,54.84,13,18,72.2,10,31,41,23,11,11,2,22
493,DEN,1,48,40,82,48.8,9,35,25.7,31,47,65.96,17,19,89.5,10,41,51,26,20,11,3,20
494,MIL,1,48,47,94,50,12,35,34.3,35,59,59.32,18,23,78.3,11,39,50,24,9,7,2,19
495,MIA,0,48,35,88,39.8,10,33,30.3,25,55,45.45,10,13,76.9,6,32,38,27,15,8,5,9
496,TOR,1,48,41,85,48.2,11,30,36.7,30,55,54.55,26,28,92.9,13,34,47,12,10,7,1,23
497,MIN,1,48,45,86,52.3,22,52,42.3,23,34,67.65,20,26,76.9,6,42,48,34,14,10,5,18
498,WAS,0,48,41,87,47.1,10,27,37,31,60,51.67,17,20,85,9,32,41,26,13,10,3,13
499,BOS,1,48,46,93,49.5,12,37,32.4,34,56,60.71,11,14,78.6,16,31,47,30,11,10,8,20
500,CHA,0,48,36,85,42.4,8,33,24.2,28,52,53.85,21,28,75,15,31,46,18,16,8,7,15
501,CHI,1,48,40,76,52.6,3,15,20,37,61,60.66,31,35,88.6,2,31,33,19,11,13,0,15
502,HOU,1,53,52,102,51,17,40,42.5,35,62,56.45,18,19,94.7,10,40,50,25,20,7,4,21
503,OKC,0,48,42,84,50,16,39,41,26,45,57.78,15,21,71.4,6,30,36,26,16,6,5,20
504,PHX,1,48,35,92,38,13,37,35.1,22,55,40,19,23,82.6,7,45,52,24,10,7,6,20
505,MEM,1,48,48,101,47.5,16,44,36.4,32,57,56.14,20,24,83.3,15,37,52,30,12,8,6,20
506,ORL,0,48,35,92,38,7,39,17.9,28,53,52.83,22,25,88,8,45,53,17,12,6,2,20
507,NOP,0,48,41,88,46.6,11,34,32.4,30,54,55.56,18,27,66.7,12,33,45,24,15,9,3,18
508,MIL,1,48,53,100,53,20,40,50,33,60,55,16,20,80,16,37,53,35,13,10,4,18
509,BKN,1,48,46,82,56.1,18,35,51.4,28,47,59.57,22,29,75.9,6,32,38,33,16,8,4,20
510,IND,0,48,49,91,53.8,16,32,50,33,59,55.93,10,15,66.7,11,27,38,35,18,6,7,20
511,GSW,1,48,44,92,47.8,13,34,38.2,31,58,53.45,11,13,84.6,10,41,51,33,16,8,6,20
512,LAC,0,48,33,93,35.5,12,39,30.8,21,54,38.89,19,23,82.6,12,35,47,23,13,12,3,12
513,CHA,0,48,45,92,48.9,13,41,31.7,32,51,62.75,18,22,81.8,10,31,41,26,15,12,3,24
514,CLE,1,48,47,94,50,9,32,28.1,38,62,61.29,24,27,88.9,14,26,40,25,8,13,6,16
515,MIN,1,48,38,92,41.3,13,43,30.2,25,49,51.02,35,44,79.5,19,48,67,21,22,10,9,25
516,SAC,0,48,39,80,48.8,11,32,34.4,28,48,58.33,26,36,72.2,4,36,40,23,12,4,2,16
517,DAL,1,48,39,88,44.3,17,46,37,22,42,52.38,16,20,80,9,34,43,19,9,9,5,21
518,ATL,0,53,42,93,45.2,11,38,28.9,31,55,56.36,15,22,68.2,13,35,48,28,14,3,6,25
519,POR,0,48,23,83,27.7,7,28,25,16,55,29.09,28,38,73.7,8,34,42,11,18,10,5,30
520,SAS,1,48,46,84,54.8,9,26,34.6,37,58,63.79,16,30,53.3,12,35,47,28,18,6,7,18
521,PHI,1,48,41,84,48.8,12,30,40,29,54,53.7,27,34,79.4,8,30,38,29,10,5,5,19
522,HOU,0,48,39,88,44.3,13,43,30.2,26,45,57.78,15,22,68.2,9,24,33,22,11,8,7,24
523,UTA,0,48,36,83,43.4,12,31,38.7,24,52,46.15,19,24,79.2,12,33,45,22,14,5,6,20
524,GSW,0,48,45,88,51.1,17,40,42.5,28,48,58.33,17,23,73.9,9,32,41,29,14,5,0,30
525,DEN,1,48,46,84,54.8,10,32,31.3,36,52,69.23,29,41,70.7,7,34,41,39,9,8,5,25
526,CHI,0,48,39,87,44.8,8,24,33.3,31,63,49.21,20,26,76.9,14,34,48,22,13,5,4,24
527,MIA,1,48,49,91,53.8,14,31,45.2,35,60,58.33,11,14,78.6,13,37,50,26,15,3,4,17
528,NYK,1,48,47,92,51.1,18,42,42.9,29,50,58,19,23,82.6,9,38,47,19,9,7,6,31
529,DET,1,53,43,93,46.2,12,33,36.4,31,60,51.67,15,23,65.2,15,32,47,27,14,7,2,27
530,LAL,0,48,43,91,47.3,8,26,30.8,35,65,53.85,16,23,69.6,12,31,43,19,15,7,3,26
531,LAC,0,48,33,88,37.5,11,34,32.4,22,54,40.74,16,22,72.7,9,34,43,17,10,2,5,23
532,DEN,1,53,47,87,54,10,33,30.3,37,54,68.52,34,43,79.1,10,37,47,32,15,7,8,26
533,TOR,0,48,37,94,39.4,6,24,25,31,70,44.29,16,26,61.5,14,31,45,17,7,13,3,20
534,MEM,0,48,44,97,45.4,5,26,19.2,39,71,54.93,19,27,70.4,12,28,40,27,11,12,8,27
535,PHX,0,48,50,93,53.8,14,31,45.2,36,62,58.06,8,11,72.7,6,21,27,33,11,8,4,20
536,BKN,0,48,45,89,50.6,12,27,44.4,33,62,53.23,18,20,90,12,33,45,24,16,6,4,26
537,NOP,0,53,48,101,47.5,14,33,42.4,34,68,50,20,29,69,14,35,49,30,14,9,4,30
538,UTA,1,48,40,89,44.9,23,52,44.2,17,37,45.95,13,17,76.5,11,37,48,27,11,4,4,21
539,WAS,1,48,45,86,52.3,17,42,40.5,28,44,63.64,26,32,81.3,5,31,36,33,6,6,4,16
540,HOU,1,48,43,82,52.4,13,34,38.2,30,48,62.5,24,36,66.7,8,37,45,23,17,4,5,22
541,MIL,1,48,47,87,54,15,32,46.9,32,55,58.18,23,29,79.3,14,34,48,31,15,9,6,19
542,NYK,1,48,42,89,47.2,13,29,44.8,29,60,48.33,19,30,63.3,15,42,57,19,10,4,5,18
543,BOS,1,48,40,83,48.2,17,36,47.2,23,47,48.94,29,38,76.3,10,27,37,25,10,9,7,19
544,OKC,0,48,39,92,42.4,8,40,20,31,52,59.62,17,19,89.5,11,36,47,20,8,11,9,19
545,IND,0,48,44,85,51.8,10,31,32.3,34,54,62.96,25,29,86.2,7,35,42,28,10,3,5,22
546,CLE,1,48,39,85,45.9,11,36,30.6,28,49,57.14,15,23,65.2,15,43,58,24,19,5,7,22
547,PHI,0,48,28,82,34.1,7,41,17.1,21,41,51.22,19,23,82.6,13,28,41,13,12,9,4,17
548,LAL,1,48,44,89,49.4,18,41,43.9,26,48,54.17,18,21,85.7,12,35,47,25,20,10,6,18
549,DAL,1,48,40,84,47.6,14,36,38.9,26,48,54.17,20,27,74.1,10,29,39,22,10,7,2,22
550,MEM,1,48,46,92,50,14,34,41.2,32,58,55.17,18,27,66.7,6,49,55,25,8,7,4,14
551,GSW,0,48,46,92,50,15,34,44.1,31,58,53.45,9,19,47.4,10,31,41,22,16,11,4,20
552,SAC,0,48,46,94,48.9,9,25,36,37,69,53.62,12,18,66.7,10,35,45,24,16,5,1,28
553,ORL,0,48,37,86,43,11,35,31.4,26,51,50.98,11,16,68.8,1,40,41,25,12,7,5,20
554,MIN,1,48,48,85,56.5,15,37,40.5,33,48,68.75,24,29,82.8,9,33,42,36,11,10,7,21
555,SAS,0,48,45,98,45.9,11,37,29.7,34,61,55.74,16,20,80,13,38,51,28,10,7,6,18
556,POR,0,48,40,85,47.1,16,38,42.1,24,47,51.06,25,30,83.3,11,30,41,24,16,5,1,23
557,CHA,1,48,42,91,46.2,16,42,38.1,26,49,53.06,23,29,79.3,11,39,50,29,9,8,5,16
558,MIA,1,48,35,72,48.6,13,28,46.4,22,44,50,16,19,84.2,6,32,38,20,14,6,3,19
559,NYK,0,48,40,86,46.5,13,29,44.8,27,57,47.37,21,30,70,12,37,49,23,14,7,5,22
560,PHX,1,48,38,85,44.7,17,34,50,21,51,41.18,22,27,81.5,3,30,33,28,10,7,3,22
561,PHI,1,48,41,75,54.7,14,33,42.4,27,42,64.29,29,32,90.6,3,27,30,23,12,8,3,24
562,OKC,0,48,37,86,43,9,35,25.7,28,51,54.9,18,21,85.7,8,31,39,19,23,12,4,16
563,DET,1,48,42,94,44.7,15,30,50,27,64,42.19,12,18,66.7,19,33,52,28,13,5,9,22
564,MIL,1,48,43,88,48.9,10,31,32.3,33,57,57.89,22,33,66.7,12,38,50,20,14,5,5,18
565,ATL,1,48,38,91,41.8,13,36,36.1,25,55,45.45,28,34,82.4,13,26,39,18,4,6,5,16
566,HOU,0,48,38,83,45.8,10,36,27.8,28,47,59.57,15,22,68.2,9,35,44,25,15,4,3,21
567,MIN,1,48,49,91,53.8,22,47,46.8,27,44,61.36,18,23,78.3,7,34,41,35,18,17,7,17
568,CHI,0,48,47,94,50,10,26,38.5,37,68,54.41,8,11,72.7,5,35,40,25,12,5,2,23
569,ORL,1,48,36,95,37.9,11,37,29.7,25,58,43.1,20,21,95.2,12,43,55,24,11,5,4,18
570,UTA,0,48,31,89,34.8,11,41,26.8,20,48,41.67,17,26,65.4,22,30,52,15,21,7,2,14
571,NOP,1,48,50,97,51.5,11,36,30.6,39,61,63.93,13,17,76.5,15,37,52,29,11,11,5,23
572,CLE,0,48,44,82,53.7,10,28,35.7,34,54,62.96,21,24,87.5,10,31,41,30,12,5,4,22
573,DEN,1,48,39,86,45.3,13,33,39.4,26,53,49.06,25,31,80.6,10,31,41,27,10,10,4,21
574,TOR,0,48,37,93,39.8,12,37,32.4,25,56,44.64,11,17,64.7,12,42,54,22,12,2,8,18
575,IND,0,48,39,100,39,10,40,25,29,60,48.33,18,28,64.3,21,34,55,24,14,4,9,16
576,WAS,0,48,46,85,54.1,14,29,48.3,32,56,57.14,8,9,88.9,7,34,41,37,14,2,7,29
577,SAS,0,48,46,93,49.5,12,32,37.5,34,61,55.74,8,16,50,6,34,40,28,11,8,5,24
578,LAL,0,48,41,84,48.8,12,35,34.3,29,49,59.18,17,22,77.3,9,27,36,26,14,8,4,17
579,MEM,0,48,42,99,42.4,13,40,32.5,29,59,49.15,10,13,76.9,17,27,44,24,7,10,4,16
580,SAC,1,48,39,85,45.9,10,32,31.3,29,53,54.72,27,32,84.4,9,40,49,26,14,6,2,13
581,BKN,0,48,39,83,47,12,31,38.7,27,52,51.92,17,22,77.3,7,23,30,24,13,5,5,24
582,LAC,1,48,51,93,54.8,17,27,63,34,66,51.52,13,15,86.7,13,33,46,32,12,10,3,22
583,TOR,0,48,36,83,43.4,7,26,26.9,29,57,50.88,27,36,75,14,27,41,12,10,5,4,22
584,BOS,1,48,46,89,51.7,16,37,43.2,30,52,57.69,12,15,80,15,36,51,33,14,4,7,15
585,DET,1,48,38,84,45.2,11,37,29.7,27,47,57.45,21,28,75,11,31,42,25,10,4,5,29
586,GSW,0,48,44,81,54.3,15,30,50,29,51,56.86,10,13,76.9,10,27,37,26,15,7,5,19
587,CHI,0,48,52,88,59.1,14,26,53.8,38,62,61.29,6,7,85.7,5,27,32,30,14,5,2,19
588,MIA,1,48,40,77,51.9,10,30,33.3,30,47,63.83,23,28,82.1,5,30,35,27,15,8,6,22
589,DAL,1,48,45,85,52.9,17,37,45.9,28,48,58.33,15,20,75,8,24,32,29,10,7,1,16
590,ATL,1,48,44,84,52.4,18,40,45,26,44,59.09,24,28,85.7,8,25,33,26,6,7,3,15
591,IND,1,53,41,94,43.6,12,37,32.4,29,57,50.88,28,35,80,14,40,54,23,18,12,7,19
592,PHI,1,48,39,75,52,17,36,47.2,22,39,56.41,28,33,84.8,5,38,43,24,14,2,8,25
593,UTA,1,53,50,91,54.9,15,42,35.7,35,49,71.43,17,24,70.8,11,38,49,32,19,12,2,24
594,NYK,0,48,39,91,42.9,8,28,28.6,31,63,49.21,22,32,68.8,10,30,40,20,10,9,3,25
595,MIL,1,48,41,91,45.1,14,36,38.9,27,55,49.09,24,27,88.9,11,41,52,22,12,7,3,16
596,HOU,0,53,43,86,50,21,51,41.2,22,35,62.86,20,30,66.7,5,29,34,27,17,12,3,25
597,ORL,0,53,44,97,45.4,10,32,31.3,34,65,52.31,16,20,80,12,40,52,22,20,12,5,28
598,DEN,0,48,40,90,44.4,12,46,26.1,28,44,63.64,15,17,88.2,10,37,47,25,16,11,2,19
599,OKC,1,48,44,87,50.6,16,29,55.2,28,58,48.28,15,21,71.4,9,41,50,24,15,11,6,15
600,POR,0,48,30,78,38.5,11,31,35.5,19,47,40.43,19,25,76,5,30,35,22,19,10,2,23
601,MIA,0,48,44,97,45.4,21,44,47.7,23,53,43.4,10,12,83.3,9,39,48,28,12,9,4,22
602,CLE,0,48,37,79,46.8,10,31,32.3,27,48,56.25,14,21,66.7,4,33,37,21,14,6,1,18
603,CHA,1,48,43,85,50.6,17,38,44.7,26,47,55.32,16,22,72.7,9,36,45,32,12,10,5,21
604,NOP,1,48,52,88,59.1,11,29,37.9,41,59,69.49,10,12,83.3,7,43,50,30,16,5,5,23
605,PHX,1,48,40,80,50,14,36,38.9,26,44,59.09,26,31,83.9,7,39,46,32,16,14,6,21
606,SAC,0,48,35,89,39.3,8,35,22.9,27,54,50,17,25,68,12,26,38,20,11,9,4,19
607,GSW,0,48,41,90,45.6,13,45,28.9,28,45,62.22,19,22,86.4,8,32,40,26,17,11,3,25
608,TOR,1,48,41,90,45.6,7,23,30.4,34,67,50.75,20,23,87,16,32,48,27,13,5,2,19
609,LAC,1,48,42,96,43.8,13,31,41.9,29,65,44.62,16,17,94.1,17,38,55,24,16,7,8,19
610,HOU,0,48,38,96,39.6,13,39,33.3,25,57,43.86,11,17,64.7,14,31,45,21,14,8,6,18
611,BOS,1,48,39,83,47,11,35,31.4,28,48,58.33,18,19,94.7,11,36,47,27,14,4,8,20
612,BKN,0,48,42,84,50,10,25,40,32,59,54.24,14,19,73.7,7,30,37,21,12,3,5,21
613,MIN,1,48,47,89,52.8,16,40,40,31,49,63.27,19,23,82.6,6,36,42,27,16,10,2,20
614,WAS,1,48,41,82,50,13,26,50,28,56,50,21,26,80.8,12,30,42,29,15,6,8,22
615,LAL,0,48,37,82,45.1,14,34,41.2,23,48,47.92,16,20,80,4,33,37,22,12,8,6,20
616,ATL,0,48,36,83,43.4,7,31,22.6,29,52,55.77,19,24,79.2,5,32,37,15,10,8,4,20
617,DAL,1,48,41,82,50,10,35,28.6,31,47,65.96,17,27,63,10,35,45,24,14,8,7,19
618,DET,0,48,43,90,47.8,8,27,29.6,35,63,55.56,19,23,82.6,14,29,43,23,12,9,3,21
619,MEM,1,48,48,89,53.9,11,26,42.3,37,63,58.73,11,19,57.9,13,42,55,24,18,5,6,18
620,SAS,0,48,41,99,41.4,9,32,28.1,32,67,47.76,14,19,73.7,12,26,38,30,9,13,3,18
621,CHI,0,48,41,84,48.8,7,29,24.1,34,55,61.82,10,15,66.7,5,33,38,23,16,9,4,24
622,OKC,0,48,40,86,46.5,11,35,31.4,29,51,56.86,19,27,70.4,7,31,38,28,17,12,5,26
623,MIA,1,48,40,81,49.4,12,31,38.7,28,50,56,20,26,76.9,9,30,39,28,14,8,5,18
624,CLE,0,48,39,74,52.7,15,37,40.5,24,37,64.86,29,34,85.3,10,28,38,29,22,5,3,17
625,CHA,0,48,36,93,38.7,14,39,35.9,22,54,40.74,20,32,62.5,9,31,40,22,9,6,1,27
626,ORL,1,48,45,96,46.9,12,37,32.4,33,59,55.93,17,22,77.3,10,29,39,29,11,10,2,19
627,MIN,1,48,47,86,54.7,18,42,42.9,29,44,65.91,15,19,78.9,8,23,31,30,13,12,6,31
628,SAC,1,48,49,87,56.3,10,31,32.3,39,56,69.64,23,30,76.7,11,35,46,30,17,10,6,25
629,MIL,1,48,40,91,44,18,45,40,22,46,47.83,32,37,86.5,17,45,62,25,13,4,5,28
630,TOR,1,48,51,99,51.5,18,38,47.4,33,61,54.1,13,22,59.1,16,31,47,35,13,17,5,20
631,IND,0,48,35,72,48.6,15,36,41.7,20,36,55.56,18,25,72,4,35,39,22,22,4,6,18
632,BKN,0,48,33,86,38.4,12,35,34.3,21,51,41.18,19,24,79.2,14,31,45,23,23,4,5,20
633,DAL,1,48,39,78,50,13,34,38.2,26,44,59.09,16,20,80,6,39,45,16,18,5,7,18
634,NYK,0,48,38,85,44.7,11,33,33.3,27,52,51.92,22,35,62.9,12,35,47,21,18,6,2,24
635,LAL,0,48,35,84,41.7,7,34,20.6,28,50,56,18,20,90,7,31,38,15,23,8,7,18
636,LAC,1,48,34,77,44.2,11,34,32.4,23,43,53.49,20,28,71.4,10,49,59,18,18,4,12,22
637,DET,1,53,50,110,45.5,14,40,35,36,70,51.43,13,18,72.2,22,32,54,30,15,10,3,29
638,BOS,0,48,39,91,42.9,12,43,27.9,27,48,56.25,17,20,85,12,28,40,25,10,5,9,13
639,PHX,0,48,44,86,51.2,13,28,46.4,31,58,53.45,13,16,81.3,10,26,36,24,9,7,5,19
640,IND,1,48,47,90,52.2,17,33,51.5,30,57,52.63,17,20,85,10,39,49,25,14,7,5,23
641,NOP,1,48,47,92,51.1,13,30,43.3,34,62,54.84,16,25,64,12,39,51,29,15,16,3,19
642,UTA,1,48,44,94,46.8,17,40,42.5,27,54,50,13,20,65,14,27,41,23,10,7,6,16
643,GSW,0,48,39,91,42.9,11,39,28.2,28,52,53.85,12,20,60,12,32,44,27,11,15,2,23
644,DEN,1,48,44,86,51.2,12,37,32.4,32,49,65.31,24,31,77.4,8,47,55,28,15,9,5,20
645,CHA,0,53,45,89,50.6,13,31,41.9,32,58,55.17,23,34,67.6,12,34,46,25,17,8,8,19
646,HOU,0,48,35,92,38,17,42,40.5,18,50,36,11,18,61.1,6,31,37,26,7,8,0,21
647,POR,0,48,34,91,37.4,6,36,16.7,28,55,50.91,18,26,69.2,11,31,42,22,15,12,3,25
648,PHI,1,48,38,78,48.7,10,33,30.3,28,45,62.22,39,44,88.6,5,38,43,28,10,13,5,26
649,SAS,0,48,50,90,55.6,14,31,45.2,36,59,61.02,15,19,78.9,12,34,46,33,22,5,1,31
650,TOR,0,48,38,95,40,10,32,31.3,28,63,44.44,14,19,73.7,11,31,42,25,13,5,2,26
651,MIA,1,48,47,83,56.6,12,28,42.9,35,55,63.64,27,38,71.1,4,28,32,25,12,8,3,20
652,ATL,1,48,48,83,57.8,13,31,41.9,35,52,67.31,18,22,81.8,5,40,45,27,12,8,8,19
653,SAC,0,48,38,89,42.7,9,30,30,29,59,49.15,25,33,75.8,9,36,45,24,13,4,3,25
654,MEM,1,48,44,100,44,7,23,30.4,37,77,48.05,21,26,80.8,19,42,61,23,14,5,10,24
655,BOS,1,48,42,88,47.7,10,26,38.5,32,62,51.61,19,21,90.5,10,27,37,31,10,5,6,21
656,CHI,0,48,39,93,41.9,9,20,45,30,73,41.1,23,30,76.7,6,35,41,17,10,9,3,17
657,DET,0,48,39,87,44.8,7,27,25.9,32,60,53.33,19,22,86.4,10,31,41,18,14,4,4,22
658,DEN,1,48,38,82,46.3,16,43,37.2,22,39,56.41,23,29,79.3,4,41,45,29,15,5,2,25
659,WAS,0,48,35,81,43.2,11,23,47.8,24,58,41.38,5,6,83.3,7,35,42,19,18,8,7,24
660,CLE,1,48,32,83,38.6,8,25,32,24,58,41.38,20,24,83.3,13,36,49,22,14,9,5,10
661,BKN,1,48,44,92,47.8,13,34,38.2,31,58,53.45,25,33,75.8,12,28,40,24,9,7,5,24
662,MIL,0,48,41,78,52.6,16,38,42.1,25,40,62.5,25,38,65.8,4,39,43,24,15,4,0,26
663,IND,0,53,49,101,48.5,14,37,37.8,35,64,54.69,13,22,59.1,12,39,51,31,14,8,11,19
664,CHA,1,48,52,94,55.3,15,40,37.5,37,54,68.52,6,9,66.7,13,39,52,34,18,10,7,20
665,PHX,0,48,36,82,43.9,12,40,30,24,42,57.14,18,24,75,7,30,37,23,14,6,8,27
666,MIA,1,48,39,83,47,11,32,34.4,28,51,54.9,26,35,74.3,4,40,44,22,10,13,5,28
667,LAL,0,48,39,93,41.9,8,31,25.8,31,62,50,16,21,76.2,13,34,47,18,12,8,7,17
668,WAS,0,58,59,108,54.6,16,38,42.1,43,70,61.43,19,24,79.2,11,28,39,36,16,10,5,29
669,SAS,1,58,57,105,54.3,9,29,31,48,76,63.16,34,43,79.1,16,34,50,35,17,6,3,22
670,MIN,0,48,36,86,41.9,9,39,23.1,27,47,57.45,21,25,84,9,32,41,23,16,4,1,27
671,UTA,1,48,40,74,54.1,16,38,42.1,24,36,66.67,18,22,81.8,9,35,44,22,18,9,4,14
672,LAC,1,48,41,83,49.4,10,26,38.5,31,57,54.39,13,19,68.4,7,40,47,25,17,8,8,19
673,NYK,0,48,30,75,40,14,40,35,16,35,45.71,26,36,72.2,5,40,45,19,18,4,1,30
674,ORL,1,48,42,83,50.6,13,36,36.1,29,47,61.7,22,29,75.9,10,44,54,20,19,7,4,22
675,OKC,1,53,50,101,49.5,11,31,35.5,39,70,55.71,18,24,75,11,43,54,23,11,8,3,19
676,HOU,0,48,44,94,46.8,14,47,29.8,30,47,63.83,9,20,45,10,31,41,22,13,12,3,24
677,TOR,0,48,37,84,44,6,23,26.1,31,61,50.82,13,23,56.5,10,26,36,18,17,6,4,12
678,DAL,0,48,42,88,47.7,17,39,43.6,25,49,51.02,8,8,100,8,22,30,22,12,9,3,21
679,NOP,1,48,38,87,43.7,8,29,27.6,30,58,51.72,33,41,80.5,16,37,53,21,11,10,4,18
680,PHI,1,48,42,82,51.2,19,39,48.7,23,43,53.49,30,36,83.3,6,36,42,30,12,10,0,23
681,MEM,0,48,38,98,38.8,9,31,29,29,67,43.28,29,40,72.5,26,33,59,25,16,9,7,21
682,BKN,0,48,39,94,41.5,7,29,24.1,32,65,49.23,21,28,75,8,30,38,25,11,8,4,16
683,PHX,1,48,46,86,53.5,13,34,38.2,33,52,63.46,19,21,90.5,3,40,43,32,16,14,6,12
684,SAC,0,48,43,86,50,9,29,31,34,57,59.65,15,18,83.3,6,28,34,25,15,5,8,17
685,POR,0,48,31,79,39.2,9,35,25.7,22,44,50,24,29,82.8,6,25,31,16,18,5,4,29
686,CHI,1,48,41,84,48.8,8,27,29.6,33,57,57.89,22,27,81.5,6,37,43,16,9,5,8,20
687,ATL,0,48,41,97,42.3,8,28,28.6,33,69,47.83,18,27,66.7,13,32,45,20,10,2,3,18
688,BOS,1,48,46,85,54.1,17,42,40.5,29,43,67.44,20,27,74.1,8,40,48,28,14,9,3,20
689,GSW,1,48,45,88,51.1,15,41,36.6,30,47,63.83,27,32,84.4,10,36,46,36,12,10,7,23
690,MIN,1,48,43,93,46.2,16,42,38.1,27,51,52.94,17,25,68,12,30,42,26,12,6,11,27
691,OKC,0,48,44,93,47.3,6,31,19.4,38,62,61.29,10,11,90.9,7,35,42,22,16,10,4,19
692,DET,1,48,35,86,40.7,11,34,32.4,24,52,46.15,25,28,89.3,13,36,49,23,11,8,8,24
693,DEN,1,48,48,86,55.8,15,35,42.9,33,51,64.71,17,20,85,3,36,39,30,17,12,4,24
694,CLE,0,48,34,77,44.2,12,35,34.3,22,42,52.38,23,34,67.6,8,35,43,20,12,3,7,21
695,LAC,1,48,51,92,55.4,18,35,51.4,33,57,57.89,22,26,84.6,12,38,50,34,18,12,5,16
696,DAL,1,48,44,82,53.7,19,40,47.5,25,42,59.52,18,25,72,7,31,38,18,9,5,4,22
697,NOP,0,48,46,92,50,12,28,42.9,34,64,53.12,14,21,66.7,17,31,48,22,13,7,0,18
698,MIA,1,58,41,102,40.2,14,48,29.2,27,54,50,15,23,65.2,15,41,56,31,15,4,5,23
699,HOU,0,48,42,91,46.2,13,37,35.1,29,54,53.7,14,19,73.7,12,23,35,29,19,8,2,20
700,CHA,0,58,38,95,40,10,42,23.8,28,53,52.83,21,30,70,17,41,58,27,18,6,4,28
701,PHI,1,48,44,88,50,12,34,35.3,32,54,59.26,23,27,85.2,9,37,46,21,12,2,2,23
702,MIL,0,48,42,95,44.2,14,44,31.8,28,51,54.9,22,28,78.6,12,32,44,20,7,5,1,22
703,BKN,0,48,36,89,40.4,14,38,36.8,22,51,43.14,17,24,70.8,15,27,42,19,16,6,5,20
704,WAS,1,48,46,83,55.4,12,24,50,34,59,57.63,13,16,81.3,8,30,38,26,16,10,7,21
705,SAC,0,48,43,84,51.2,12,30,40,31,54,57.41,20,22,90.9,7,29,36,24,13,9,3,14
706,GSW,0,48,45,87,51.7,10,34,29.4,35,53,66.04,16,24,66.7,8,29,37,26,11,13,5,21
707,MEM,0,48,37,85,43.5,11,30,36.7,26,55,47.27,34,42,81,10,29,39,20,10,10,7,26
708,BOS,0,48,42,77,54.5,13,32,40.6,29,45,64.44,14,18,77.8,2,28,30,29,17,8,6,14
709,ATL,1,48,45,90,50,18,33,54.5,27,57,47.37,22,28,78.6,13,34,47,23,11,7,6,20
710,PHX,1,48,44,86,51.2,7,24,29.2,37,62,59.68,29,36,80.6,7,35,42,27,11,10,7,20
711,NYK,0,48,37,85,43.5,16,43,37.2,21,42,50,16,18,88.9,10,34,44,22,10,7,9,17
712,LAL,1,48,41,86,47.7,10,36,27.8,31,50,62,14,22,63.6,12,32,44,24,12,9,7,18
713,UTA,0,48,37,79,46.8,11,33,33.3,26,46,56.52,16,19,84.2,8,33,41,17,13,11,6,22
714,TOR,1,48,40,88,45.5,8,25,32,32,63,50.79,15,19,78.9,9,39,48,21,13,7,6,21
715,SAS,1,48,43,98,43.9,10,34,29.4,33,64,51.56,18,22,81.8,14,43,57,29,14,3,7,15
716,MIN,0,48,30,77,39,10,42,23.8,20,35,57.14,21,29,72.4,6,36,42,23,17,6,7,18
717,BKN,1,48,43,98,43.9,11,34,32.4,32,64,50,14,23,60.9,16,35,51,21,9,5,1,16
718,IND,1,48,45,83,54.2,4,20,20,41,63,65.08,19,29,65.5,7,33,40,30,11,9,6,14
719,DEN,1,48,43,91,47.3,14,36,38.9,29,55,52.73,17,21,81,12,36,48,27,19,5,1,18
720,HOU,0,48,42,97,43.3,13,44,29.5,29,53,54.72,24,28,85.7,13,36,49,23,16,5,5,27
721,CHI,1,48,47,94,50,12,29,41.4,35,65,53.85,19,20,95,13,34,47,25,13,8,2,16
722,ORL,0,48,42,98,42.9,13,41,31.7,29,57,50.88,12,13,92.3,12,33,45,23,13,3,5,19
723,OKC,0,48,41,105,39,11,32,34.4,30,73,41.1,13,19,68.4,15,35,50,25,8,6,6,19
724,DET,1,48,43,93,46.2,16,30,53.3,27,63,42.86,10,13,76.9,18,29,47,28,17,9,1,17
725,POR,1,48,43,85,50.6,13,32,40.6,30,53,56.6,24,32,75,13,30,43,23,12,6,5,27
726,WAS,0,48,39,91,42.9,17,37,45.9,22,54,40.74,13,16,81.3,12,32,44,25,13,7,3,20
727,DAL,1,48,34,76,44.7,18,41,43.9,16,35,45.71,21,33,63.6,12,26,38,27,9,5,7,26
728,PHX,1,48,44,90,48.9,8,25,32,36,65,55.38,7,10,70,12,40,52,30,17,9,4,12
729,MIN,1,53,43,109,39.4,13,55,23.6,30,54,55.56,27,43,62.8,17,41,58,29,14,10,8,26
730,ATL,1,48,43,80,53.8,14,33,42.4,29,47,61.7,24,27,88.9,7,28,35,25,11,9,4,18
731,BOS,1,48,46,82,56.1,25,45,55.6,21,37,56.76,18,22,81.8,7,44,51,28,11,2,10,25
732,MIL,1,48,48,86,55.8,10,29,34.5,38,57,66.67,22,30,73.3,9,38,47,28,15,7,0,17
733,MEM,1,48,47,94,50,10,34,29.4,37,60,61.67,17,27,63,18,31,49,29,13,10,3,24
734,PHI,0,48,23,80,28.8,8,32,25,15,48,31.25,33,39,84.6,12,28,40,17,9,7,2,17
735,IND,0,48,47,93,50.5,17,41,41.5,30,52,57.69,8,19,42.1,10,31,41,32,12,8,2,23
736,MIA,0,48,35,84,41.7,7,27,25.9,28,57,49.12,22,27,81.5,15,33,48,19,12,1,2,23
737,LAC,0,48,40,97,41.2,10,35,28.6,30,62,48.39,6,9,66.7,13,33,46,26,14,11,9,12
738,NOP,0,48,44,88,50,4,26,15.4,40,62,64.52,17,20,85,11,23,34,20,15,7,5,23
739,CLE,0,48,45,88,51.1,16,41,39,29,47,61.7,10,12,83.3,14,25,39,30,13,8,3,23
740,CHA,0,53,42,102,41.2,8,33,24.2,34,69,49.28,28,37,75.7,16,46,62,31,14,9,7,30
741,GSW,0,48,39,86,45.3,16,41,39,23,45,51.11,10,13,76.9,7,31,38,23,14,7,3,18
742,HOU,0,48,35,83,42.2,12,37,32.4,23,46,50,19,28,67.9,10,23,33,23,12,5,4,20
743,SAS,0,48,44,92,47.8,6,20,30,38,72,52.78,15,21,71.4,4,29,33,28,7,9,2,15
744,SAC,0,48,31,90,34.4,9,35,25.7,22,55,40,14,18,77.8,11,32,43,12,18,8,4,17
745,OKC,1,53,48,96,50,13,34,38.2,35,62,56.45,18,27,66.7,8,38,46,28,11,9,1,19
746,BKN,1,48,43,84,51.2,9,26,34.6,34,58,58.62,14,15,93.3,6,43,49,25,18,7,5,22
747,POR,1,48,45,99,45.5,18,43,41.9,27,56,48.21,14,19,73.7,14,44,58,30,14,8,6,19
748,NOP,1,48,45,77,58.4,16,35,45.7,29,42,69.05,14,16,87.5,4,43,47,36,14,4,7,24
749,DET,0,48,32,85,37.6,8,23,34.8,24,62,38.71,22,27,81.5,13,31,44,19,12,7,3,19
750,CHI,1,48,46,88,52.3,10,24,41.7,36,64,56.25,18,21,85.7,10,43,53,25,16,3,3,19
751,NYK,0,53,45,108,41.7,15,50,30,30,58,51.72,18,22,81.8,19,37,56,28,14,8,12,25
752,DEN,1,48,42,88,47.7,16,40,40,26,48,54.17,21,23,91.3,12,40,52,25,23,7,2,18
753,LAC,1,48,48,85,56.5,15,34,44.1,33,51,64.71,8,15,53.3,6,37,43,25,12,6,3,18
754,ORL,0,48,40,91,44,11,39,28.2,29,52,55.77,20,23,87,11,31,42,24,15,16,5,19
755,UTA,1,48,49,89,55.1,18,40,45,31,49,63.27,19,22,86.4,13,40,53,34,13,6,5,22
756,MIL,0,48,38,89,42.7,13,41,31.7,25,48,52.08,18,24,75,6,37,43,18,13,8,3,18
757,WAS,1,48,40,85,47.1,9,29,31,31,56,55.36,14,18,77.8,10,35,45,21,15,8,3,16
758,TOR,0,48,29,95,30.5,8,34,23.5,21,61,34.43,24,31,77.4,19,25,44,8,8,7,3,14
759,ATL,0,48,34,93,36.6,12,38,31.6,22,55,40,15,15,100,11,37,48,18,13,6,3,22
760,BOS,1,48,36,85,42.4,11,38,28.9,25,47,53.19,22,27,81.5,12,42,54,21,12,5,6,15
761,IND,0,48,45,102,44.1,13,45,28.9,32,57,56.14,17,22,77.3,22,32,54,28,13,5,6,21
762,MIN,1,48,43,84,51.2,18,34,52.9,25,50,50,25,28,89.3,8,30,38,23,14,8,8,25
763,MIA,1,48,41,82,50,10,29,34.5,31,53,58.49,23,29,79.3,10,42,52,20,15,6,1,21
764,CLE,0,48,36,77,46.8,8,24,33.3,28,53,52.83,13,15,86.7,5,29,34,21,17,3,3,16
765,NOP,0,48,43,87,49.4,11,32,34.4,32,55,58.18,17,20,85,10,36,46,22,15,2,4,19
766,LAC,1,48,43,82,52.4,7,22,31.8,36,60,60,6,11,54.5,6,36,42,23,14,7,4,20
767,CHI,1,48,40,89,44.9,7,25,28,33,64,51.56,19,23,82.6,11,46,57,20,13,6,3,19
768,WAS,0,48,41,88,46.6,13,38,34.2,28,50,56,15,21,71.4,10,22,32,26,10,11,3,19
769,TOR,0,48,43,88,48.9,12,34,35.3,31,54,57.41,11,17,64.7,8,27,35,22,7,11,1,19
770,POR,1,48,40,84,47.6,15,40,37.5,25,44,56.82,17,20,85,9,42,51,29,17,3,2,26
771,SAC,1,48,43,76,56.6,12,28,42.9,31,48,64.58,25,29,86.2,6,36,42,27,14,4,2,20
772,MEM,1,48,47,96,49,11,33,33.3,36,63,57.14,20,33,60.6,16,41,57,31,17,11,8,26
773,OKC,0,48,34,88,38.6,11,36,30.6,23,52,44.23,22,30,73.3,7,36,43,22,8,8,10,15
774,PHI,1,48,38,79,48.1,10,22,45.5,28,57,49.12,17,21,81,8,32,40,24,13,13,5,21
775,PHX,1,48,55,105,52.4,15,34,44.1,40,71,56.34,7,10,70,7,45,52,40,7,8,2,19
776,NYK,0,48,31,81,38.3,12,39,30.8,19,42,45.24,29,34,85.3,9,32,41,19,13,6,6,24
777,CHA,0,48,39,97,40.2,14,45,31.1,25,52,48.08,26,33,78.8,18,35,53,28,17,7,6,29
778,BKN,0,48,42,93,45.2,12,40,30,30,53,56.6,15,22,68.2,9,32,41,16,8,12,2,27
779,GSW,1,48,40,90,44.4,12,38,31.6,28,52,53.85,25,34,73.5,10,40,50,24,9,4,3,24
780,DAL,0,48,35,85,41.2,15,39,38.5,20,46,43.48,12,19,63.2,13,31,44,16,14,4,0,17
781,ORL,0,48,37,87,42.5,15,41,36.6,22,46,47.83,16,24,66.7,4,40,44,25,15,2,2,9
782,LAL,0,48,41,88,46.6,11,27,40.7,30,61,49.18,22,33,66.7,12,36,48,25,9,5,6,24
783,SAS,1,48,47,93,50.5,14,37,37.8,33,56,58.93,16,19,84.2,7,27,34,26,5,9,5,19
784,DEN,1,48,39,84,46.4,14,37,37.8,25,47,53.19,18,21,85.7,12,38,50,28,18,5,3,16
785,MIN,0,48,48,96,50,13,40,32.5,35,56,62.5,13,16,81.3,7,25,32,32,9,7,4,12
786,CHI,1,48,55,87,63.2,14,31,45.2,41,56,73.21,10,13,76.9,6,37,43,32,15,6,3,15
787,SAS,1,48,50,90,55.6,18,32,56.3,32,58,55.17,18,21,85.7,5,36,41,37,14,11,4,21
788,DET,0,48,48,102,47.1,12,35,34.3,36,67,53.73,11,18,61.1,16,29,45,32,18,10,6,20
789,PHI,1,48,36,93,38.7,7,26,26.9,29,67,43.28,21,26,80.8,15,40,55,19,11,7,10,16
790,UTA,1,48,40,89,44.9,13,41,31.7,27,48,56.25,21,24,87.5,11,39,50,22,16,15,5,14
791,CLE,1,48,43,81,53.1,9,24,37.5,34,57,59.65,25,30,83.3,6,26,32,20,13,12,7,16
792,BOS,1,48,38,96,39.6,10,37,27,28,59,47.46,22,30,73.3,18,36,54,24,12,13,8,20
793,IND,0,48,42,89,47.2,18,38,47.4,24,51,47.06,11,16,68.8,9,29,38,25,23,9,4,25
794,CHA,1,48,54,97,55.7,18,42,42.9,36,55,65.45,15,23,65.2,15,36,51,36,18,13,2,22
795,ORL,0,48,37,84,44,13,35,37.1,24,49,48.98,12,16,75,9,31,40,23,18,12,5,15
796,DEN,0,48,39,90,43.3,11,44,25,28,46,60.87,13,18,72.2,12,40,52,23,21,7,6,22
797,OKC,0,48,35,90,38.9,6,35,17.1,29,55,52.73,11,12,91.7,11,41,52,21,16,6,8,21
798,ATL,0,48,47,103,45.6,14,43,32.6,33,60,55,13,15,86.7,17,32,49,28,14,10,5,18
799,MIA,1,48,39,81,48.1,10,32,31.3,29,49,59.18,24,28,85.7,11,32,43,25,14,12,4,19
800,BKN,0,48,39,84,46.4,10,29,34.5,29,55,52.73,24,28,85.7,12,30,42,19,10,6,3,21
801,DET,0,48,41,94,43.6,7,35,20,34,59,57.63,18,21,85.7,10,30,40,27,10,4,7,29
802,GSW,0,48,42,91,46.2,15,45,33.3,27,46,58.7,15,17,88.2,5,33,38,27,8,4,5,24
803,LAC,0,48,39,81,48.1,9,23,39.1,30,58,51.72,18,25,72,4,27,31,24,10,9,2,25
804,PHX,1,48,51,90,56.7,9,30,30,42,60,70,20,29,69,9,34,43,35,8,10,2,22
805,TOR,1,48,53,97,54.6,15,39,38.5,38,58,65.52,18,22,81.8,14,23,37,25,12,12,3,28
806,NYK,1,48,39,90,43.3,14,36,38.9,25,54,46.3,24,33,72.7,16,35,51,24,15,3,3,18
807,MIL,0,48,40,88,45.5,10,38,26.3,30,50,60,17,25,68,11,28,39,18,14,6,4,22
808,DAL,1,48,38,78,48.7,13,39,33.3,25,39,64.1,23,27,85.2,8,33,41,19,14,4,3,23
809,WAS,1,48,43,85,50.6,11,31,35.5,32,54,59.26,16,18,88.9,10,31,41,29,12,7,5,23
810,NOP,0,48,36,85,42.4,11,41,26.8,25,44,56.82,14,16,87.5,12,27,39,19,17,8,6,23
811,HOU,0,48,43,82,52.4,16,38,42.1,27,44,61.36,18,30,60,13,28,41,25,21,5,4,20
812,MEM,1,48,44,92,47.8,15,30,50,29,62,46.77,29,42,69,18,42,60,32,13,6,4,23
813,TOR,1,48,45,88,51.1,13,35,37.1,32,53,60.38,14,14,100,10,35,45,22,16,9,4,16
814,GSW,0,48,28,78,35.9,16,43,37.2,12,35,34.29,13,17,76.5,3,32,35,17,13,8,3,19
815,POR,1,48,42,89,47.2,10,32,31.3,32,57,56.14,13,16,81.3,11,30,41,26,11,15,3,15
816,OKC,0,48,36,87,41.4,14,47,29.8,22,40,55,12,14,85.7,14,31,45,28,18,11,4,17
817,LAL,0,48,41,74,55.4,17,37,45.9,24,37,64.86,6,13,46.2,3,35,38,29,21,7,7,15
818,CHA,0,48,40,93,43,13,43,30.2,27,50,54,16,23,69.6,11,32,43,26,9,7,1,16
819,CHI,1,48,46,82,56.1,16,33,48.5,30,49,61.22,13,19,68.4,5,35,40,27,14,4,5,17
820,MIN,0,48,44,98,44.9,16,46,34.8,28,52,53.85,15,18,83.3,6,28,34,28,10,4,6,21
821,CLE,1,48,39,82,47.6,9,21,42.9,30,61,49.18,18,24,75,10,41,51,18,15,8,2,12
822,SAC,1,48,48,93,51.6,12,30,40,36,63,57.14,24,27,88.9,11,40,51,32,14,4,7,19
823,UTA,1,48,41,89,46.1,17,51,33.3,24,38,63.16,12,17,70.6,11,41,52,26,12,3,9,16
824,SAS,0,48,38,99,38.4,8,33,24.2,30,66,45.45,8,11,72.7,15,31,46,24,13,8,4,17
825,PHI,0,48,41,89,46.1,10,32,31.3,31,57,54.39,17,18,94.4,6,38,44,24,15,7,4,22
826,MIL,1,48,52,96,54.2,15,36,41.7,37,60,61.67,12,20,60,11,31,42,31,12,10,4,24
827,BKN,0,48,38,99,38.4,10,36,27.8,28,63,44.44,5,13,38.5,15,25,40,22,14,6,4,18
828,NOP,1,48,42,80,52.5,8,32,25,34,48,70.83,18,20,90,8,35,43,27,19,10,10,29
829,HOU,0,48,32,86,37.2,13,42,31,19,44,43.18,20,31,64.5,18,29,47,19,21,8,3,23
830,ORL,1,48,44,90,48.9,19,38,50,25,52,48.08,6,8,75,10,40,50,34,15,8,7,18
831,LAC,0,48,40,89,44.9,11,31,35.5,29,58,50,18,24,75,11,29,40,25,17,8,7,17
832,MEM,1,48,53,103,51.5,9,26,34.6,44,77,57.14,20,25,80,21,34,55,26,13,12,6,18
833,DEN,1,48,46,85,54.1,16,39,41,30,46,65.22,24,31,77.4,12,40,52,31,13,5,1,18
834,DAL,1,48,40,79,50.6,18,36,50,22,43,51.16,18,23,78.3,6,41,47,24,13,10,5,18
835,IND,0,48,37,93,39.8,10,31,32.3,27,62,43.55,28,33,84.8,18,25,43,22,13,10,4,16
836,MIN,1,48,50,104,48.1,22,44,50,28,60,46.67,12,17,70.6,16,33,49,34,14,10,4,24
837,SAC,0,48,41,83,49.4,9,25,36,32,58,55.17,23,26,88.5,5,33,38,29,19,4,3,20
838,BOS,1,48,50,91,54.9,14,40,35,36,51,70.59,12,16,75,11,41,52,32,14,6,8,14
839,DET,0,48,33,87,37.9,5,30,16.7,28,57,49.12,15,22,68.2,13,32,45,20,15,5,2,24
840,PHX,1,48,43,95,45.3,6,26,23.1,37,69,53.62,22,24,91.7,11,37,48,27,8,7,5,15
841,NYK,0,48,45,101,44.6,15,43,34.9,30,58,51.72,10,12,83.3,14,27,41,25,9,9,3,25
842,LAL,0,48,44,85,51.8,10,32,31.3,34,53,64.15,18,30,60,12,29,41,28,16,7,6,20
843,ATL,1,48,52,90,57.8,17,33,51.5,35,57,61.4,12,16,75,10,33,43,36,16,8,7,26
844,POR,0,48,32,91,35.2,11,38,28.9,21,53,39.62,20,26,76.9,17,33,50,21,13,9,5,12
845,NYK,0,48,36,95,37.9,8,33,24.2,28,62,45.16,24,35,68.6,20,36,56,18,16,8,3,23
846,MIA,1,48,43,76,56.6,18,32,56.3,25,44,56.82,17,21,81,5,32,37,29,19,9,1,23
847,CHI,0,48,43,90,47.8,10,26,38.5,33,64,51.56,28,31,90.3,11,29,40,18,9,7,2,18
848,UTA,1,48,39,93,41.9,12,48,25,27,45,60,23,27,85.2,14,35,49,19,12,6,6,26
849,OKC,0,48,37,90,41.1,11,36,30.6,26,54,48.15,13,17,76.5,18,32,50,21,18,8,2,14
850,CHA,0,48,39,95,41.1,9,40,22.5,30,55,54.55,14,16,87.5,9,29,38,28,13,11,4,19
851,WAS,0,48,36,80,45,7,31,22.6,29,49,59.18,21,23,91.3,7,26,33,25,17,10,0,18
852,GSW,1,48,41,82,50,15,43,34.9,26,39,66.67,13,17,76.5,6,34,40,30,15,12,3,19
853,PHX,1,48,49,90,54.4,12,32,37.5,37,58,63.79,17,19,89.5,10,34,44,31,11,5,5,23
854,TOR,1,48,41,84,48.8,15,35,42.9,26,49,53.06,19,29,65.5,14,37,51,21,18,9,5,20
855,DET,0,48,40,95,42.1,12,32,37.5,28,63,44.44,13,19,68.4,14,33,47,28,11,6,9,22
856,DAL,1,48,38,88,43.2,16,36,44.4,22,52,42.31,11,13,84.6,12,36,48,25,16,8,5,25
857,BKN,0,48,36,87,41.4,16,41,39,20,46,43.48,16,22,72.7,8,28,36,24,10,8,9,19
858,BOS,1,48,45,99,45.5,13,46,28.3,32,53,60.38,13,14,92.9,16,39,55,29,16,9,6,17
859,ATL,0,48,37,95,38.9,5,25,20,32,70,45.71,15,16,93.8,15,35,50,21,12,7,4,18
860,PHI,1,48,45,84,53.6,12,24,50,33,60,55,17,21,81,4,34,38,29,11,5,5,17
861,CLE,1,48,34,84,40.5,11,32,34.4,23,52,44.23,19,28,67.9,16,34,50,25,11,9,5,22
862,NOP,1,48,41,77,53.2,12,29,41.4,29,48,60.42,26,36,72.2,5,28,33,29,13,12,4,23
863,MIN,1,48,42,91,46.2,17,36,47.2,25,55,45.45,17,21,81,11,40,51,27,10,6,7,19
864,LAC,0,48,40,96,41.7,18,46,39.1,22,50,44,15,16,93.8,10,34,44,26,10,6,2,20
865,CHI,0,48,39,81,48.1,7,26,26.9,32,55,58.18,23,26,88.5,6,32,38,21,8,3,4,19
866,ORL,0,48,29,81,35.8,5,26,19.2,24,55,43.64,20,21,95.2,8,32,40,17,19,8,5,16
867,MIL,1,48,48,88,54.5,19,38,50,29,50,58,22,27,81.5,7,43,50,28,10,6,4,15
868,IND,0,48,31,83,37.3,8,31,25.8,23,52,44.23,15,17,88.2,13,34,47,17,19,5,2,26
869,DEN,1,48,49,94,52.1,10,32,31.3,39,62,62.9,16,21,76.2,11,44,55,37,11,7,2,20
870,HOU,0,48,40,84,47.6,16,45,35.6,24,39,61.54,11,16,68.8,5,28,33,28,18,5,7,23
871,MIL,1,48,49,92,53.3,23,50,46,26,42,61.9,16,22,72.7,10,34,44,36,10,9,6,18
872,PHX,1,48,40,99,40.4,8,31,25.8,32,68,47.06,7,14,50,20,44,64,26,10,6,7,16
873,LAL,1,53,48,102,47.1,9,34,26.5,39,68,57.35,17,28,60.7,14,43,57,29,13,8,7,23
874,NYK,0,53,39,98,39.8,11,38,28.9,28,60,46.67,26,36,72.2,15,41,56,24,14,8,4,26
875,CHA,0,48,33,86,38.4,10,36,27.8,23,50,46,10,16,62.5,12,38,50,23,20,4,5,19
876,SAC,1,48,43,83,51.8,12,32,37.5,31,51,60.78,15,22,68.2,7,40,47,30,16,13,4,15
877,OKC,0,48,42,87,48.3,9,30,30,33,57,57.89,10,16,62.5,7,34,41,23,14,8,1,16
878,ORL,0,48,39,90,43.3,17,48,35.4,22,42,52.38,20,29,69,7,31,38,27,9,2,2,20
879,POR,0,48,41,85,48.2,14,45,31.1,27,40,67.5,12,21,57.1,9,29,38,25,16,6,6,18
880,MIA,1,48,38,91,41.8,11,32,34.4,27,59,45.76,17,18,94.4,11,38,49,27,12,14,6,17
881,WAS,0,48,30,85,35.3,5,24,20.8,25,61,40.98,15,19,78.9,8,34,42,14,9,8,4,17
882,MEM,1,48,53,105,50.5,13,39,33.3,40,66,60.61,16,22,72.7,16,46,62,33,8,6,5,21
883,CLE,1,48,36,90,40,14,35,40,22,55,40,16,20,80,15,36,51,26,12,7,0,17
884,OKC,1,48,33,87,37.9,15,42,35.7,18,45,40,15,21,71.4,13,39,52,24,15,5,6,18
885,CHI,1,48,49,90,54.4,6,26,23.1,43,64,67.19,18,23,78.3,10,33,43,30,9,5,6,17
886,DAL,1,48,39,85,45.9,10,34,29.4,29,51,56.86,19,23,82.6,11,29,40,22,11,8,0,18
887,POR,0,48,40,101,39.6,6,33,18.2,34,68,50,7,10,70,17,36,53,18,12,7,4,18
888,TOR,1,48,46,81,56.8,17,27,63,29,54,53.7,16,18,88.9,8,37,45,29,17,7,4,18
889,NOP,1,48,42,75,56,8,25,32,34,50,68,21,23,91.3,5,33,38,27,15,8,5,18
890,CHA,0,48,38,92,41.3,14,43,32.6,24,49,48.98,11,12,91.7,15,37,52,27,14,9,2,22
891,BKN,0,48,41,99,41.4,12,34,35.3,29,65,44.62,8,11,72.7,16,26,42,25,10,10,2,12
892,BOS,1,48,37,82,45.1,9,28,32.1,28,54,51.85,19,25,76,11,44,55,23,14,4,9,17
893,HOU,0,48,36,83,43.4,11,33,33.3,25,50,50,23,29,79.3,9,26,35,15,19,9,6,20
894,ATL,0,48,43,93,46.2,9,29,31,34,64,53.12,19,21,90.5,13,27,40,27,9,12,4,16
895,IND,0,48,47,95,49.5,12,27,44.4,35,68,51.47,9,9,100,10,27,37,25,13,3,3,19
896,PHI,0,48,36,70,51.4,9,27,33.3,27,43,62.79,17,23,73.9,6,30,36,23,14,5,5,22
897,DET,0,48,34,104,32.7,10,26,38.5,24,78,30.77,15,20,75,20,36,56,18,11,5,4,24
898,SAS,1,48,51,89,57.3,13,28,46.4,38,61,62.3,16,20,80,11,33,44,33,13,14,5,25
899,UTA,1,48,48,85,56.5,17,38,44.7,31,47,65.96,12,14,85.7,9,41,50,33,18,7,5,16
900,DEN,0,48,35,78,44.9,19,41,46.3,16,37,43.24,16,17,94.1,7,24,31,22,15,9,4,20
901,PHX,0,48,46,88,52.3,9,32,28.1,37,56,66.07,14,18,77.8,6,33,39,30,11,11,2,20
902,ATL,1,48,44,84,52.4,20,40,50,24,44,54.55,16,22,72.7,6,35,41,25,15,6,1,21
903,MIN,1,48,44,87,50.6,15,34,44.1,29,53,54.72,25,28,89.3,9,33,42,29,14,11,3,18
904,GSW,1,48,47,84,56,20,42,47.6,27,42,64.29,12,16,75,9,31,40,27,16,11,3,19
905,SAC,0,48,42,80,52.5,11,31,35.5,31,49,63.27,19,23,82.6,5,20,25,29,16,13,3,16
906,TOR,1,53,48,113,42.5,14,36,38.9,34,77,44.16,17,19,89.5,22,36,58,30,12,10,5,17
907,SAS,0,48,30,80,37.5,8,33,24.2,22,47,46.81,27,38,71.1,12,31,43,21,17,9,5,19
908,LAL,0,48,41,88,46.6,11,29,37.9,30,59,50.85,17,25,68,11,33,44,19,11,6,6,13
909,LAC,1,48,46,89,51.7,13,30,43.3,33,59,55.93,6,11,54.5,7,36,43,29,10,5,6,22
910,CHI,0,53,43,90,47.8,12,29,41.4,31,61,50.82,22,24,91.7,10,41,51,30,17,8,7,19
911,MIA,1,48,42,83,50.6,12,30,40,30,53,56.6,16,18,88.9,7,35,42,27,14,13,3,27
912,DET,0,48,40,91,44,15,46,32.6,25,45,55.56,22,28,78.6,13,32,45,27,16,3,6,24
913,ORL,1,48,42,95,44.2,11,35,31.4,31,60,51.67,24,26,92.3,9,43,52,29,12,5,3,21
914,POR,0,48,35,98,35.7,14,42,33.3,21,56,37.5,10,19,52.6,18,37,55,23,13,11,3,28
915,BKN,0,48,41,84,48.8,8,25,32,33,59,55.93,11,14,78.6,10,30,40,22,13,7,12,16
916,MEM,1,48,44,102,43.1,16,39,41,28,63,44.44,16,23,69.6,15,36,51,30,11,11,5,18
917,LAL,1,48,33,78,42.3,11,30,36.7,22,48,45.83,22,33,66.7,12,41,53,25,17,8,7,18
918,NYK,0,48,38,88,43.2,12,36,33.3,26,52,50,20,26,76.9,13,35,48,23,15,5,10,19
919,CHA,0,48,37,87,42.5,12,40,30,25,47,53.19,21,27,77.8,14,32,46,18,16,12,4,20
920,DEN,0,48,42,79,53.2,11,28,39.3,31,51,60.78,9,12,75,7,32,39,24,14,5,7,20
921,UTA,1,48,42,86,48.8,7,29,24.1,35,57,61.4,17,22,77.3,8,29,37,21,8,8,4,12
922,HOU,1,48,39,82,47.6,14,40,35,25,42,59.52,23,33,69.7,8,29,37,25,12,11,3,23
923,SAC,1,48,41,93,44.1,14,42,33.3,27,51,52.94,16,18,88.9,15,33,48,23,14,8,7,15
924,DAL,0,53,46,98,46.9,14,43,32.6,32,55,58.18,8,10,80,13,26,39,28,14,12,8,21
925,WAS,1,48,41,90,45.6,9,22,40.9,32,68,47.06,15,19,78.9,15,37,52,25,10,1,5,14
926,PHI,0,48,41,91,45.1,11,27,40.7,30,64,46.88,10,13,76.9,10,31,41,23,4,2,4,20
927,CLE,0,48,41,80,51.3,7,21,33.3,34,59,57.63,15,27,55.6,12,36,48,23,19,6,4,27
928,IND,0,48,44,98,44.9,14,32,43.8,30,66,45.45,16,23,69.6,7,39,46,25,8,7,1,19
929,OKC,1,53,41,86,47.7,17,37,45.9,24,49,48.98,21,25,84,14,36,50,25,20,6,8,16
930,BOS,1,48,42,82,51.2,14,36,38.9,28,46,60.87,15,17,88.2,6,36,42,31,19,9,5,21
931,TOR,1,48,39,81,48.1,12,26,46.2,27,55,49.09,20,29,69,15,28,43,20,15,9,3,24
932,SAS,0,48,46,83,55.4,16,33,48.5,30,50,60,12,17,70.6,5,29,34,33,14,7,7,17
933,WAS,0,48,36,82,43.9,12,35,34.3,24,47,51.06,14,20,70,7,33,40,22,12,4,5,16
934,CHI,1,48,46,90,51.1,11,30,36.7,35,60,58.33,23,29,79.3,11,38,49,25,10,5,6,15
935,MIA,0,48,38,78,48.7,8,30,26.7,30,48,62.5,22,25,88,10,28,38,26,17,8,1,25
936,MIL,1,48,46,92,50,12,38,31.6,34,54,62.96,8,9,88.9,8,36,44,26,9,7,2,17
937,PHX,1,48,42,76,55.3,11,31,35.5,31,45,68.89,26,31,83.9,7,30,37,26,16,8,4,19
938,BKN,0,48,40,81,49.4,16,40,40,24,41,58.54,15,21,71.4,6,27,33,25,12,7,1,27
939,ORL,0,48,46,93,49.5,14,39,35.9,32,54,59.26,9,11,81.8,3,33,36,33,9,7,4,18
940,NOP,1,48,39,89,43.8,8,28,28.6,31,61,50.82,25,28,89.3,16,30,46,24,17,8,5,17
941,DEN,0,48,38,89,42.7,14,44,31.8,24,45,53.33,25,28,89.3,10,36,46,27,12,7,4,17
942,DET,0,48,41,84,48.8,8,32,25,33,52,63.46,11,14,78.6,6,29,35,21,19,7,3,25
943,GSW,1,48,43,96,44.8,20,46,43.5,23,50,46,18,18,100,15,31,46,30,16,10,3,17
944,MIN,1,48,46,93,49.5,19,45,42.2,27,48,56.25,19,25,76,13,39,52,35,10,8,9,21
945,GSW,1,48,43,80,53.8,17,40,42.5,26,40,65,19,23,82.6,7,34,41,23,15,10,8,24
946,LAC,0,48,45,96,46.9,15,44,34.1,30,52,57.69,11,13,84.6,10,31,41,25,10,7,5,15
947,NYK,1,48,40,80,50,13,35,37.1,27,45,60,23,29,79.3,8,39,47,25,17,12,5,20
948,ATL,0,48,37,81,45.7,12,32,37.5,25,49,51.02,14,16,87.5,5,41,46,28,15,6,5,20
949,IND,1,48,50,95,52.6,14,29,48.3,36,66,54.55,8,12,66.7,11,39,50,31,12,3,5,12
950,POR,0,48,34,81,42,7,38,18.4,27,43,62.79,6,8,75,6,35,41,18,15,7,6,20
951,OKC,1,48,35,86,40.7,12,41,29.3,23,45,51.11,16,17,94.1,11,39,50,22,13,6,3,13
952,BOS,1,48,44,84,52.4,16,42,38.1,28,42,66.67,18,27,66.7,9,35,44,24,10,9,6,15
953,SAC,0,48,37,86,43,11,38,28.9,26,48,54.17,11,22,50,9,27,36,24,16,6,5,23
954,PHI,1,53,49,100,49,11,31,35.5,38,69,55.07,13,15,86.7,14,35,49,30,21,8,12,23
955,MEM,0,53,47,102,46.1,6,30,20,41,72,56.94,19,28,67.9,15,33,48,18,14,14,6,15
956,NOP,0,48,33,85,38.8,6,30,20,27,55,49.09,18,21,85.7,16,35,51,26,13,6,8,18
957,CLE,1,48,36,84,42.9,9,31,29,27,53,50.94,12,14,85.7,7,30,37,26,10,6,9,19
958,TOR,1,48,38,89,42.7,18,36,50,20,53,37.74,12,17,70.6,6,37,43,21,8,7,8,15
959,HOU,0,48,36,84,42.9,16,43,37.2,20,41,48.78,20,29,69,9,28,37,25,17,4,3,19
960,MIA,0,48,34,87,39.1,17,44,38.6,17,43,39.53,7,10,70,10,28,38,25,19,6,2,22
961,PHX,1,48,48,97,49.5,11,32,34.4,37,65,56.92,8,12,66.7,11,35,46,31,8,6,5,12
962,CLE,0,48,38,82,46.3,13,34,38.2,25,48,52.08,16,25,64,12,29,41,25,13,6,6,20
963,SAS,0,48,45,100,45,13,37,35.1,32,63,50.79,7,8,87.5,11,32,43,27,11,6,3,15
964,MIN,1,48,49,89,55.1,13,31,41.9,36,58,62.07,15,18,83.3,10,30,40,35,16,11,2,15
965,CHI,1,48,50,90,55.6,13,32,40.6,37,58,63.79,17,18,94.4,8,36,44,36,7,10,3,16
966,LAL,0,48,47,87,54,15,35,42.9,32,52,61.54,12,23,52.2,6,32,38,29,13,5,2,24
967,ORL,1,48,43,84,51.2,11,34,32.4,32,50,64,13,16,81.3,9,31,40,26,16,8,1,16
968,DEN,1,48,53,88,60.2,23,43,53.5,30,45,66.67,7,10,70,6,35,41,39,10,8,3,15
969,POR,0,48,43,83,51.8,18,39,46.2,25,44,56.82,12,16,75,5,31,36,23,12,4,3,12
970,CHA,0,48,32,98,32.7,8,34,23.5,24,64,37.5,18,27,66.7,11,33,44,24,9,8,2,15
971,MIL,0,48,37,78,47.4,10,30,33.3,27,48,56.25,16,22,72.7,6,26,32,23,15,6,3,10
972,DAL,0,48,39,81,48.1,16,38,42.1,23,43,53.49,14,18,77.8,7,33,40,22,18,9,4,19
973,ATL,1,48,49,84,58.3,10,31,32.3,39,53,73.58,21,32,65.6,8,37,45,31,12,7,0,21
974,LAC,1,48,44,84,52.4,11,28,39.3,33,56,58.93,16,19,84.2,6,54,60,23,18,5,6,23
975,DET,1,48,42,91,46.2,10,26,38.5,32,65,49.23,21,25,84,16,32,48,26,9,7,4,21
976,UTA,0,48,38,81,46.9,15,40,37.5,23,41,56.1,15,21,71.4,9,29,38,23,20,8,4,24
977,MIA,0,63,45,110,40.9,16,50,32,29,60,48.33,14,20,70,19,42,61,26,24,12,6,26
978,DAL,1,48,51,96,53.1,16,34,47.1,35,62,56.45,14,22,63.6,11,35,46,31,5,8,7,19
979,WAS,0,48,35,84,41.7,10,29,34.5,25,55,45.45,15,21,71.4,7,30,37,27,12,6,5,12
980,GSW,1,48,40,98,40.8,14,45,31.1,26,53,49.06,16,18,88.9,16,39,55,24,12,8,8,23
981,PHI,1,48,36,70,51.4,12,30,40,24,40,60,19,26,73.1,3,33,36,24,18,8,3,17
982,BOS,1,48,43,81,53.1,14,41,34.1,29,40,72.5,7,11,63.6,6,37,43,31,15,6,7,19
983,NOP,0,48,36,82,43.9,8,32,25,28,50,56,17,23,73.9,9,31,40,22,15,8,0,14
984,IND,0,48,40,91,44,9,33,27.3,31,58,53.45,16,23,69.6,10,37,47,25,11,1,7,21
985,SAC,0,48,36,82,43.9,12,35,34.3,24,47,51.06,17,20,85,10,33,43,24,13,9,2,21
986,MEM,1,48,46,100,46,13,31,41.9,33,69,47.83,10,12,83.3,21,39,60,24,9,8,10,21
987,BKN,0,48,39,98,39.8,11,28,39.3,28,70,40,17,21,81,18,34,52,21,11,7,10,15
988,TOR,1,63,47,107,43.9,16,45,35.6,31,62,50,14,18,77.8,12,41,53,24,17,15,9,22
989,ATL,1,48,41,89,46.1,12,31,38.7,29,58,50,14,20,70,9,34,43,19,12,10,11,21
990,HOU,0,48,38,79,48.1,10,41,24.4,28,38,73.68,24,31,77.4,5,33,38,25,19,6,3,22
991,BOS,0,48,30,86,34.9,7,36,19.4,23,50,46,25,27,92.6,16,36,52,15,18,5,8,25
992,ORL,1,48,41,83,49.4,12,25,48,29,58,50,25,26,96.2,8,39,47,28,17,5,7,22
993,MIN,0,48,44,90,48.9,14,39,35.9,30,51,58.82,22,27,81.5,8,30,38,20,7,7,6,26
994,LAC,0,48,41,92,44.6,9,35,25.7,32,57,56.14,23,32,71.9,9,28,37,22,13,7,3,21
995,CHI,0,48,46,88,52.3,8,30,26.7,38,58,65.52,22,26,84.6,4,33,37,22,6,5,2,16
996,UTA,0,48,37,85,43.5,17,46,37,20,39,51.28,18,21,85.7,11,26,37,20,18,10,3,16
997,DET,0,48,32,87,36.8,10,29,34.5,22,58,37.93,29,37,78.4,14,27,41,23,10,10,9,24
998,MIL,1,48,41,89,46.1,14,43,32.6,27,46,58.7,27,31,87.1,11,36,47,27,13,11,1,24
999,CHA,1,48,43,83,51.8,11,36,30.6,32,47,68.09,20,28,71.4,11,39,50,25,12,4,5,24
1000,IND,1,53,41,95,43.2,13,39,33.3,28,56,50,18,29,62.1,19,41,60,25,21,7,6,20
1001,LAL,0,48,38,91,41.8,15,40,37.5,23,51,45.1,23,32,71.9,12,32,44,19,7,7,3,23
1002,OKC,0,53,43,95,45.3,14,43,32.6,29,52,55.77,10,17,58.8,10,33,43,22,14,12,6,27
1003,POR,1,48,46,81,56.8,17,39,43.6,29,42,69.05,16,20,80,4,30,34,20,15,10,4,24
1004,NYK,0,48,39,84,46.4,14,40,35,25,44,56.82,16,28,57.1,11,34,45,21,14,6,4,23
1005,PHX,1,48,43,84,51.2,20,39,51.3,23,45,51.11,28,37,75.7,10,39,49,36,12,4,2,22
1006,MEM,1,48,46,82,56.1,9,23,39.1,37,59,62.71,18,24,75,8,34,42,27,15,9,7,19
1007,SAS,1,48,50,95,52.6,16,37,43.2,34,58,58.62,15,18,83.3,10,34,44,35,7,3,1,18
1008,NOP,0,48,35,90,38.9,5,34,14.7,30,56,53.57,30,33,90.9,14,29,43,23,13,14,4,19
1009,DEN,1,48,41,82,50,12,33,36.4,29,49,59.18,22,25,88,9,34,43,29,21,9,4,22
1010,MIA,1,48,40,85,47.1,15,34,44.1,25,51,49.02,26,27,96.3,12,39,51,28,18,6,3,23
1011,MIN,0,48,42,95,44.2,10,44,22.7,32,51,62.75,21,27,77.8,10,31,41,22,9,10,4,15
1012,GSW,1,48,44,82,53.7,21,36,58.3,23,46,50,15,21,71.4,10,37,47,31,19,8,3,23
1013,LAL,0,48,36,88,40.9,6,29,20.7,30,59,50.85,9,9,100,9,33,42,19,19,7,9,16
1014,PHI,1,48,41,82,50,13,35,37.1,28,47,59.57,10,17,58.8,3,38,41,30,15,8,5,14
1015,LAC,1,48,36,81,44.4,15,29,51.7,21,52,40.38,24,27,88.9,8,41,49,20,15,7,1,22
1016,ORL,0,48,38,84,45.2,9,35,25.7,29,49,59.18,17,22,77.3,8,31,39,29,13,9,3,23
1017,CHA,1,48,54,93,58.1,24,45,53.3,30,48,62.5,26,33,78.8,8,28,36,37,13,9,5,29
1018,POR,0,48,42,82,51.2,14,38,36.8,28,44,63.64,14,23,60.9,3,35,38,27,9,4,1,21
1019,IND,0,48,44,92,47.8,10,34,29.4,34,58,58.62,28,34,82.4,17,24,41,33,20,9,3,31
1020,UTA,0,48,34,79,43,12,30,40,22,49,44.9,17,23,73.9,8,31,39,20,16,6,4,28
1021,SAS,0,48,43,94,45.7,9,37,24.3,34,57,59.65,15,19,78.9,13,26,39,30,13,9,7,19
1022,PHX,1,48,40,82,48.8,7,18,38.9,33,64,51.56,18,27,66.7,9,35,44,14,9,6,7,20
1023,NYK,0,48,35,83,42.2,15,44,34.1,20,39,51.28,11,17,64.7,15,29,44,24,18,8,4,23
1024,DAL,1,48,48,88,54.5,16,36,44.4,32,52,61.54,20,26,76.9,6,39,45,35,9,6,6,21
1025,MEM,1,48,46,90,51.1,7,23,30.4,39,67,58.21,19,26,73.1,12,32,44,24,13,9,9,18
1026,CHI,1,48,46,84,54.8,7,26,26.9,39,58,67.24,12,16,75,10,35,45,32,15,2,1,22
1027,MIL,0,48,37,80,46.3,9,32,28.1,28,48,58.33,16,18,88.9,10,31,41,22,19,7,3,19
1028,SAC,0,48,39,93,41.9,12,40,30,27,53,50.94,14,19,73.7,10,32,42,23,12,6,3,20
1029,TOR,0,48,38,79,48.1,12,31,38.7,26,48,54.17,17,28,60.7,8,26,34,24,12,8,5,17
1030,MIA,1,48,37,74,50,16,37,43.2,21,37,56.76,20,22,90.9,7,31,38,30,20,8,3,23
1031,DEN,1,48,42,89,47.2,15,36,41.7,27,53,50.94,25,27,92.6,12,36,48,27,13,8,2,21
1032,ATL,1,48,48,90,53.3,12,36,33.3,36,54,66.67,13,17,76.5,6,42,48,29,9,9,2,18
1033,CLE,1,48,41,87,47.1,19,42,45.2,22,45,48.89,14,17,82.4,12,29,41,27,13,11,3,19
1034,BKN,0,48,43,88,48.9,12,29,41.4,31,59,52.54,20,26,76.9,6,32,38,26,12,6,3,25
1035,BOS,1,48,51,103,49.5,20,45,44.4,31,58,53.45,6,7,85.7,17,50,67,32,11,6,6,12
1036,SAC,0,48,29,95,30.5,6,33,18.2,23,62,37.1,11,15,73.3,15,30,45,15,12,7,8,14
1037,GSW,1,48,49,92,53.3,17,43,39.5,32,49,65.31,15,18,83.3,12,46,58,31,14,8,2,17
1038,LAL,1,48,42,89,47.2,12,38,31.6,30,51,58.82,10,10,100,5,28,33,23,10,12,9,19
1039,DAL,0,48,32,91,35.2,10,40,25,22,51,43.14,18,18,100,10,29,39,17,11,9,4,17
1040,SAS,1,48,58,101,57.4,12,32,37.5,46,69,66.67,6,6,100,11,38,49,38,13,8,5,22
1041,DEN,1,48,36,84,42.9,11,32,34.4,25,52,48.08,27,31,87.1,16,40,56,25,25,7,1,17
1042,TOR,1,48,43,82,52.4,16,34,47.1,27,48,56.25,23,29,79.3,7,35,42,27,17,6,7,22
1043,BKN,0,48,37,88,42,7,27,25.9,30,61,49.18,15,22,68.2,18,36,54,20,19,5,2,12
1044,PHI,1,48,39,84,46.4,10,31,32.3,29,53,54.72,29,31,93.5,14,30,44,26,11,4,8,22
1045,MIN,1,48,36,82,43.9,14,43,32.6,22,39,56.41,23,31,74.2,11,38,49,21,17,8,10,19
1046,NOP,0,48,40,83,48.2,9,22,40.9,31,61,50.82,18,26,69.2,11,28,39,26,8,5,7,25
1047,WAS,0,48,37,80,46.3,9,27,33.3,28,53,52.83,32,40,80,10,42,52,25,19,4,7,24
1048,CHA,0,48,40,82,48.8,10,31,32.3,30,51,58.82,23,32,71.9,9,28,37,25,12,7,2,20
1049,POR,0,48,37,94,39.4,16,41,39,21,53,39.62,17,20,85,15,35,50,26,14,4,2,24
1050,LAC,1,48,39,94,41.5,11,29,37.9,28,65,43.08,27,31,87.1,12,36,48,28,12,9,5,29
1051,DET,0,48,41,97,42.3,12,36,33.3,29,61,47.54,11,14,78.6,9,27,36,25,9,14,5,25
1052,HOU,0,48,39,95,41.1,9,34,26.5,30,61,49.18,17,25,68,18,27,45,21,17,8,3,12
1053,IND,0,48,38,87,43.7,19,46,41.3,19,41,46.34,18,25,72,10,31,41,26,17,5,7,28
1054,PHX,1,48,47,99,47.5,13,36,36.1,34,63,53.97,8,15,53.3,18,33,51,28,14,10,5,17
1055,NOP,1,48,41,88,46.6,6,30,20,35,58,60.34,29,31,93.5,12,33,45,23,12,7,4,22
1056,NYK,0,48,35,84,41.7,12,38,31.6,23,46,50,11,21,52.4,11,34,45,21,12,11,1,19
1057,CLE,1,48,35,81,43.2,13,36,36.1,22,45,48.89,12,20,60,12,39,51,29,20,7,1,18
1058,UTA,0,48,40,81,49.4,14,31,45.2,26,50,52,15,22,68.2,7,31,38,16,14,11,3,15
1059,CHI,1,48,41,89,46.1,15,39,38.5,26,50,52,14,19,73.7,10,41,51,31,19,7,9,23
1060,OKC,0,48,38,92,41.3,16,45,35.6,22,47,46.81,18,24,75,10,34,44,26,11,9,5,15
1061,LAC,0,48,34,79,43,14,41,34.1,20,38,52.63,20,30,66.7,6,34,40,20,12,7,6,19
1062,MEM,0,48,37,99,37.4,4,24,16.7,33,75,44,13,19,68.4,21,29,50,20,15,10,3,25
1063,GSW,1,48,36,83,43.4,13,42,31,23,41,56.1,9,10,90,10,30,40,19,10,8,5,19
1064,SAS,0,48,42,89,47.2,10,30,33.3,32,59,54.24,15,22,68.2,12,31,43,30,9,4,5,15
1065,TOR,0,48,39,98,39.8,18,54,33.3,21,44,47.73,9,14,64.3,15,28,43,28,16,15,8,18
1066,BKN,0,48,48,95,50.5,15,38,39.5,33,57,57.89,14,15,93.3,16,32,48,27,19,4,1,29
1067,DET,0,48,42,75,56,11,29,37.9,31,46,67.39,16,19,84.2,4,30,34,28,22,4,5,29
1068,LAL,0,48,36,79,45.6,11,40,27.5,25,39,64.1,24,30,80,7,31,38,20,18,7,1,20
1069,UTA,0,48,31,81,38.3,11,35,31.4,20,46,43.48,19,23,82.6,17,34,51,17,12,7,2,13
1070,CHI,0,48,33,76,43.4,5,21,23.8,28,55,50.91,24,32,75,11,33,44,10,22,3,4,22
1071,CHA,0,48,34,87,39.1,4,36,11.1,30,51,58.82,19,27,70.4,11,43,54,23,16,6,6,24
1072,POR,1,48,45,85,52.9,18,32,56.3,27,53,50.94,6,13,46.2,10,37,47,31,22,8,7,17
1073,BOS,1,48,40,90,44.4,19,39,48.7,21,51,41.18,17,21,81,11,46,57,26,13,5,3,16
1074,PHI,1,48,44,92,47.8,7,16,43.8,37,76,48.68,20,23,87,13,34,47,22,10,5,3,19
1075,ORL,1,48,42,80,52.5,12,26,46.2,30,54,55.56,18,23,78.3,3,32,35,31,14,7,8,25
1076,DAL,1,48,36,74,48.6,9,30,30,27,44,61.36,23,31,74.2,9,33,42,22,18,10,12,23
1077,ATL,1,48,40,88,45.5,15,39,38.5,25,49,51.02,18,24,75,7,38,45,25,10,12,6,22
1078,NYK,1,48,39,91,42.9,16,36,44.4,23,55,41.82,16,19,84.2,15,37,52,26,13,6,4,22
1079,MIN,1,48,48,92,52.2,14,32,43.8,34,60,56.67,26,31,83.9,10,27,37,24,9,11,7,17
1080,MIA,1,48,40,81,49.4,15,33,45.5,25,48,52.08,18,20,90,6,33,39,31,16,9,3,31
1081,WAS,0,48,33,93,35.5,8,34,23.5,25,59,42.37,13,16,81.3,9,35,44,20,7,8,6,14
1082,DEN,1,48,44,85,51.8,12,35,34.3,32,50,64,17,23,73.9,8,26,34,29,13,8,1,22
1083,MIL,1,48,45,91,49.5,21,42,50,24,49,48.98,22,25,88,9,34,43,19,7,12,0,14
1084,OKC,0,48,33,85,38.8,12,41,29.3,21,44,47.73,9,16,56.3,11,30,41,16,15,14,3,28
1085,SAC,0,48,51,97,52.6,15,37,40.5,36,60,60,10,16,62.5,13,35,48,29,14,4,2,20
1086,PHX,1,48,47,96,49,7,25,28,40,71,56.34,12,14,85.7,14,37,51,34,11,11,8,19
1087,IND,0,48,37,84,44,10,29,34.5,27,55,49.09,19,27,70.4,12,32,44,19,18,5,5,18
1088,CLE,1,48,35,76,46.1,6,27,22.2,29,49,59.18,18,35,51.4,15,39,54,22,23,5,6,20
1089,DEN,0,48,43,91,47.3,13,32,40.6,30,59,50.85,19,23,82.6,10,27,37,34,13,6,6,25
1090,BOS,0,48,37,82,45.1,11,37,29.7,26,45,57.78,20,23,87,8,34,42,25,12,7,7,24
1091,ATL,1,48,38,68,55.9,14,33,42.4,24,35,68.57,20,24,83.3,6,30,36,26,18,3,1,17
1092,POR,1,48,36,76,47.4,16,33,48.5,20,43,46.51,21,30,70,7,35,42,20,13,6,4,21
1093,TOR,1,48,42,90,46.7,11,30,36.7,31,60,51.67,14,17,82.4,11,29,40,20,8,10,4,15
1094,LAL,1,48,42,85,49.4,13,30,43.3,29,55,52.73,19,23,82.6,8,37,45,23,19,12,4,24
1095,DET,0,48,38,87,43.7,13,32,40.6,25,55,45.45,12,16,75,9,31,40,22,11,6,4,24
1096,BKN,1,48,48,100,48,9,25,36,39,75,52,12,12,100,12,41,53,24,8,3,5,17
1097,CHI,0,48,31,85,36.5,7,38,18.4,24,47,51.06,21,24,87.5,6,43,49,21,10,4,4,21
1098,WAS,0,48,43,85,50.6,11,33,33.3,32,52,61.54,8,10,80,11,34,45,29,18,3,3,16
1099,CHA,1,48,45,99,45.5,17,49,34.7,28,50,56,14,20,70,16,46,62,34,12,8,5,18
1100,OKC,0,48,37,98,37.8,12,44,27.3,25,54,46.3,12,15,80,15,37,52,20,12,6,2,21
1101,GSW,1,48,39,81,48.1,10,30,33.3,29,51,56.86,17,22,77.3,7,34,41,25,19,4,9,18
1102,ORL,0,48,36,81,44.4,11,40,27.5,25,41,60.98,22,29,75.9,3,32,35,23,18,6,9,21
1103,UTA,1,48,36,79,45.6,10,31,32.3,26,48,54.17,29,34,85.3,7,37,44,22,11,3,7,21
1104,PHI,0,48,38,91,41.8,10,28,35.7,28,63,44.44,15,21,71.4,13,31,44,23,7,7,3,17
1105,SAS,0,48,37,95,38.9,8,29,27.6,29,66,43.94,20,24,83.3,16,33,49,24,6,3,7,13
1106,MIA,0,48,41,85,48.2,15,40,37.5,26,45,57.78,11,12,91.7,11,22,33,30,15,8,1,22
1107,HOU,0,48,38,89,42.7,10,35,28.6,28,54,51.85,17,20,85,8,31,39,25,12,10,3,15
1108,LAC,1,48,40,87,46,11,32,34.4,29,55,52.73,11,15,73.3,10,39,49,21,12,5,0,21
1109,MIL,1,48,34,88,38.6,6,31,19.4,28,57,49.12,20,28,71.4,11,42,53,20,8,3,3,17
1110,MEM,1,48,43,82,52.4,11,25,44,32,57,56.14,25,40,62.5,13,35,48,19,16,11,10,24
1111,NYK,0,48,29,77,37.7,9,38,23.7,20,39,51.28,24,36,66.7,14,34,48,21,15,6,5,21
1112,PHX,1,48,39,86,45.3,8,36,22.2,31,50,62,23,25,92,5,35,40,25,7,13,1,21
1113,IND,1,53,41,95,43.2,15,35,42.9,26,60,43.33,24,34,70.6,13,35,48,23,18,12,3,23
1114,NOP,1,48,38,76,50,11,28,39.3,27,48,56.25,15,22,68.2,3,32,35,27,12,10,2,26
1115,DAL,0,48,37,85,43.5,11,37,29.7,26,48,54.17,16,20,80,10,40,50,19,19,1,3,22
1116,GSW,0,53,42,94,44.7,9,42,21.4,33,52,63.46,24,29,82.8,15,38,53,28,21,11,6,28
1117,MIN,0,48,42,97,43.3,17,46,37,25,51,49.02,21,29,72.4,16,29,45,21,13,10,3,24
1118,BKN,1,48,47,89,52.8,8,25,32,39,64,60.94,17,20,85,7,29,36,23,15,5,4,25
1119,ORL,0,48,40,90,44.4,18,35,51.4,22,55,40,12,16,75,9,34,43,26,11,4,4,19
1120,CLE,0,48,40,77,51.9,9,27,33.3,31,50,62,15,22,68.2,9,29,38,27,15,7,4,15
1121,TOR,0,48,35,91,38.5,8,32,25,27,59,45.76,20,25,80,16,28,44,17,12,11,1,21
1122,DEN,1,53,48,98,49,13,38,34.2,35,60,58.33,21,25,84,13,31,44,32,12,9,3,15
1123,MIA,1,48,37,80,46.3,12,35,34.3,25,45,55.56,18,25,72,9,34,43,24,16,12,6,15
1124,HOU,1,48,41,96,42.7,22,45,48.9,19,51,37.25,12,17,70.6,12,32,44,24,9,4,3,18
1125,MEM,0,48,44,106,41.5,9,40,22.5,35,66,53.03,17,25,68,16,31,47,26,10,10,8,20
1126,SAC,0,48,44,84,52.4,12,27,44.4,32,57,56.14,31,44,70.5,8,27,35,22,7,4,8,17
1127,ATL,1,48,45,86,52.3,15,38,39.5,30,48,62.5,29,33,87.9,8,31,39,34,12,7,9,23
1128,LAC,0,53,52,97,53.6,15,39,38.5,37,58,63.79,9,12,75,12,35,47,35,14,6,3,24
1129,IND,1,48,44,90,48.9,11,30,36.7,33,60,55,12,15,80,14,34,48,28,13,6,8,22
1130,DET,1,48,46,91,50.5,15,36,41.7,31,55,56.36,26,30,86.7,13,28,41,27,9,3,6,26
1131,BOS,0,48,39,90,43.3,14,46,30.4,25,44,56.82,10,13,76.9,8,30,38,27,14,8,3,20
1132,MIL,1,48,46,97,47.4,13,37,35.1,33,60,55,21,22,95.5,13,43,56,29,15,7,6,21
1133,WAS,0,48,41,86,47.7,10,29,34.5,31,57,54.39,26,32,81.3,13,27,40,23,13,6,8,19
1134,CHA,1,48,42,86,48.8,16,39,41,26,47,55.32,11,15,73.3,11,36,47,27,17,6,6,17
1135,OKC,0,48,38,98,38.8,8,31,25.8,30,67,44.78,12,15,80,14,32,46,20,15,5,2,14
1136,PHI,1,48,45,83,54.2,10,28,35.7,35,55,63.64,23,27,85.2,6,38,44,21,10,7,8,15
1137,POR,0,48,33,81,40.7,14,46,30.4,19,35,54.29,12,16,75,10,33,43,19,18,7,6,22
1138,SAS,1,48,47,96,49,15,40,37.5,32,56,57.14,9,14,64.3,11,39,50,32,9,9,13,17
1139,DAL,1,48,37,76,48.7,9,33,27.3,28,43,65.12,19,20,95,10,35,45,23,18,5,0,20
1140,UTA,0,48,42,89,47.2,10,38,26.3,32,51,62.75,17,20,85,11,38,49,26,9,7,5,16
1141,LAL,0,48,40,90,44.4,11,34,32.4,29,56,51.79,13,18,72.2,12,28,40,23,11,4,7,18
1142,CHI,1,48,47,86,54.7,10,22,45.5,37,64,57.81,13,18,72.2,7,30,37,25,10,7,4,18
1143,MIN,1,48,35,81,43.2,13,41,31.7,22,40,55,29,38,76.3,8,30,38,21,13,10,6,25
1144,GSW,1,48,34,83,41,14,42,33.3,20,41,48.78,20,27,74.1,13,41,54,26,13,12,3,25
1145,DET,0,48,30,85,35.3,9,34,26.5,21,51,41.18,17,24,70.8,11,39,50,18,16,4,5,23
1146,NYK,0,48,37,80,46.3,12,38,31.6,25,42,59.52,24,33,72.7,11,33,44,21,18,6,7,30
1147,NOP,0,48,36,87,41.4,9,30,30,27,57,47.37,11,18,61.1,8,33,41,23,12,10,4,15
1148,PHX,1,48,49,95,51.6,9,32,28.1,40,63,63.49,14,20,70,12,33,45,29,5,9,5,18
1149,POR,1,48,37,90,41.1,7,34,20.6,30,56,53.57,17,18,94.4,11,44,55,20,17,9,8,17
1150,CHA,1,48,36,86,41.9,14,39,35.9,22,47,46.81,11,17,64.7,6,33,39,23,7,6,2,14
1151,UTA,0,48,31,83,37.3,12,46,26.1,19,37,51.35,21,24,87.5,8,36,44,21,16,6,6,21
1152,LAC,1,48,45,82,54.9,18,36,50,27,46,58.7,31,36,86.1,8,29,37,32,13,7,7,18
1153,DAL,1,48,35,88,39.8,12,37,32.4,23,51,45.1,22,28,78.6,11,36,47,28,11,10,7,19
1154,PHI,0,48,35,86,40.7,7,26,26.9,28,60,46.67,21,25,84,10,32,42,19,12,9,3,26
1155,IND,0,48,50,97,51.5,13,33,39.4,37,64,57.81,20,23,87,15,26,41,30,12,8,4,23
1156,ATL,1,48,38,86,44.2,15,36,41.7,23,50,46,30,32,93.8,10,36,46,25,13,7,8,18
1157,MIL,0,48,39,88,44.3,16,38,42.1,23,50,46,20,24,83.3,9,33,42,21,13,8,4,28
1158,BOS,1,48,38,80,47.5,10,32,31.3,28,48,58.33,18,20,90,5,42,47,22,14,6,4,18
1159,NYK,0,48,32,80,40,12,34,35.3,20,46,43.48,11,21,52.4,14,39,53,22,15,7,4,19
1160,LAL,1,48,38,86,44.2,11,37,29.7,27,49,55.1,14,23,60.9,10,35,45,15,13,7,5,19
1161,WAS,1,48,42,87,48.3,9,30,30,33,57,57.89,24,32,75,9,40,49,25,12,7,6,18
1162,MEM,1,48,47,92,51.1,10,25,40,37,67,55.22,15,20,75,10,38,48,29,18,14,7,13
1163,ORL,0,48,34,90,37.8,8,32,25,26,58,44.83,12,20,60,10,40,50,21,16,9,7,15
1164,MIA,1,48,38,83,45.8,9,24,37.5,29,59,49.15,19,22,86.4,13,36,49,20,12,11,8,18
1165,OKC,0,48,36,83,43.4,11,35,31.4,25,48,52.08,19,24,79.2,5,37,42,20,13,10,2,23
1166,BKN,0,48,41,83,49.4,12,30,40,29,53,54.72,13,18,72.2,8,27,35,27,14,11,4,22
1167,TOR,0,48,37,90,41.1,13,36,36.1,24,54,44.44,12,17,70.6,15,30,45,24,12,9,5,21
1168,SAS,0,48,41,92,44.6,9,30,30,32,62,51.61,16,22,72.7,13,34,47,21,12,3,2,16
1169,CHI,0,48,40,92,43.5,13,31,41.9,27,61,44.26,13,15,86.7,9,34,43,24,18,10,7,15
1170,CLE,1,48,42,81,51.9,11,32,34.4,31,49,63.27,19,21,90.5,8,32,40,26,16,7,3,14
1171,HOU,1,48,41,76,53.9,16,40,40,25,36,69.44,20,24,83.3,4,43,47,22,23,6,3,20
1172,DET,0,48,38,82,46.3,9,25,36,29,57,50.88,23,34,67.6,5,27,32,25,11,6,2,20
1173,DEN,0,48,42,95,44.2,11,43,25.6,31,52,59.62,7,8,87.5,6,33,39,32,9,5,2,22
1174,GSW,0,48,32,82,39,13,42,31,19,40,47.5,22,29,75.9,7,40,47,20,15,6,3,17
1175,SAC,0,48,41,91,45.1,12,38,31.6,29,53,54.72,18,24,75,7,30,37,26,12,16,2,24
1176,MIN,1,48,45,91,49.5,16,43,37.2,29,48,60.42,13,20,65,6,41,47,30,16,8,9,21
1177,PHX,1,48,51,87,58.6,11,27,40.7,40,60,66.67,22,30,73.3,11,40,51,30,15,4,7,26
1178,UTA,1,48,44,84,52.4,15,39,38.5,29,45,64.44,22,29,75.9,9,42,51,26,9,8,5,16
1179,ORL,0,48,37,77,48.1,7,26,26.9,30,51,58.82,11,16,68.8,5,32,37,16,17,7,3,26
1180,BOS,1,48,44,90,48.9,9,26,34.6,35,64,54.69,17,19,89.5,17,33,50,27,11,6,6,15
1181,BKN,1,48,46,84,54.8,12,27,44.4,34,57,59.65,16,17,94.1,9,35,44,30,16,5,5,21
1182,MIA,0,48,33,86,38.4,9,35,25.7,24,51,47.06,23,30,76.7,12,31,43,24,10,10,4,18
1183,SAS,1,48,34,83,41,11,37,29.7,23,46,50,22,27,81.5,15,39,54,19,15,6,5,12
1184,POR,1,48,39,85,45.9,13,39,33.3,26,46,56.52,24,35,68.6,8,31,39,19,13,13,2,25
1185,MIL,0,48,26,77,33.8,12,39,30.8,14,38,36.84,32,35,91.4,9,32,41,19,13,8,8,23
1186,TOR,1,48,40,91,44,12,35,34.3,28,56,50,11,20,55,16,34,50,25,15,7,8,25
1187,CHI,0,48,44,87,50.6,12,29,41.4,32,58,55.17,12,15,80,7,25,32,31,6,3,3,19
1188,LAC,0,48,38,100,38,12,38,31.6,26,62,41.94,6,8,75,21,33,54,24,15,8,4,21
1189,OKC,0,48,36,83,43.4,10,27,37,26,56,46.43,20,22,90.9,14,37,51,17,16,4,5,21
1190,PHI,1,48,40,79,50.6,13,32,40.6,27,47,57.45,16,21,76.2,6,37,43,24,15,5,5,22
1191,ATL,0,48,40,80,50,16,44,36.4,24,36,66.67,12,17,70.6,4,27,31,23,9,5,5,20
1192,DEN,1,48,47,91,51.6,23,40,57.5,24,51,47.06,16,17,94.1,9,42,51,35,6,9,2,17
1193,NYK,1,48,42,83,50.6,13,31,41.9,29,52,55.77,20,26,76.9,11,33,44,24,11,2,0,20
1194,WAS,0,48,39,90,43.3,12,37,32.4,27,53,50.94,20,23,87,10,33,43,20,20,4,3,26
1195,CLE,1,48,40,87,46,9,35,25.7,31,52,59.62,18,25,72,11,26,37,28,9,6,4,13
1196,NOP,0,48,40,87,46,9,31,29,31,56,55.36,16,24,66.7,12,23,35,27,12,9,3,18
1197,LAL,0,48,36,82,43.9,10,30,33.3,26,52,50,14,19,73.7,8,33,41,21,11,4,3,15
1198,DAL,1,48,32,78,41,12,34,35.3,20,44,45.45,32,38,84.2,12,35,47,16,10,6,3,18
1199,SAS,0,48,42,92,45.7,15,34,44.1,27,58,46.55,10,13,76.9,10,37,47,22,15,6,5,24
1200,PHX,1,48,40,88,45.5,11,28,39.3,29,60,48.33,21,23,91.3,12,39,51,24,15,8,6,18
1201,CHA,0,48,40,97,41.2,12,42,28.6,28,55,50.91,17,21,81,11,33,44,28,17,9,5,20
1202,SAC,1,48,48,96,50,13,37,35.1,35,59,59.32,17,24,70.8,13,40,53,33,14,8,7,23
1203,DAL,1,48,47,91,51.6,8,32,25,39,59,66.1,10,16,62.5,8,44,52,30,15,8,1,19
1204,MEM,0,48,34,89,38.2,7,31,22.6,27,58,46.55,10,13,76.9,10,31,41,19,15,8,6,16
1205,MIA,1,48,41,77,53.2,14,30,46.7,27,47,57.45,28,30,93.3,9,28,37,30,16,6,5,27
1206,CLE,1,48,46,95,48.4,8,20,40,38,75,50.67,14,24,58.3,12,34,46,24,9,7,3,13
1207,TOR,0,48,28,87,32.2,11,38,28.9,17,49,34.69,20,26,76.9,16,30,46,18,11,5,4,24
1208,GSW,1,48,53,94,56.4,19,42,45.2,34,52,65.38,13,17,76.5,9,38,47,39,7,12,5,17
1209,ATL,0,48,38,79,48.1,16,38,42.1,22,41,53.66,26,30,86.7,9,25,34,26,16,6,6,27
1210,IND,0,48,34,88,38.6,13,43,30.2,21,45,46.67,13,18,72.2,9,33,42,20,12,9,7,20
1211,DET,1,48,38,81,46.9,8,27,29.6,30,54,55.56,19,23,82.6,9,34,43,22,8,7,6,25
1212,PHI,1,48,38,85,44.7,14,41,34.1,24,44,54.55,21,25,84,7,33,40,26,10,12,4,19
1213,CHI,0,48,37,87,42.5,10,38,26.3,27,49,55.1,12,18,66.7,10,26,36,26,14,4,5,19
1214,ORL,1,48,45,87,51.7,15,45,33.3,30,42,71.43,11,15,73.3,4,39,43,32,20,9,4,18
1215,BOS,0,48,37,78,47.4,11,31,35.5,26,47,55.32,14,18,77.8,7,37,44,20,20,4,4,21
1216,HOU,0,48,44,101,43.6,13,43,30.2,31,58,53.45,13,16,81.3,13,37,50,25,17,7,4,19
1217,MEM,1,48,42,92,45.7,8,32,25,34,60,56.67,24,35,68.6,16,40,56,22,14,10,7,15
1218,MIL,1,48,44,86,51.2,18,41,43.9,26,45,57.78,12,18,66.7,5,49,54,29,17,10,7,16
1219,MIN,0,48,41,96,42.7,15,48,31.3,26,48,54.17,11,14,78.6,12,34,46,23,18,4,8,26
1220,NOP,1,48,43,97,44.3,14,39,35.9,29,58,50,13,16,81.3,13,44,57,23,6,8,4,18
1221,POR,0,48,39,86,45.3,13,40,32.5,26,46,56.52,17,28,60.7,11,23,34,28,15,11,5,18
1222,LAC,0,48,31,81,38.3,10,34,29.4,21,47,44.68,17,20,85,5,41,46,19,15,2,7,16
1223,OKC,1,48,47,91,51.6,20,45,44.4,27,46,58.7,16,18,88.9,9,29,38,32,11,8,7,19
1224,GSW,0,48,33,95,34.7,16,48,33.3,17,47,36.17,17,24,70.8,12,37,49,20,15,9,2,15
1225,DEN,1,48,52,83,62.7,21,42,50,31,41,75.61,15,20,75,6,34,40,35,16,7,3,25
1226,BKN,0,48,41,98,41.8,7,32,21.9,34,66,51.52,20,22,90.9,21,29,50,16,12,7,11,19
1227,SAC,1,48,49,89,55.1,11,30,36.7,38,59,64.41,16,19,84.2,8,37,45,28,13,8,7,20
1228,BOS,1,48,40,78,51.3,18,38,47.4,22,40,55,21,25,84,7,30,37,23,13,6,5,22
1229,MIA,1,48,43,90,47.8,16,45,35.6,27,45,60,13,14,92.9,10,44,54,28,15,7,4,20
1230,BKN,1,48,49,87,56.3,17,32,53.1,32,55,58.18,23,28,82.1,7,34,41,35,10,11,4,21
1231,SAS,0,48,43,99,43.4,17,46,37,26,53,49.06,21,27,77.8,9,34,43,27,9,10,5,24
1232,WAS,1,48,43,82,52.4,10,31,32.3,33,51,64.71,16,21,76.2,6,36,42,26,10,6,4,14
1233,IND,0,48,40,86,46.5,7,36,19.4,33,50,66,13,20,65,11,26,37,27,12,6,5,24
1234,NYK,1,48,42,90,46.7,12,27,44.4,30,63,47.62,12,15,80,11,43,54,24,9,5,4,21
1235,CHA,1,48,46,89,51.7,10,34,29.4,36,55,65.45,7,8,87.5,7,35,42,29,12,9,3,21
1236,CHI,0,48,38,81,46.9,11,30,36.7,27,51,52.94,25,31,80.6,10,25,35,22,17,5,6,20
1237,ATL,0,48,31,82,37.8,13,45,28.9,18,37,48.65,16,23,69.6,6,31,37,20,14,8,3,15
1238,DAL,0,48,32,78,41,8,37,21.6,24,41,58.54,13,19,68.4,5,34,39,16,13,6,2,18
1239,ORL,0,48,41,99,41.4,11,35,31.4,30,64,46.88,13,16,81.3,18,31,49,31,9,6,6,16
1240,PHI,0,48,34,73,46.6,12,30,40,22,43,51.16,18,28,64.3,3,30,33,18,17,3,3,13
1241,HOU,1,48,45,82,54.9,16,36,44.4,29,46,63.04,22,32,68.8,4,44,48,23,14,5,7,24
1242,LAL,0,48,42,98,42.9,16,47,34,26,51,50.98,16,24,66.7,15,30,45,25,9,6,3,19
1243,CLE,1,48,43,81,53.1,11,30,36.7,32,51,62.75,14,17,82.4,7,43,50,28,15,6,3,17
1244,UTA,0,48,34,85,40,16,47,34,18,38,47.37,7,11,63.6,4,28,32,11,7,7,2,16
1245,MEM,1,48,44,100,44,14,34,41.2,30,66,45.45,14,18,77.8,11,38,49,30,11,11,8,18
1246,MIN,0,48,42,86,48.8,18,39,46.2,24,47,51.06,23,31,74.2,9,23,32,27,13,11,4,24
1247,TOR,0,48,36,89,40.4,8,37,21.6,28,52,53.85,15,25,60,22,25,47,15,16,11,3,20
1248,NOP,1,48,42,76,55.3,16,33,48.5,26,43,60.47,28,37,75.7,9,29,38,33,21,6,1,26
1249,DEN,0,48,32,80,40,4,33,12.1,28,47,59.57,17,20,85,13,43,56,24,20,4,2,19
1250,GSW,0,48,35,82,42.7,13,36,36.1,22,46,47.83,25,29,86.2,4,41,45,25,17,8,5,19
1251,OKC,0,48,47,98,48,11,39,28.2,36,59,61.02,13,15,86.7,9,32,41,23,5,5,1,20
1252,DET,0,48,30,89,33.7,6,35,17.1,24,54,44.44,21,27,77.8,15,26,41,17,18,9,7,20
1253,CHI,1,48,50,92,54.3,18,34,52.9,32,58,55.17,15,19,78.9,14,47,61,33,18,13,4,23
1254,LAC,1,48,34,84,40.5,10,34,29.4,24,50,48,9,12,75,3,28,31,23,9,12,4,22
1255,WAS,1,48,47,87,54,11,33,33.3,36,54,66.67,17,23,73.9,7,35,42,29,8,3,7,15
1256,PHX,1,48,35,74,47.3,11,32,34.4,24,42,57.14,18,22,81.8,10,29,39,25,20,10,2,23
1257,CLE,1,48,43,87,49.4,10,34,29.4,33,53,62.26,13,15,86.7,14,34,48,29,17,6,8,18
1258,MIL,0,48,37,84,44,13,43,30.2,24,41,58.54,12,16,75,7,41,48,25,20,7,2,17
1259,UTA,0,48,44,86,51.2,11,33,33.3,33,53,62.26,17,22,77.3,10,30,40,23,16,9,4,16
1260,NYK,1,48,40,82,48.8,13,32,40.6,27,50,54,18,24,75,9,40,49,23,15,7,9,22
1261,DET,1,48,48,93,51.6,19,37,51.4,29,56,51.79,11,12,91.7,9,30,39,30,12,9,7,20
1262,HOU,0,48,30,77,39,13,42,31,17,35,48.57,18,27,66.7,7,32,39,18,21,8,7,11
1263,CHA,1,48,38,96,39.6,13,44,29.5,25,52,48.08,14,16,87.5,13,35,48,23,14,12,3,16
1264,POR,1,48,40,86,46.5,15,38,39.5,25,48,52.08,19,26,73.1,11,36,47,23,15,8,9,17
1265,SAC,0,48,39,91,42.9,14,30,46.7,25,61,40.98,16,22,72.7,15,28,43,20,12,10,3,16
1266,BKN,0,48,42,91,46.2,12,32,37.5,30,59,50.85,12,15,80,12,30,42,23,15,9,6,22
1267,BOS,1,53,35,88,39.8,8,28,28.6,27,60,45,23,28,82.1,12,41,53,17,20,10,6,19
1268,IND,0,53,36,94,38.3,11,37,29.7,25,57,43.86,15,17,88.2,10,37,47,22,20,10,6,21
1269,PHI,1,48,43,94,45.7,10,35,28.6,33,59,55.93,15,18,83.3,14,33,47,23,15,14,7,21
1270,SAS,0,48,39,95,41.1,8,29,27.6,31,66,46.97,10,15,66.7,13,30,43,19,10,7,7,18
1271,LAC,1,48,44,92,47.8,12,33,36.4,32,59,54.24,6,7,85.7,13,34,47,24,13,5,4,18
1272,ATL,0,48,35,78,44.9,7,26,26.9,28,52,53.85,16,19,84.2,6,33,39,19,13,6,2,14
1273,OKC,0,48,38,88,43.2,9,38,23.7,29,50,58,10,12,83.3,11,30,41,29,9,9,7,13
1274,SAS,0,53,46,107,43,13,32,40.6,33,75,44,14,18,77.8,12,32,44,33,15,12,8,19
1275,ORL,0,48,38,95,40,9,28,32.1,29,67,43.28,15,16,93.8,9,33,42,18,8,9,6,21
1276,DEN,1,48,37,89,41.6,13,36,36.1,24,53,45.28,12,16,75,18,35,53,28,15,7,2,14
1277,TOR,1,48,36,85,42.4,14,34,41.2,22,51,43.14,19,20,95,15,31,46,18,13,8,3,20
1278,MIN,1,48,55,108,50.9,15,42,35.7,40,66,60.61,16,21,76.2,18,38,56,37,11,10,10,22
1279,GSW,1,48,39,97,40.2,10,42,23.8,29,55,52.73,8,10,80,22,32,54,24,15,16,5,20
1280,CLE,0,48,32,75,42.7,7,24,29.2,25,51,49.02,11,18,61.1,8,34,42,21,19,9,3,10
1281,WAS,1,48,36,88,40.9,11,29,37.9,25,59,42.37,19,24,79.2,12,42,54,23,13,1,6,21
1282,DAL,1,48,44,88,50,16,36,44.4,28,52,53.85,9,9,100,7,41,48,28,10,4,2,14
1283,LAL,0,48,45,97,46.4,14,33,42.4,31,64,48.44,15,19,78.9,14,27,41,26,12,6,7,25
1284,MEM,1,48,47,86,54.7,11,30,36.7,36,56,64.29,22,32,68.8,10,37,47,33,14,10,10,22
1285,CHI,0,48,39,90,43.3,11,33,33.3,28,57,49.12,10,13,76.9,8,31,39,23,7,8,3,15
1286,HOU,0,48,46,97,47.4,14,43,32.6,32,54,59.26,17,28,60.7,10,35,45,31,13,5,6,17
1287,SAC,0,48,33,85,38.8,7,31,22.6,26,54,48.15,15,21,71.4,8,38,46,20,12,8,5,17
1288,BKN,1,53,47,98,48,8,28,28.6,39,70,55.71,19,22,86.4,13,42,55,26,22,8,8,18
1289,NOP,0,48,34,75,45.3,12,33,36.4,22,42,52.38,21,25,84,7,28,35,20,13,5,5,18
1290,POR,1,48,37,88,42,17,40,42.5,20,48,41.67,12,15,80,10,38,48,26,17,6,5,23
1291,ORL,0,48,29,86,33.7,14,46,30.4,15,40,37.5,20,23,87,8,36,44,25,13,6,9,20
1292,DET,1,48,38,87,43.7,10,33,30.3,28,54,51.85,11,16,68.8,7,42,49,23,13,7,6,21
1293,BOS,1,48,36,76,47.4,12,29,41.4,24,47,51.06,15,17,88.2,9,36,45,26,12,8,8,15
1294,PHX,0,48,30,79,38,14,34,41.2,16,45,35.56,26,29,89.7,6,29,35,24,16,10,1,14
1295,IND,1,48,44,80,55,14,29,48.3,30,51,58.82,23,32,71.9,5,33,38,30,10,9,7,21
1296,NYK,0,48,29,79,36.7,11,31,35.5,18,48,37.5,6,15,40,11,29,40,13,14,8,4,15
1297,UTA,0,48,40,84,47.6,15,35,42.9,25,49,51.02,18,19,94.7,9,30,39,20,15,6,3,25
1298,LAC,0,48,39,96,40.6,10,32,31.3,29,64,45.31,20,24,83.3,14,35,49,16,13,7,6,23
1299,CHA,1,48,44,99,44.4,16,48,33.3,28,51,54.9,10,17,58.8,13,36,49,29,11,10,3,25
1300,MEM,1,48,44,100,44,12,38,31.6,32,62,51.61,23,31,74.2,16,40,56,26,10,9,11,21
1301,MIA,1,48,44,88,50,22,44,50,22,44,50,13,15,86.7,11,38,49,33,16,9,1,18
1302,MIL,0,48,35,90,38.9,12,37,32.4,23,53,43.4,24,26,92.3,14,39,53,21,15,6,4,20
1303,WAS,0,48,45,88,51.1,7,24,29.2,38,64,59.38,25,26,96.2,10,31,41,28,15,8,5,15
1304,ATL,0,48,43,96,44.8,13,36,36.1,30,60,50,19,27,70.4,13,41,54,29,15,3,0,18
1305,TOR,1,48,45,100,45,12,41,29.3,33,59,55.93,20,25,80,19,29,48,26,9,11,7,17
1306,BKN,0,48,42,92,45.7,6,27,22.2,36,65,55.38,19,20,95,14,35,49,23,11,8,5,16
1307,DAL,1,48,49,90,54.4,17,38,44.7,32,52,61.54,15,28,53.6,11,44,55,34,16,6,4,24
1308,SAC,0,48,40,92,43.5,11,29,37.9,29,63,46.03,20,24,83.3,12,35,47,21,12,6,3,19
1309,MIL,1,48,44,96,45.8,16,45,35.6,28,51,54.9,17,21,81,13,32,45,21,11,6,3,20
1310,LAL,1,48,50,101,49.5,17,41,41.5,33,60,55,17,19,89.5,8,39,47,37,8,14,4,26
1311,CLE,1,48,39,80,48.8,17,39,43.6,22,41,53.66,19,29,65.5,8,35,43,22,9,7,3,15
1312,UTA,0,48,39,81,48.1,17,38,44.7,22,43,51.16,13,18,72.2,7,33,40,23,21,3,4,21
1313,SAS,0,48,38,92,41.3,9,30,30,29,62,46.77,15,20,75,11,28,39,22,12,6,6,21
1314,HOU,0,48,37,87,42.5,12,43,27.9,25,44,56.82,20,29,69,7,33,40,17,13,6,3,20
1315,MIN,1,48,50,90,55.6,17,41,41.5,33,49,67.35,18,25,72,8,37,45,39,15,12,8,18
1316,PHI,1,48,45,87,51.7,8,23,34.8,37,64,57.81,21,27,77.8,12,37,49,28,13,7,4,18
1317,OKC,0,48,36,89,40.4,15,44,34.1,21,45,46.67,18,23,78.3,13,32,45,26,20,10,4,23
1318,DEN,1,48,47,85,55.3,12,34,35.3,35,51,68.63,15,24,62.5,5,36,41,32,8,5,7,20
1319,CHI,1,48,48,91,52.7,15,33,45.5,33,58,56.9,19,21,90.5,10,31,41,34,15,11,3,21
1320,POR,0,48,37,92,40.2,16,35,45.7,21,57,36.84,11,19,57.9,16,35,51,22,12,8,5,19
1321,MEM,1,48,48,98,49,10,32,31.3,38,66,57.58,12,19,63.2,18,43,61,31,19,8,9,18
1322,PHX,1,48,44,107,41.1,10,31,32.3,34,76,44.74,8,10,80,21,42,63,22,8,5,7,20
1323,NYK,1,48,40,90,44.4,18,36,50,22,54,40.74,10,15,66.7,11,31,42,23,11,8,1,17
1324,LAC,0,48,31,86,36,6,28,21.4,25,58,43.1,21,25,84,8,41,49,20,13,5,7,16
1325,BOS,0,48,38,80,47.5,17,45,37.8,21,35,60,12,13,92.3,8,30,38,22,13,5,10,16
1326,NOP,1,48,35,83,42.2,8,34,23.5,27,49,55.1,23,29,79.3,8,38,46,20,17,7,5,18
1327,DET,0,48,34,99,34.3,10,44,22.7,24,55,43.64,10,13,76.9,10,29,39,23,13,7,3,14
1328,GSW,0,48,37,87,42.5,7,33,21.2,30,54,55.56,15,18,83.3,8,35,43,22,14,12,6,24
1329,ATL,1,48,39,86,45.3,8,30,26.7,31,56,55.36,22,30,73.3,10,38,48,20,10,8,5,14
1330,WAS,0,48,40,91,44,10,39,25.6,30,52,57.69,21,26,80.8,9,32,41,18,15,9,6,27
1331,UTA,1,48,43,92,46.7,14,41,34.1,29,51,56.86,15,18,83.3,8,36,44,22,7,7,4,18
1332,IND,0,48,41,82,50,13,39,33.3,28,43,65.12,26,28,92.9,7,26,33,26,17,3,5,19
1333,PHI,1,48,43,85,50.6,12,28,42.9,31,57,54.39,18,24,75,10,32,42,26,17,8,4,16
1334,SAS,1,48,42,88,47.7,10,26,38.5,32,62,51.61,5,5,100,12,36,48,20,18,6,5,13
1335,DET,0,48,43,92,46.7,14,42,33.3,29,50,58,11,20,55,9,27,36,26,13,12,3,21
1336,TOR,1,48,42,89,47.2,16,36,44.4,26,53,49.06,17,25,68,10,34,44,24,15,8,4,20
1337,ORL,0,48,40,90,44.4,12,39,30.8,28,51,54.9,14,20,70,14,33,47,22,19,9,3,30
1338,DAL,1,48,33,87,37.9,12,40,30,21,47,44.68,21,26,80.8,10,36,46,22,12,6,5,15
1339,DEN,0,48,42,88,47.7,11,36,30.6,31,52,59.62,14,15,93.3,6,36,42,27,12,2,4,21
1340,SAC,0,48,38,90,42.2,11,27,40.7,27,63,42.86,15,20,75,10,37,47,15,11,6,1,20
1341,GSW,0,48,33,81,40.7,5,28,17.9,28,53,52.83,11,16,68.8,8,38,46,20,17,10,5,20
1342,MIN,1,48,36,90,40,12,44,27.3,24,46,52.17,14,20,70,15,40,55,23,16,11,7,16
1343,OKC,0,48,33,90,36.7,9,35,25.7,24,55,43.64,15,18,83.3,14,38,52,21,18,11,7,18
1344,HOU,1,48,40,85,47.1,9,26,34.6,31,59,52.54,25,32,78.1,10,38,48,15,21,10,2,24
1345,POR,0,48,33,78,42.3,15,38,39.5,18,40,45,28,36,77.8,8,28,36,18,6,8,4,23
1346,MIA,1,48,37,82,45.1,19,41,46.3,18,41,43.9,22,29,75.9,14,36,50,29,11,3,3,21
1347,MIL,0,48,38,85,44.7,17,39,43.6,21,46,45.65,18,26,69.2,9,36,45,22,18,10,8,18
1348,BOS,0,48,40,90,44.4,9,28,32.1,31,62,50,8,9,88.9,13,28,41,19,10,10,9,12
1349,CHA,1,48,48,81,59.3,24,42,57.1,24,39,61.54,20,29,69,8,41,49,39,17,6,3,21
1350,BKN,1,48,49,86,57,5,21,23.8,44,65,67.69,26,29,89.7,9,29,38,28,12,13,4,20
1351,PHX,1,48,46,85,54.1,17,31,54.8,29,54,53.7,14,20,70,5,37,42,32,11,7,5,24
1352,MEM,1,48,42,90,46.7,9,27,33.3,33,63,52.38,17,22,77.3,12,33,45,21,9,6,8,18
1353,NYK,1,48,39,80,48.8,6,28,21.4,33,52,63.46,20,28,71.4,14,37,51,17,10,6,0,23
1354,SAS,0,48,41,95,43.2,9,35,25.7,32,60,53.33,13,19,68.4,17,33,50,27,20,6,3,23
1355,SAC,0,48,43,83,51.8,14,34,41.2,29,49,59.18,14,18,77.8,9,36,45,31,18,2,3,18
1356,LAL,1,48,49,99,49.5,11,32,34.4,38,67,56.72,13,20,65,14,30,44,24,5,6,5,16
1357,NOP,0,48,36,89,40.4,10,33,30.3,26,56,46.43,28,32,87.5,15,33,48,28,12,7,3,21
1358,CLE,0,48,40,92,43.5,10,34,29.4,30,58,51.72,16,21,76.2,14,35,49,28,13,2,6,14
1359,IND,0,48,32,76,42.1,9,38,23.7,23,38,60.53,21,32,65.6,9,26,35,22,12,3,3,20
1360,TOR,1,48,45,96,46.9,18,44,40.9,27,52,51.92,21,29,72.4,16,36,52,30,12,13,8,20
1361,HOU,0,48,37,89,41.6,15,44,34.1,22,45,48.89,24,33,72.7,11,31,42,25,11,6,4,16
1362,NOP,0,48,39,97,40.2,12,46,26.1,27,51,52.94,14,22,63.6,17,30,47,21,10,7,5,21
1363,POR,1,48,47,89,52.8,18,41,43.9,29,48,60.42,24,28,85.7,12,29,41,29,10,10,3,19
1364,UTA,1,48,41,85,48.2,19,39,48.7,22,46,47.83,14,17,82.4,10,33,43,22,15,6,4,24
1365,MEM,1,48,48,102,47.1,10,35,28.6,38,67,56.72,12,21,57.1,23,38,61,24,13,11,5,21
1366,CHI,1,48,37,86,43,11,31,35.5,26,55,47.27,17,23,73.9,10,39,49,17,13,10,4,16
1367,DAL,1,48,35,78,44.9,14,37,37.8,21,41,51.22,19,21,90.5,5,23,28,23,11,12,5,21
1368,PHI,1,48,50,96,52.1,17,40,42.5,33,56,58.93,16,17,94.1,12,42,54,33,14,7,7,21
1369,WAS,1,48,40,87,46,16,38,42.1,24,49,48.98,28,31,90.3,10,41,51,26,15,5,4,12
1370,ORL,0,48,36,85,42.4,10,27,37,26,58,44.83,16,18,88.9,5,39,44,24,13,5,2,17
1371,ATL,0,48,48,88,54.5,14,41,34.1,34,47,72.34,21,24,87.5,9,30,39,31,13,6,1,24
1372,CHA,0,48,50,104,48.1,14,38,36.8,36,66,54.55,7,13,53.8,13,32,45,28,9,14,5,22
1373,BKN,0,48,37,82,45.1,9,31,29,28,51,54.9,21,26,80.8,8,25,33,28,13,10,10,20
1374,MIA,0,48,37,90,41.1,17,42,40.5,20,48,41.67,17,19,89.5,11,38,49,24,19,5,2,13
1375,MIN,1,48,49,93,52.7,16,45,35.6,33,48,68.75,8,9,88.9,11,29,40,34,17,9,4,14
1376,DEN,0,48,31,67,46.3,6,25,24,25,42,59.52,21,29,72.4,11,36,47,21,26,6,1,24
1377,DET,1,48,44,91,48.4,18,43,41.9,26,48,54.17,9,14,64.3,9,38,47,31,14,6,1,21
1378,GSW,1,48,45,92,48.9,14,38,36.8,31,54,57.41,11,13,84.6,7,36,43,39,12,11,6,17
1379,MIL,0,48,39,92,42.4,11,46,23.9,28,46,60.87,17,22,77.3,11,36,47,21,8,9,2,12
1380,LAC,0,48,39,78,50,11,32,34.4,28,46,60.87,15,17,88.2,4,27,31,22,21,12,3,10
1381,NYK,0,48,35,78,44.9,12,36,33.3,23,42,54.76,23,28,82.1,7,23,30,22,18,11,4,26
1382,ORL,0,53,40,95,42.1,9,27,33.3,31,68,45.59,22,27,81.5,10,35,45,17,16,12,3,24
1383,TOR,1,48,41,86,47.7,13,34,38.2,28,52,53.85,25,30,83.3,11,33,44,21,17,9,5,27
1384,OKC,0,48,35,85,41.2,10,30,33.3,25,55,45.45,6,9,66.7,7,34,41,20,11,11,4,16
1385,IND,0,48,37,83,44.6,19,46,41.3,18,37,48.65,11,14,78.6,9,30,39,24,14,6,6,24
1386,PHX,1,48,52,103,50.5,17,41,41.5,35,62,56.45,12,12,100,14,39,53,36,17,15,4,21
1387,SAC,1,48,40,78,51.3,13,34,38.2,27,44,61.36,22,27,81.5,7,32,39,31,16,3,2,18
1388,MIA,0,48,46,105,43.8,9,33,27.3,37,72,51.39,12,12,100,18,31,49,26,9,4,3,18
1389,MIN,0,48,41,92,44.6,9,38,23.7,32,54,59.26,12,16,75,20,36,56,21,24,9,2,22
1390,DAL,1,48,38,85,44.7,14,39,35.9,24,46,52.17,5,7,71.4,7,41,48,28,16,9,3,12
1391,CLE,1,48,41,88,46.6,6,26,23.1,35,62,56.45,20,28,71.4,12,36,48,26,11,6,4,11
1392,CHA,0,48,39,85,45.9,9,35,25.7,30,50,60,12,21,57.1,5,29,34,27,18,10,9,15
1393,LAL,1,48,36,75,48,13,41,31.7,23,34,67.65,23,29,79.3,4,24,28,20,18,13,5,16
1394,BOS,1,53,39,86,45.3,13,36,36.1,26,50,52,25,28,89.3,9,37,46,25,22,5,10,23
1395,SAS,0,53,42,102,41.2,12,40,30,30,62,48.39,20,28,71.4,13,35,48,30,17,8,3,27
1396,UTA,0,48,40,92,43.5,14,44,31.8,26,48,54.17,22,28,78.6,15,30,45,19,13,7,0,21
1397,BKN,0,48,42,97,43.3,11,33,33.3,31,64,48.44,21,25,84,17,40,57,26,15,9,2,20
1398,HOU,0,48,37,85,43.5,16,42,38.1,21,43,48.84,21,24,87.5,13,23,36,20,18,10,4,24
1399,DET,1,53,41,101,40.6,9,35,25.7,32,66,48.48,26,33,78.8,22,41,63,18,21,12,6,23
1400,CHI,1,48,41,84,48.8,17,34,50,24,50,48,21,25,84,6,38,44,17,15,4,4,24
1401,WAS,0,48,46,87,52.9,6,27,22.2,40,60,66.67,21,26,80.8,6,37,43,26,12,9,3,22
1402,LAC,1,48,42,86,48.8,14,36,38.9,28,50,56,22,31,71,7,33,40,23,11,7,6,19
1403,MIL,1,48,49,92,53.3,23,48,47.9,26,44,59.09,15,18,83.3,4,44,48,27,14,10,4,20
1404,GSW,1,48,46,86,53.5,17,32,53.1,29,54,53.7,14,21,66.7,7,33,40,39,15,10,2,24
1405,NOP,0,48,39,95,41.1,16,51,31.4,23,44,52.27,19,30,63.3,14,36,50,28,15,10,5,16
1406,DEN,1,48,46,86,53.5,10,32,31.3,36,54,66.67,22,27,81.5,13,33,46,33,18,10,6,23
1407,LAL,1,48,47,85,55.3,19,41,46.3,28,44,63.64,26,30,86.7,5,42,47,27,7,6,9,21
1408,DAL,1,48,42,81,51.9,9,22,40.9,33,59,55.93,19,22,86.4,10,37,47,30,13,5,7,14
1409,IND,0,48,38,91,41.8,8,31,25.8,30,60,50,22,29,75.9,17,38,55,23,17,7,8,22
1410,OKC,1,48,36,87,41.4,18,43,41.9,18,44,40.91,5,7,71.4,7,42,49,21,10,6,3,17
1411,SAC,0,48,38,91,41.8,10,29,34.5,28,62,45.16,10,12,83.3,8,25,33,25,10,7,4,16
1412,BOS,1,48,45,83,54.2,10,27,37,35,56,62.5,23,26,88.5,13,38,51,28,18,6,7,18
1413,MEM,1,48,49,102,48,10,26,38.5,39,76,51.32,10,16,62.5,16,42,58,28,10,7,11,18
1414,MIA,1,48,40,86,46.5,14,33,42.4,26,53,49.06,26,31,83.9,11,32,43,21,14,7,6,16
1415,CLE,0,48,48,84,57.1,8,25,32,40,59,67.8,14,24,58.3,8,38,46,27,9,1,8,18
1416,PHX,0,48,41,100,41,11,35,31.4,30,65,46.15,15,16,93.8,15,22,37,20,10,10,2,21
1417,CHI,1,48,35,86,40.7,12,27,44.4,23,59,38.98,26,30,86.7,8,34,42,22,11,11,5,19
1418,LAC,0,48,38,78,48.7,15,34,44.1,23,44,52.27,17,19,89.5,3,34,37,27,13,6,7,24
1419,HOU,0,48,41,93,44.1,14,42,33.3,27,51,52.94,14,17,82.4,15,31,46,21,18,9,4,27
1420,POR,0,48,36,102,35.3,12,42,28.6,24,60,40,22,27,81.5,21,33,54,19,9,4,2,22
1421,ATL,1,48,43,97,44.3,16,38,42.1,27,59,45.76,19,21,90.5,14,30,44,23,2,8,4,23
1422,SAS,0,48,39,90,43.3,12,35,34.3,27,55,49.09,15,24,62.5,11,36,47,24,11,3,8,15
1423,UTA,1,48,37,78,47.4,11,29,37.9,26,49,53.06,35,41,85.4,10,39,49,18,18,4,5,20
1424,TOR,1,48,40,96,41.7,11,35,31.4,29,61,47.54,25,33,75.8,18,36,54,19,7,8,4,18
1425,NYK,0,48,30,81,37,8,41,19.5,22,40,55,12,22,54.5,5,43,48,12,10,6,3,12
1426,MIN,0,48,40,93,43,14,41,34.1,26,52,50,14,22,63.6,11,30,41,23,10,9,5,30
1427,BKN,0,48,37,81,45.7,7,27,25.9,30,54,55.56,21,27,77.8,12,40,52,21,18,4,9,22
1428,MIL,1,48,45,91,49.5,13,33,39.4,32,58,55.17,33,36,91.7,14,36,50,24,13,7,6,19
1429,WAS,1,48,45,90,50,9,29,31,36,61,59.02,11,17,64.7,10,37,47,27,8,7,8,19
1430,ORL,0,48,42,87,48.3,13,36,36.1,29,51,56.86,21,27,77.8,6,27,33,26,10,5,1,26
1431,PHI,1,48,42,100,42,13,32,40.6,29,68,42.65,13,20,65,14,29,43,22,8,10,4,20
1432,CLE,0,48,35,83,42.2,8,28,28.6,27,55,49.09,15,23,65.2,8,36,44,20,13,4,3,17
1433,OKC,0,48,38,96,39.6,7,35,20,31,61,50.82,14,16,87.5,14,31,45,19,12,6,1,24
1434,CHI,1,48,52,84,61.9,10,22,45.5,42,62,67.74,17,22,77.3,6,35,41,38,15,9,6,18
1435,MEM,1,48,35,85,41.2,10,30,33.3,25,55,45.45,24,29,82.8,13,30,43,18,13,13,5,11
1436,LAL,0,48,39,86,45.3,15,41,36.6,24,45,53.33,6,8,75,7,32,39,24,18,5,5,25
1437,ATL,0,48,44,92,47.8,11,26,42.3,33,66,50,18,26,69.2,10,27,37,26,11,6,3,17
1438,IND,0,48,36,86,41.9,17,45,37.8,19,41,46.34,19,29,65.5,10,35,45,25,18,8,6,20
1439,CHA,1,48,44,85,51.8,9,26,34.6,35,59,59.32,19,32,59.4,8,40,48,27,14,12,5,20
1440,UTA,1,48,46,87,52.9,8,29,27.6,38,58,65.52,20,32,62.5,13,33,46,22,11,6,3,20
1441,NYK,1,48,31,81,38.3,8,31,25.8,23,50,46,24,27,88.9,11,37,48,19,17,11,5,14
1442,DET,0,48,30,81,37,12,35,34.3,18,46,39.13,13,17,76.5,8,35,43,19,17,11,5,23
1443,POR,0,48,37,88,42,14,40,35,23,48,47.92,17,24,70.8,11,34,45,23,11,6,3,28
1444,DAL,0,48,38,81,46.9,9,24,37.5,29,57,50.88,9,13,69.2,7,29,36,23,13,7,5,19
1445,PHX,1,48,41,89,46.1,12,34,35.3,29,55,52.73,21,28,75,18,38,56,22,15,7,7,15
1446,LAC,1,48,33,81,40.7,11,28,39.3,22,53,41.51,14,17,82.4,9,40,49,17,16,5,4,12
1447,SAC,1,48,36,75,48,10,26,38.5,26,49,53.06,13,15,86.7,7,31,38,21,15,5,2,21
1448,BOS,0,48,35,101,34.7,4,42,9.5,31,59,52.54,8,11,72.7,21,29,50,19,8,8,8,16
1449,MIL,1,48,47,85,55.3,17,37,45.9,30,48,62.5,16,22,72.7,7,33,40,31,13,4,3,20
1450,CLE,0,48,37,88,42,14,41,34.1,23,47,48.94,16,19,84.2,11,31,42,27,8,6,3,19
1451,SAC,1,48,40,95,42.1,17,39,43.6,23,56,41.07,20,27,74.1,11,46,57,25,10,3,9,22
1452,MIA,1,48,41,92,44.6,16,34,47.1,25,58,43.1,21,23,91.3,14,28,42,26,8,14,5,13
1453,ORL,0,48,38,83,45.8,12,39,30.8,26,44,59.09,22,26,84.6,7,30,37,24,13,7,4,25
1454,GSW,0,48,30,72,41.7,10,32,31.3,20,40,50,16,31,51.6,8,35,43,20,17,8,2,20
1455,DEN,1,48,34,83,41,8,33,24.2,26,50,52,13,20,65,13,31,44,24,16,10,5,19
1456,OKC,0,48,35,90,38.9,11,33,33.3,24,57,42.11,30,36,83.3,8,37,45,16,9,6,6,21
1457,NOP,1,48,36,80,45,16,36,44.4,20,44,45.45,20,26,76.9,8,36,44,24,13,3,8,16
1458,MIN,0,48,34,85,40,7,38,18.4,27,47,57.45,13,20,65,10,35,45,22,11,6,11,22
1459,HOU,0,48,44,83,53,16,35,45.7,28,48,58.33,19,25,76,4,26,30,24,14,10,7,20
1460,PHI,1,48,34,77,44.2,14,30,46.7,20,47,42.55,32,38,84.2,8,34,42,23,8,6,4,18
1461,NYK,1,48,37,90,41.1,16,40,40,21,50,42,6,16,37.5,15,39,54,20,16,5,4,20
1462,LAL,1,48,48,92,52.2,14,34,41.2,34,58,58.62,22,29,75.9,14,34,48,27,12,8,6,23
1463,WAS,0,48,42,85,49.4,17,42,40.5,25,43,58.14,11,14,78.6,13,34,47,27,18,5,3,20
1464,TOR,0,48,38,87,43.7,15,41,36.6,23,46,50,18,22,81.8,9,34,43,24,10,7,5,24
1465,PHX,0,48,41,90,45.6,11,31,35.5,30,59,50.85,20,23,87,10,25,35,25,11,11,2,16
1466,UTA,1,48,39,86,45.3,9,31,29,30,55,54.55,23,30,76.7,7,48,55,19,15,9,4,15
1467,HOU,0,48,36,87,41.4,15,46,32.6,21,41,51.22,12,18,66.7,13,31,44,20,21,9,3,15
1468,MEM,1,48,45,88,51.1,11,29,37.9,34,59,57.63,13,17,76.5,15,35,50,22,19,10,6,23
1469,CHI,1,48,51,94,54.3,18,37,48.6,33,57,57.89,10,14,71.4,9,35,44,29,10,5,6,19
1470,BOS,0,48,33,89,37.1,16,47,34,17,42,40.48,21,28,75,15,38,53,23,14,8,10,16
1471,MIN,1,48,40,90,44.4,14,34,41.2,26,56,46.43,14,19,73.7,11,42,53,30,14,7,5,17
1472,ATL,0,48,40,89,44.9,15,34,44.1,25,55,45.45,23,26,88.5,11,34,45,22,10,3,5,14
1473,DAL,1,48,48,84,57.1,12,33,36.4,36,51,70.59,24,33,72.7,10,31,41,38,13,6,4,31
1474,LAC,0,48,37,97,38.1,14,37,37.8,23,60,38.33,20,27,74.1,17,28,45,25,12,7,4,17
1475,CHA,1,48,47,88,53.4,18,41,43.9,29,47,61.7,11,14,78.6,7,32,39,33,16,13,4,18
1476,BKN,1,48,50,88,56.8,13,34,38.2,37,54,68.52,11,16,68.8,7,40,47,31,15,7,8,25
1477,POR,0,48,35,82,42.7,12,40,30,23,42,54.76,35,42,83.3,8,25,33,19,11,4,5,28
1478,SAS,0,48,45,100,45,10,30,33.3,35,70,50,4,9,44.4,9,35,44,26,10,8,3,24
1479,DEN,1,48,39,95,41.1,15,41,36.6,24,54,44.44,10,11,90.9,10,38,48,29,14,7,4,20
1480,SAS,1,48,51,91,56,13,27,48.1,38,64,59.38,29,37,78.4,9,43,52,39,19,6,5,28
1481,LAC,0,48,40,86,46.5,8,26,30.8,32,60,53.33,12,18,66.7,8,38,46,26,14,8,7,22
1482,MIA,1,48,36,89,40.4,10,34,29.4,26,55,47.27,11,18,61.1,20,31,51,28,14,7,1,19
1483,DET,0,48,38,98,38.8,8,32,25,30,66,45.45,25,34,73.5,14,28,42,16,14,10,5,30
1484,MEM,1,48,47,100,47,9,30,30,38,70,54.29,24,30,80,19,34,53,33,12,11,6,19
1485,ORL,0,48,31,72,43.1,10,32,31.3,21,40,52.5,11,17,64.7,8,35,43,17,19,6,4,19
1486,TOR,0,48,37,89,41.6,9,36,25,28,53,52.83,16,23,69.6,11,32,43,24,21,11,3,13
1487,PHI,1,48,43,86,50,12,31,38.7,31,55,56.36,19,22,86.4,10,40,50,25,13,6,8,23
1488,IND,0,48,41,94,43.6,8,30,26.7,33,64,51.56,15,21,71.4,14,31,45,23,9,9,5,16
1489,CLE,1,48,56,106,52.8,22,52,42.3,34,54,62.96,10,12,83.3,13,39,52,39,15,12,5,17
1490,WAS,0,48,35,90,38.9,8,33,24.2,27,57,47.37,18,28,64.3,14,29,43,22,8,6,1,18
1491,SAC,0,48,34,81,42,10,29,34.5,24,52,46.15,24,27,88.9,9,29,38,22,18,7,9,23
1492,CHI,1,48,43,76,56.6,11,23,47.8,32,53,60.38,16,22,72.7,2,38,40,17,15,5,6,20
1493,OKC,1,48,41,86,47.7,13,36,36.1,28,50,56,22,31,71,7,40,47,24,12,8,5,23
1494,NOP,0,48,39,94,41.5,10,41,24.4,29,53,54.72,24,28,85.7,11,38,49,26,11,10,4,19
1495,UTA,1,48,40,90,44.4,12,36,33.3,28,54,51.85,28,37,75.7,13,36,49,24,14,9,6,24
1496,BKN,1,48,43,89,48.3,14,32,43.8,29,57,50.88,22,27,81.5,6,35,41,31,12,6,9,25
1497,NYK,1,48,38,85,44.7,20,50,40,18,35,51.43,5,12,41.7,9,41,50,28,10,6,6,13
1498,GSW,1,48,42,85,49.4,14,37,37.8,28,48,58.33,18,21,85.7,12,30,42,28,11,11,7,22
1499,MIL,1,48,43,91,47.3,12,33,36.4,31,58,53.45,19,27,70.4,15,33,48,24,13,7,6,20
1500,ATL,0,48,33,87,37.9,13,38,34.2,20,49,40.82,8,14,57.1,8,38,46,23,12,8,5,12
1501,LAL,0,48,40,96,41.7,10,35,28.6,30,61,49.18,25,28,89.3,12,35,47,29,14,8,5,23
1502,PHX,0,48,40,83,48.2,11,30,36.7,29,53,54.72,16,16,100,9,28,37,20,13,5,2,17
1503,BOS,0,48,38,89,42.7,17,45,37.8,21,44,47.73,20,24,83.3,11,33,44,24,14,9,8,23
1504,DAL,0,48,38,89,42.7,10,30,33.3,28,59,47.46,30,35,85.7,8,35,43,19,14,7,3,31
1505,ORL,0,48,38,88,43.2,9,32,28.1,29,56,51.79,19,21,90.5,10,34,44,19,9,6,11,26
1506,SAS,1,48,46,95,48.4,18,39,46.2,28,56,50,28,33,84.8,12,38,50,33,6,7,5,21
1507,NYK,0,48,42,93,45.2,13,42,31,29,51,56.86,20,23,87,14,30,44,17,7,2,1,21
1508,UTA,1,48,48,90,53.3,16,39,41,32,51,62.75,16,22,72.7,10,35,45,31,15,7,7,17
1509,LAL,0,48,44,94,46.8,5,27,18.5,39,67,58.21,17,30,56.7,14,34,48,21,14,4,6,20
1510,WAS,1,48,42,75,56,16,37,43.2,26,38,68.42,24,32,75,5,33,38,30,11,4,6,18
1511,MIL,1,48,37,82,45.1,10,36,27.8,27,46,58.7,18,22,81.8,6,41,47,26,12,7,5,16
1512,CHA,1,48,39,94,41.5,16,47,34,23,47,48.94,21,24,87.5,12,38,50,28,11,10,8,21
1513,DAL,0,48,35,86,40.7,12,45,26.7,23,41,56.1,13,17,76.5,8,35,43,25,11,6,2,21
1514,MIA,1,48,43,88,48.9,12,32,37.5,31,56,55.36,17,19,89.5,6,37,43,23,13,4,0,25
1515,MEM,0,48,38,90,42.2,8,26,30.8,30,64,46.88,20,24,83.3,14,28,42,18,13,10,6,20
1516,PHI,0,48,33,80,41.3,6,27,22.2,27,53,50.94,24,26,92.3,8,30,38,20,8,8,7,13
1517,PHX,1,48,45,93,48.4,15,39,38.5,30,54,55.56,8,13,61.5,11,41,52,26,14,9,8,22
1518,NOP,1,48,37,86,43,13,30,43.3,24,56,42.86,23,26,88.5,12,34,46,21,10,4,2,13
1519,GSW,1,48,40,82,48.8,19,40,47.5,21,42,50,14,18,77.8,8,31,39,30,19,9,9,19
1520,OKC,0,48,37,96,38.5,11,41,26.8,26,55,47.27,16,21,76.2,11,33,44,17,13,6,5,10
1521,HOU,0,48,35,80,43.8,15,37,40.5,20,43,46.51,21,26,80.8,8,20,28,16,13,9,6,17
1522,DET,0,48,36,80,45,18,40,45,18,40,45,22,25,88,6,37,43,23,16,9,5,25
1523,ATL,1,48,37,82,45.1,7,24,29.2,30,58,51.72,17,19,89.5,11,35,46,20,16,5,4,19
1524,DEN,0,48,40,96,41.7,14,40,35,26,56,46.43,13,17,76.5,10,44,54,23,15,7,2,22
1525,IND,1,48,46,88,52.3,13,38,34.2,33,50,66,13,19,68.4,15,32,47,27,15,6,6,21
1526,MIN,0,48,45,101,44.6,17,45,37.8,28,56,50,9,12,75,15,29,44,29,14,7,4,19
1527,ATL,0,48,32,80,40,12,31,38.7,20,49,40.82,22,29,75.9,13,36,49,21,14,4,8,19
1528,HOU,0,48,36,86,41.9,13,45,28.9,23,41,56.1,21,31,67.7,13,39,52,23,15,0,7,21
1529,CLE,0,48,36,92,39.1,9,38,23.7,27,54,50,20,24,83.3,15,38,53,17,16,8,3,15
1530,SAC,0,48,34,85,40,12,38,31.6,22,47,46.81,9,12,75,7,33,40,24,19,7,5,15
1531,OKC,1,48,42,94,44.7,8,34,23.5,34,60,56.67,16,19,84.2,15,45,60,22,11,7,4,25
1532,BOS,1,48,43,92,46.7,11,30,36.7,32,62,51.61,14,18,77.8,12,36,48,24,13,12,5,24
1533,MIL,1,48,45,103,43.7,17,46,37,28,57,49.12,19,21,90.5,14,34,48,25,7,8,2,24
1534,DEN,0,48,33,84,39.3,13,44,29.5,20,40,50,15,26,57.7,4,35,39,21,11,7,5,18
1535,ORL,1,48,38,85,44.7,11,37,29.7,27,48,56.25,17,23,73.9,8,32,40,27,10,11,5,24
1536,LAC,1,48,42,82,51.2,7,24,29.2,35,58,60.34,14,16,87.5,6,37,43,26,13,10,3,15
1537,IND,0,48,31,87,35.6,11,31,35.5,20,56,35.71,23,28,82.1,11,31,42,22,12,6,3,13
1538,DAL,1,48,42,86,48.8,11,34,32.4,31,52,59.62,19,23,82.6,10,34,44,30,11,11,3,22
1539,LAL,0,48,34,87,39.1,7,35,20,27,52,51.92,15,23,65.2,6,41,47,14,15,9,3,18
1540,MIN,0,48,36,79,45.6,13,40,32.5,23,39,58.97,17,20,85,9,30,39,26,17,4,5,22
1541,NOP,1,48,42,80,52.5,12,33,36.4,30,47,63.83,15,18,83.3,8,36,44,27,16,5,3,19
1542,NYK,1,48,40,90,44.4,11,33,33.3,29,57,50.88,14,19,73.7,13,39,52,22,13,5,7,19
1543,DET,0,48,34,94,36.2,8,33,24.2,26,61,42.62,15,19,78.9,10,38,48,22,14,9,4,18
1544,PHX,1,48,41,93,44.1,12,41,29.3,29,52,55.77,14,15,93.3,8,45,53,29,16,11,4,18
1545,POR,0,48,35,78,44.9,13,34,38.2,22,44,50,14,19,73.7,7,24,31,18,11,12,4,17
1546,MIA,1,48,47,95,49.5,22,49,44.9,25,46,54.35,9,11,81.8,15,38,53,30,11,5,5,21
1547,CHA,0,48,39,101,38.6,15,43,34.9,24,58,41.38,9,9,100,11,40,51,27,13,7,4,25
1548,CHI,1,48,47,88,53.4,16,35,45.7,31,53,58.49,23,24,95.8,9,25,34,33,8,7,5,23
1549,SAS,1,48,50,114,43.9,12,37,32.4,38,77,49.35,4,6,66.7,23,43,66,37,12,11,4,19
1550,LAC,0,48,34,87,39.1,9,32,28.1,25,55,45.45,15,20,75,9,34,43,18,15,6,5,15
1551,BOS,0,48,38,82,46.3,7,27,25.9,31,55,56.36,20,25,80,11,31,42,16,18,9,5,23
1552,UTA,1,48,34,96,35.4,16,53,30.2,18,43,41.86,28,37,75.7,22,46,68,21,17,4,6,14
1553,MEM,0,48,39,101,38.6,11,32,34.4,28,69,40.58,10,13,76.9,17,34,51,24,12,9,2,21
1554,GSW,1,48,46,88,52.3,15,37,40.5,31,51,60.78,6,9,66.7,10,32,42,28,16,12,9,18
1555,SAC,0,48,37,83,44.6,13,32,40.6,24,51,47.06,11,16,68.8,6,31,37,23,21,10,3,9
1556,OKC,1,48,36,84,42.9,11,38,28.9,25,46,54.35,19,28,67.9,9,38,47,24,14,7,7,17
1557,PHI,1,48,36,72,50,10,25,40,26,47,55.32,26,31,83.9,2,32,34,20,17,11,7,23
1558,HOU,0,48,44,78,56.4,12,33,36.4,32,45,71.11,18,24,75,7,28,35,27,14,4,4,17
1559,SAS,0,48,45,91,49.5,12,25,48,33,66,50,12,13,92.3,13,31,44,24,14,7,8,12
1560,LAL,0,48,42,82,51.2,12,34,35.3,30,48,62.5,14,22,63.6,9,37,46,25,20,6,8,25
1561,MIN,1,48,36,77,46.8,15,34,44.1,21,43,48.84,24,31,77.4,6,31,37,26,9,6,3,22
1562,CHA,0,48,36,100,36,10,45,22.2,26,55,47.27,24,28,85.7,13,30,43,26,9,12,6,12
1563,MEM,0,48,35,91,38.5,9,34,26.5,26,57,45.61,21,25,84,10,23,33,22,8,13,5,22
1564,SAC,1,48,46,91,50.5,14,25,56,32,66,48.48,15,18,83.3,11,29,40,23,12,11,3,19
1565,DAL,0,48,36,82,43.9,12,41,29.3,24,41,58.54,21,22,95.5,7,34,41,27,12,5,2,25
1566,PHX,1,48,54,95,56.8,20,41,48.8,34,54,62.96,9,13,69.2,10,47,57,35,18,5,8,21
1567,MIA,0,48,28,74,37.8,13,43,30.2,15,31,48.39,21,33,63.6,8,31,39,23,13,4,3,27
1568,POR,1,48,35,74,47.3,11,32,34.4,24,42,57.14,24,28,85.7,9,42,51,17,25,4,9,18
1569,DET,1,48,35,75,46.7,8,32,25,27,43,62.79,22,30,73.3,6,41,47,24,15,4,2,28
1570,CHI,1,48,40,93,43,10,30,33.3,30,63,47.62,25,31,80.6,16,27,43,20,10,10,3,17
1571,WAS,1,48,42,94,44.7,9,31,29,33,63,52.38,16,20,80,11,36,47,27,9,7,4,23
1572,HOU,1,48,46,93,49.5,14,38,36.8,32,55,58.18,10,17,58.8,13,34,47,27,19,15,5,18
1573,LAC,0,48,37,83,44.6,16,39,41,21,44,47.73,13,19,68.4,7,32,39,26,13,11,3,16
1574,BKN,0,48,39,102,38.2,9,46,19.6,30,56,53.57,6,8,75,16,35,51,24,16,8,8,14
1575,CLE,1,48,45,90,50,16,45,35.6,29,45,64.44,13,14,92.9,9,37,46,36,15,11,3,13
1576,GSW,0,48,37,79,46.8,11,36,30.6,26,43,60.47,15,21,71.4,11,36,47,26,20,5,5,21
1577,MIL,0,48,35,89,39.3,12,38,31.6,23,51,45.1,8,11,72.7,13,31,44,18,17,8,4,15
1578,BOS,1,48,42,89,47.2,17,45,37.8,25,44,56.82,13,17,76.5,12,33,45,23,13,6,3,20
1579,OKC,1,48,43,92,46.7,12,31,38.7,31,61,50.82,6,10,60,17,38,55,23,16,4,4,18
1580,DET,0,48,43,93,46.2,10,36,27.8,33,57,57.89,11,16,68.8,15,27,42,29,21,8,6,24
1581,UTA,0,48,35,81,43.2,14,44,31.8,21,37,56.76,19,30,63.3,8,38,46,17,16,5,6,23
1582,NYK,0,48,35,80,43.8,13,36,36.1,22,44,50,24,30,80,8,34,42,18,14,8,6,21
1583,TOR,1,48,45,90,50,14,38,36.8,31,52,59.62,15,23,65.2,12,29,41,26,11,13,3,21
1584,ORL,1,48,39,94,41.5,10,31,32.3,29,63,46.03,12,13,92.3,12,38,50,20,16,6,4,14
1585,MIL,0,53,45,104,43.3,14,47,29.8,31,57,54.39,8,10,80,12,32,44,16,13,12,5,19
1586,ORL,0,48,43,89,48.3,11,32,34.4,32,57,56.14,8,10,80,9,27,36,23,11,10,5,19
1587,SAC,0,48,36,88,40.9,13,35,37.1,23,53,43.4,20,26,76.9,10,35,45,21,18,5,6,20
1588,MIN,1,48,41,98,41.8,12,44,27.3,29,54,53.7,16,24,66.7,15,46,61,23,15,13,6,25
1589,MEM,1,48,45,97,46.4,13,24,54.2,32,73,43.84,21,27,77.8,12,38,50,25,13,11,3,21
1590,POR,1,48,44,85,51.8,21,47,44.7,23,38,60.53,16,18,88.9,7,34,41,27,17,7,6,20
1591,LAL,0,48,30,78,38.5,12,43,27.9,18,35,51.43,20,29,69,1,35,36,26,18,6,7,22
1592,SAS,1,48,50,100,50,15,41,36.6,35,59,59.32,13,18,72.2,11,32,43,27,7,8,4,18
1593,MIA,1,48,41,82,50,19,35,54.3,22,47,46.81,14,19,73.7,14,32,46,25,17,5,5,14
1594,BOS,0,48,36,82,43.9,15,41,36.6,21,41,51.22,20,29,69,11,34,45,20,16,5,2,19
1595,NOP,1,53,42,89,47.2,13,37,35.1,29,52,55.77,19,30,63.3,13,44,57,34,20,10,3,13
1596,ATL,0,48,41,88,46.6,7,24,29.2,34,64,53.12,26,34,76.5,10,27,37,22,15,6,3,17
1597,CHA,0,48,44,92,47.8,13,37,35.1,31,55,56.36,15,18,83.3,10,28,38,29,13,8,4,19
1598,UTA,0,48,46,93,49.5,13,37,35.1,33,56,58.93,21,26,80.8,13,37,50,26,13,5,6,18
1599,DEN,1,48,50,86,58.1,17,38,44.7,33,48,68.75,16,18,88.9,4,34,38,35,17,9,7,22
1600,GSW,1,48,39,90,43.3,16,46,34.8,23,44,52.27,17,21,81,12,33,45,27,14,9,8,25
1601,PHX,1,48,42,79,53.2,9,29,31,33,50,66,25,26,96.2,9,38,47,25,20,9,2,23
1602,DET,0,48,40,81,49.4,7,25,28,33,56,58.93,26,30,86.7,6,31,37,20,12,6,4,23
1603,NYK,1,48,39,83,47,17,36,47.2,22,47,46.81,21,25,84,15,25,40,25,12,8,6,26
1604,BKN,1,48,44,89,49.4,11,23,47.8,33,66,50,15,16,93.8,10,38,48,21,15,4,3,15
1605,HOU,0,48,34,68,50,11,32,34.4,23,36,63.89,24,30,80,5,24,29,29,19,4,4,25
1606,IND,1,48,45,91,49.5,7,32,21.9,38,59,64.41,25,28,89.3,8,33,41,26,9,6,7,21
1607,WAS,0,48,40,82,48.8,6,21,28.6,34,61,55.74,12,19,63.2,6,26,32,22,16,11,3,21
1608,PHI,0,48,39,89,43.8,10,34,29.4,29,55,52.73,17,20,85,5,33,38,19,9,10,4,22
1609,PHI,0,48,35,79,44.3,12,37,32.4,23,42,54.76,14,17,82.4,4,31,35,26,11,9,5,19
1610,MEM,1,48,39,82,47.6,11,32,34.4,28,50,56,24,30,80,11,42,53,22,16,10,5,21
1611,UTA,1,48,47,89,52.8,15,37,40.5,32,52,61.54,15,20,75,8,36,44,26,10,11,4,18
1612,ORL,0,48,35,90,38.9,10,35,28.6,25,55,45.45,19,21,90.5,12,34,46,25,17,4,2,17
1613,LAL,1,53,39,90,43.3,15,39,38.5,24,51,47.06,14,18,77.8,4,42,46,24,14,8,2,20
1614,MIL,1,48,44,90,48.9,14,29,48.3,30,61,49.18,12,15,80,10,28,38,25,9,10,3,11
1615,DEN,0,48,38,84,45.2,14,39,35.9,24,45,53.33,17,23,73.9,9,33,42,33,18,5,3,15
1616,MIN,1,48,45,88,51.1,23,48,47.9,22,40,55,11,16,68.8,6,33,39,24,12,10,5,23
1617,WAS,0,48,42,89,47.2,5,24,20.8,37,65,56.92,16,21,76.2,7,32,39,20,11,8,3,22
1618,NOP,1,48,39,80,48.8,11,28,39.3,28,52,53.85,24,36,66.7,10,39,49,23,12,6,3,19
1619,MIA,1,48,35,78,44.9,18,44,40.9,17,34,50,13,17,76.5,9,35,44,25,18,5,3,18
1620,LAC,0,48,40,85,47.1,10,30,33.3,30,55,54.55,13,20,65,8,34,42,24,16,6,5,22
1621,CLE,1,48,45,80,56.3,18,40,45,27,40,67.5,16,24,66.7,9,35,44,26,17,6,5,25
1622,DAL,0,53,39,98,39.8,12,44,27.3,27,54,50,14,17,82.4,8,43,51,22,11,4,3,21
1623,CHA,1,48,51,86,59.3,18,34,52.9,33,52,63.46,11,16,68.8,9,39,48,34,13,3,4,16
1624,SAS,0,48,39,90,43.3,12,37,32.4,27,53,50.94,25,25,100,11,27,38,27,8,5,3,14
1625,POR,0,48,31,82,37.8,15,38,39.5,16,44,36.36,26,28,92.9,5,33,38,18,15,9,6,21
1626,IND,0,48,39,83,47,11,38,28.9,28,45,62.22,10,11,90.9,11,34,45,24,19,6,6,16
1627,HOU,0,48,30,78,38.5,5,29,17.2,25,49,51.02,24,35,68.6,10,31,41,20,17,13,1,21
1628,ATL,1,48,42,85,49.4,11,31,35.5,31,54,57.41,16,16,100,6,34,40,25,13,11,5,16
1629,SAC,1,48,45,82,54.9,8,26,30.8,37,56,66.07,21,29,72.4,6,33,39,25,11,7,6,21
1630,OKC,0,48,39,93,41.9,13,35,37.1,26,58,44.83,19,19,100,8,34,42,22,8,8,4,25
1631,NYK,0,48,30,83,36.1,16,42,38.1,14,41,34.15,20,22,90.9,4,31,35,18,9,6,6,21
1632,TOR,0,53,48,105,45.7,18,52,34.6,30,53,56.6,15,19,78.9,13,28,41,26,12,6,6,21
1633,GSW,1,48,35,77,45.5,15,40,37.5,20,37,54.05,20,27,74.1,7,42,49,28,12,3,6,22
1634,PHX,1,53,44,93,47.3,11,31,35.5,33,62,53.23,12,15,80,8,41,49,30,14,7,0,24
1635,POR,0,53,40,96,41.7,13,41,31.7,27,55,49.09,14,22,63.6,12,36,48,23,14,7,3,18
1636,BKN,1,53,50,103,48.5,14,39,35.9,36,64,56.25,17,23,73.9,19,41,60,28,18,7,5,20
1637,MIL,0,48,40,90,44.4,11,36,30.6,29,54,53.7,12,15,80,11,34,45,22,14,8,3,14
1638,ATL,0,48,42,85,49.4,15,39,38.5,27,46,58.7,27,31,87.1,8,32,40,20,12,9,6,26
1639,HOU,1,48,46,96,47.9,19,46,41.3,27,50,54,21,27,77.8,12,33,45,27,11,8,5,24
1640,MIA,0,48,38,85,44.7,13,40,32.5,25,45,55.56,5,9,55.6,11,28,39,26,16,4,4,15
1641,CLE,1,48,36,81,44.4,16,36,44.4,20,45,44.44,17,18,94.4,8,34,42,24,14,6,1,16
1642,IND,0,48,35,87,40.2,7,30,23.3,28,57,49.12,23,31,74.2,13,29,42,16,10,11,5,18
1643,DAL,1,48,43,83,51.8,19,41,46.3,24,42,57.14,15,17,88.2,14,36,50,28,13,4,8,19
1644,WAS,0,48,41,90,45.6,12,34,35.3,29,56,51.79,13,21,61.9,6,35,41,25,10,7,5,26
1645,LAC,1,48,43,78,55.1,9,21,42.9,34,57,59.65,16,23,69.6,8,37,45,24,17,5,7,20
1646,MEM,1,48,47,89,52.8,14,34,41.2,33,55,60,18,23,78.3,11,39,50,29,11,12,6,20
1647,SAC,0,48,38,94,40.4,11,34,32.4,27,60,45,14,21,66.7,19,34,53,21,17,5,4,16
1648,TOR,1,48,53,98,54.1,11,31,35.5,42,67,62.69,7,10,70,8,38,46,28,10,10,8,19
1649,CHA,0,48,34,86,39.5,13,37,35.1,21,49,42.86,15,24,62.5,18,20,38,22,10,8,2,18
1650,PHX,0,48,36,96,37.5,7,29,24.1,29,67,43.28,16,19,84.2,13,28,41,22,11,10,3,23
1651,PHI,0,48,37,83,44.6,4,22,18.2,33,61,54.1,13,19,68.4,5,33,38,22,15,5,10,19
1652,BOS,1,48,43,86,50,20,47,42.6,23,39,58.97,11,13,84.6,7,33,40,31,13,6,5,15
1653,DEN,1,48,37,79,46.8,10,32,31.3,27,47,57.45,29,33,87.9,4,45,49,26,13,8,2,19
1654,GSW,1,48,42,84,50,8,30,26.7,34,54,62.96,10,14,71.4,9,38,47,21,18,6,6,25
1655,NYK,0,48,35,82,42.7,17,49,34.7,18,33,54.55,10,13,76.9,8,29,37,27,17,12,2,16
1656,OKC,0,48,30,80,37.5,13,37,35.1,17,43,39.53,11,16,68.8,3,36,39,19,11,3,7,25
1657,NOP,0,48,40,94,42.6,8,29,27.6,32,65,49.23,9,15,60,11,31,42,24,14,8,4,17
1658,MIL,1,48,42,88,47.7,14,41,34.1,28,47,59.57,14,17,82.4,12,34,46,27,15,11,1,12
1659,SAS,1,48,45,91,49.5,7,25,28,38,66,57.58,15,20,75,15,40,55,31,14,11,5,19
1660,LAL,1,48,41,84,48.8,13,28,46.4,28,56,50,11,17,64.7,6,38,44,24,14,12,11,17
1661,POR,0,48,37,81,45.7,18,48,37.5,19,33,57.58,19,28,67.9,12,33,45,25,19,9,8,25
1662,ORL,0,48,33,88,37.5,13,38,34.2,20,50,40,15,19,78.9,14,33,47,17,19,6,4,13
1663,DET,0,48,39,92,42.4,14,37,37.8,25,55,45.45,12,18,66.7,8,32,40,24,21,11,5,22
1664,BKN,1,48,41,87,47.1,11,28,39.3,30,59,50.85,23,25,92,8,35,43,28,18,8,6,20
1665,DAL,1,48,38,90,42.2,9,33,27.3,29,57,50.88,18,23,78.3,10,44,54,25,9,5,5,18
1666,MIN,1,48,38,85,44.7,14,36,38.9,24,49,48.98,26,32,81.3,10,32,42,23,17,9,2,22
1667,GSW,0,48,34,85,40,12,48,25,22,37,59.46,13,18,72.2,10,32,42,21,13,5,5,22
1668,CLE,1,48,41,88,46.6,12,31,38.7,29,57,50.88,23,28,82.1,7,40,47,27,14,13,6,24
1669,SAC,0,48,41,93,44.1,7,28,25,34,65,52.31,14,22,63.6,11,37,48,19,17,8,6,21
1670,MIA,1,48,46,93,49.5,19,43,44.2,27,50,54,7,9,77.8,12,38,50,37,10,8,6,21
1671,SAS,0,48,41,89,46.1,10,27,37,31,62,50,20,29,69,14,31,45,28,17,4,4,18
1672,HOU,0,48,38,77,49.4,11,33,33.3,27,44,61.36,19,29,65.5,12,28,40,25,16,5,6,25
1673,WAS,0,48,41,89,46.1,8,25,32,33,64,51.56,8,14,57.1,9,30,39,17,13,3,3,15
1674,ORL,0,48,35,80,43.8,12,33,36.4,23,47,48.94,22,24,91.7,10,35,45,21,11,4,5,11
1675,UTA,1,48,48,93,51.6,13,39,33.3,35,54,64.81,14,17,82.4,12,37,49,28,9,5,5,14
1676,DEN,1,48,47,93,50.5,20,43,46.5,27,50,54,13,14,92.9,10,31,41,33,12,9,8,25
1677,LAC,1,48,42,92,45.7,18,36,50,24,56,42.86,4,6,66.7,12,33,45,27,8,7,1,17
1678,MEM,1,48,40,80,50,11,29,37.9,29,51,56.86,22,36,61.1,9,29,38,22,11,10,3,24
1679,PHI,1,48,35,76,46.1,9,27,33.3,26,49,53.06,23,26,88.5,5,39,44,19,13,7,5,16
1680,CHI,0,48,31,83,37.3,17,40,42.5,14,43,32.56,13,20,65,7,27,34,22,16,5,3,15
1681,ATL,0,48,37,94,39.4,11,34,32.4,26,60,43.33,20,24,83.3,16,33,49,21,15,10,3,19
1682,PHX,1,48,43,96,44.8,14,38,36.8,29,58,50,11,11,100,14,39,53,25,12,4,9,21
1683,LAL,1,48,41,87,47.1,19,42,45.2,22,45,48.89,15,20,75,12,35,47,23,16,12,3,14
1684,HOU,0,48,42,89,47.2,19,46,41.3,23,43,53.49,11,20,55,12,28,40,30,16,9,4,28
1685,BOS,0,48,35,93,37.6,4,26,15.4,31,67,46.27,16,24,66.7,15,31,46,13,13,7,6,17
1686,MIL,1,48,42,83,50.6,15,39,38.5,27,44,61.36,24,32,75,13,35,48,19,15,11,8,21
1687,NYK,0,48,29,81,35.8,9,34,26.5,20,47,42.55,20,24,83.3,14,41,55,18,15,4,2,17
1688,IND,1,48,41,87,47.1,13,36,36.1,28,51,54.9,11,12,91.7,13,31,44,28,13,7,3,19
1689,DAL,0,48,39,84,46.4,4,29,13.8,35,55,63.64,11,12,91.7,12,25,37,18,14,7,2,18
1690,BKN,1,48,46,93,49.5,6,23,26.1,40,70,57.14,15,16,93.8,9,32,41,26,14,9,7,22
1691,SAC,0,48,48,101,47.5,14,41,34.1,34,60,56.67,13,17,76.5,20,28,48,22,14,11,4,20
1692,MIN,0,48,36,92,39.1,11,39,28.2,25,53,47.17,23,28,82.1,10,30,40,24,14,9,5,19
1693,CHA,1,48,48,87,55.2,14,35,40,34,52,65.38,14,20,70,11,28,39,29,16,9,8,20
1694,DET,0,48,35,90,38.9,12,37,32.4,23,53,43.4,11,12,91.7,7,31,38,22,13,7,6,15
1695,NOP,1,48,41,95,43.2,13,37,35.1,28,58,48.28,14,16,87.5,15,45,60,29,16,6,4,16
1696,CLE,1,48,46,85,54.1,13,33,39.4,33,52,63.46,18,22,81.8,6,41,47,34,17,8,7,23
1697,TOR,1,48,30,87,34.5,12,35,34.3,18,52,34.62,18,23,78.3,12,36,48,21,8,9,7,19
1698,OKC,0,48,38,96,39.6,10,44,22.7,28,52,53.85,9,14,64.3,19,32,51,21,15,9,3,17
1699,UTA,1,48,43,91,47.3,15,40,37.5,28,51,54.9,17,24,70.8,16,36,52,22,12,7,5,14
1700,LAL,0,48,36,78,46.2,12,30,40,24,48,50,11,17,64.7,7,38,45,26,22,8,6,15
1701,MEM,1,48,41,94,43.6,14,42,33.3,27,52,51.92,12,18,66.7,14,33,47,28,13,18,5,14
1702,PHI,0,48,38,88,43.2,6,33,18.2,32,55,58.18,14,15,93.3,6,28,34,17,12,9,4,20
1703,SAS,1,48,46,88,52.3,15,35,42.9,31,53,58.49,16,22,72.7,14,40,54,32,14,5,7,21
1704,DEN,0,48,42,94,44.7,15,39,38.5,27,55,49.09,12,13,92.3,5,28,33,29,9,7,5,21
1705,DEN,1,53,45,88,51.1,9,32,28.1,36,56,64.29,21,27,77.8,5,28,33,28,12,12,4,19
1706,OKC,1,48,38,84,45.2,17,40,42.5,21,44,47.73,17,20,85,7,33,40,28,14,12,3,18
1707,TOR,0,48,42,93,45.2,15,41,36.6,27,52,51.92,10,15,66.7,13,33,46,27,13,6,5,19
1708,UTA,1,48,50,88,56.8,25,54,46.3,25,34,73.53,11,15,73.3,6,42,48,26,15,6,4,20
1709,DAL,1,48,37,77,48.1,12,33,36.4,25,44,56.82,18,23,78.3,10,37,47,24,19,5,6,21
1710,WAS,1,53,42,88,47.7,12,32,37.5,30,56,53.57,23,28,82.1,13,32,45,27,17,6,8,21
1711,MIA,1,48,40,77,51.9,22,47,46.8,18,30,60,11,12,91.7,6,36,42,32,22,6,6,23
1712,BOS,0,48,41,86,47.7,10,32,31.3,31,54,57.41,19,21,90.5,14,33,47,26,23,11,3,21
1713,ORL,0,48,48,97,49.5,16,34,47.1,32,63,50.79,18,23,78.3,17,26,43,29,13,2,5,18
1714,PHI,1,48,36,75,48,13,34,38.2,23,41,56.1,25,30,83.3,8,28,36,23,17,6,4,21
1715,MIL,0,48,36,85,42.4,12,39,30.8,24,46,52.17,20,27,74.1,12,29,41,18,19,11,4,20
1716,DET,0,53,37,79,46.8,13,24,54.2,24,55,43.64,29,35,82.9,7,30,37,22,16,9,4,26
1717,NYK,0,48,36,86,41.9,9,30,30,27,56,48.21,21,23,91.3,11,25,36,17,13,6,8,20
1718,IND,1,48,46,86,53.5,10,27,37,36,59,61.02,20,25,80,9,33,42,27,11,8,4,19
1719,GSW,1,48,33,83,39.8,14,46,30.4,19,37,51.35,24,31,77.4,10,37,47,22,16,9,3,19
1720,HOU,1,48,40,81,49.4,14,41,34.1,26,40,65,20,29,69,9,29,38,23,14,9,9,23
1721,LAC,1,48,40,85,47.1,14,32,43.8,26,53,49.06,20,22,90.9,9,29,38,20,20,13,7,18
1722,CHA,0,48,39,80,48.8,10,29,34.5,29,51,56.86,18,21,85.7,8,27,35,22,19,7,4,24
1723,POR,0,48,33,80,41.3,8,30,26.7,25,50,50,20,28,71.4,7,35,42,24,16,5,3,24
1724,SAC,1,48,53,97,54.6,15,34,44.1,38,63,60.32,21,25,84,12,31,43,24,8,8,7,22
1725,MIN,0,48,38,95,40,17,47,36.2,21,48,43.75,11,17,64.7,9,28,37,19,16,9,3,17
1726,BKN,0,48,35,89,39.3,8,33,24.2,27,56,48.21,26,31,83.9,14,30,44,18,13,7,3,23
1727,NOP,0,53,47,90,52.2,11,30,36.7,36,60,60,9,12,75,10,36,46,32,25,8,5,22
1728,MEM,0,48,36,90,40,9,31,29,27,59,45.76,15,25,60,12,28,40,23,13,14,3,23
1729,CLE,1,48,44,80,55,13,28,46.4,31,52,59.62,14,16,87.5,5,37,42,28,16,10,8,22
1730,CHI,0,48,35,84,41.7,7,26,26.9,28,58,48.28,15,21,71.4,11,26,37,21,18,6,3,17
1731,BOS,0,48,36,82,43.9,10,33,30.3,26,49,53.06,20,29,69,7,27,34,27,13,8,4,16
1732,BKN,1,48,42,83,50.6,8,26,30.8,34,57,59.65,10,13,76.9,8,42,50,28,12,3,4,22
1733,NYK,1,48,43,91,47.3,18,38,47.4,25,53,47.17,17,19,89.5,17,35,52,22,11,7,5,19
1734,LAL,1,48,48,93,51.6,8,27,29.6,40,66,60.61,13,17,76.5,13,38,51,25,16,7,4,21
1735,DAL,0,48,36,90,40,9,46,19.6,27,44,61.36,18,22,81.8,10,29,39,21,4,6,2,15
1736,SAS,0,48,41,92,44.6,12,31,38.7,29,61,47.54,15,20,75,13,30,43,30,10,5,4,18
1737,MIA,0,48,35,76,46.1,6,22,27.3,29,54,53.7,14,17,82.4,7,29,36,26,23,11,6,19
1738,PHX,1,48,43,94,45.7,10,29,34.5,33,65,50.77,12,18,66.7,15,34,49,27,17,6,4,20
1739,PHI,1,53,46,87,52.9,15,36,41.7,31,51,60.78,20,27,74.1,8,41,49,28,15,6,9,19
1740,IND,1,48,43,82,52.4,9,23,39.1,34,59,57.63,21,22,95.5,13,27,40,25,16,10,10,20
1741,GSW,1,48,43,87,49.4,20,40,50,23,47,48.94,20,29,69,7,36,43,28,15,15,2,19
1742,CLE,0,48,35,90,38.9,15,46,32.6,20,44,45.45,19,20,95,7,32,39,27,10,8,4,17
1743,WAS,0,48,43,81,53.1,7,15,46.7,36,66,54.55,17,21,81,9,21,30,25,12,11,2,19
1744,MEM,1,48,38,89,42.7,13,33,39.4,25,56,44.64,16,21,76.2,16,31,47,26,19,11,6,18
1745,CHI,1,48,41,91,45.1,13,35,37.1,28,56,50,14,20,70,13,42,55,25,11,4,7,15
1746,MIL,1,48,40,86,46.5,13,32,40.6,27,54,50,19,24,79.2,8,45,53,21,17,7,5,20
1747,DET,0,48,41,99,41.4,16,41,39,25,58,43.1,5,6,83.3,16,36,52,21,17,8,7,26
1748,MIN,0,48,39,98,39.8,17,40,42.5,22,58,37.93,15,19,78.9,16,34,50,22,8,9,5,17
1749,ORL,0,48,33,76,43.4,11,38,28.9,22,38,57.89,18,22,81.8,5,33,38,18,23,10,4,20
1750,DEN,0,48,38,96,39.6,11,32,34.4,27,64,42.19,10,15,66.7,11,39,50,30,11,5,2,17
1751,POR,0,48,35,79,44.3,5,22,22.7,30,57,52.63,15,20,75,7,38,45,16,18,6,6,19
1752,OKC,1,48,41,82,50,9,25,36,32,57,56.14,23,30,76.7,6,34,40,22,11,10,11,13
1753,LAC,1,48,41,92,44.6,11,36,30.6,30,56,53.57,9,14,64.3,7,30,37,18,13,8,7,21
1754,CHA,0,53,48,107,44.9,16,46,34.8,32,61,52.46,12,17,70.6,13,29,42,31,8,6,6,18
1755,SAS,0,48,40,93,43,11,29,37.9,29,64,45.31,13,19,68.4,9,32,41,31,15,12,6,18
1756,ATL,1,48,40,90,44.4,25,49,51,15,41,36.59,16,19,84.2,11,38,49,31,12,5,8,20
1757,UTA,1,48,40,90,44.4,20,48,41.7,20,42,47.62,9,10,90,14,32,46,24,17,8,5,14
1758,ATL,0,48,48,93,51.6,17,37,45.9,31,56,55.36,14,18,77.8,10,35,45,29,11,4,3,19
1759,WAS,0,48,30,73,41.1,8,25,32,22,48,45.83,22,29,75.9,6,37,43,20,10,4,5,22
1760,NOP,0,48,40,94,42.6,10,38,26.3,30,56,53.57,18,25,72,22,28,50,19,8,9,9,26
1761,TOR,1,48,38,85,44.7,8,23,34.8,30,62,48.39,18,24,75,10,37,47,22,8,3,1,24
1762,CHA,1,48,46,86,53.5,17,37,45.9,29,49,59.18,21,28,75,7,32,39,21,6,9,3,18
1763,CLE,0,48,42,91,46.2,14,38,36.8,28,53,52.83,10,13,76.9,15,30,45,20,14,12,5,8
1764,HOU,1,48,39,79,49.4,17,40,42.5,22,39,56.41,23,29,79.3,11,29,40,24,14,3,3,23
1765,GSW,0,48,40,90,44.4,13,39,33.3,27,51,52.94,14,21,66.7,11,34,45,26,13,6,2,18
1766,CHI,1,48,41,86,47.7,10,31,32.3,31,55,56.36,19,27,70.4,7,40,47,22,9,4,10,12
1767,POR,0,48,42,89,47.2,8,29,27.6,34,60,56.67,25,32,78.1,9,23,32,22,9,7,2,21
1768,MIA,0,48,34,84,40.5,17,43,39.5,17,41,41.46,17,24,70.8,9,30,39,29,15,6,5,17
1769,DAL,0,48,31,92,33.7,15,43,34.9,16,49,32.65,13,19,68.4,14,28,42,19,15,10,1,21
1770,SAC,1,48,36,86,41.9,12,34,35.3,24,52,46.15,20,25,80,11,40,51,19,17,8,8,25
1771,SAS,1,48,42,88,47.7,12,35,34.3,30,53,56.6,16,19,84.2,11,34,45,24,12,10,4,17
1772,LAC,0,48,34,89,38.2,13,34,38.2,21,55,38.18,18,27,66.7,9,38,47,23,18,7,3,24
1773,NYK,0,48,35,88,39.8,12,40,30,23,48,47.92,17,21,81,16,24,40,23,11,7,3,12
1774,BKN,0,48,46,111,41.4,8,25,32,38,86,44.19,7,9,77.8,15,40,55,28,7,8,6,19
1775,DEN,1,48,44,84,52.4,20,43,46.5,24,41,58.54,5,5,100,8,34,42,30,13,10,5,19
1776,MIL,1,48,44,98,44.9,18,50,36,26,48,54.17,18,20,90,19,38,57,32,14,3,6,22
1777,BOS,1,48,49,87,56.3,21,37,56.8,28,50,56,26,29,89.7,12,34,46,26,12,5,7,21
1778,MEM,1,48,37,76,48.7,9,26,34.6,28,50,56,14,24,58.3,10,42,52,20,23,10,5,23
1779,NOP,1,48,37,90,41.1,12,30,40,25,60,41.67,21,28,75,13,42,55,30,10,5,5,26
1780,IND,0,48,35,80,43.8,9,36,25,26,44,59.09,25,33,75.8,12,27,39,20,13,7,3,19
1781,DAL,0,48,32,79,40.5,10,34,29.4,22,45,48.89,17,26,65.4,5,37,42,17,15,4,3,23
1782,PHI,1,48,38,81,46.9,9,22,40.9,29,59,49.15,13,17,76.5,6,34,40,22,11,8,5,24
1783,CLE,1,48,42,89,47.2,13,30,43.3,29,59,49.15,19,25,76,15,39,54,30,16,2,5,19
1784,BKN,1,48,36,76,47.4,6,23,26.1,30,53,56.6,32,41,78,7,34,41,26,17,4,4,31
1785,HOU,1,48,44,92,47.8,17,47,36.2,27,45,60,13,15,86.7,7,28,35,33,12,7,5,16
1786,WAS,0,48,38,82,46.3,10,31,32.3,28,51,54.9,15,19,78.9,3,30,33,21,10,5,4,22
1787,UTA,1,48,45,81,55.6,27,51,52.9,18,30,60,20,23,87,9,35,44,26,20,3,3,27
1788,ATL,0,48,31,76,40.8,10,28,35.7,21,48,43.75,24,30,80,11,36,47,20,15,5,3,20
1789,PHX,0,48,31,81,38.3,8,22,36.4,23,59,38.98,26,35,74.3,9,29,38,23,16,9,3,15
1790,ORL,0,48,42,86,48.8,13,37,35.1,29,49,59.18,19,21,90.5,10,35,45,24,18,6,4,21
1791,LAL,0,48,45,90,50,12,33,36.4,33,57,57.89,13,21,61.9,13,30,43,28,12,8,3,19
1792,BOS,0,48,47,91,51.6,14,39,35.9,33,52,63.46,22,22,100,5,25,30,23,6,9,3,22
1793,GSW,1,48,45,92,48.9,19,39,48.7,26,53,49.06,9,12,75,11,40,51,30,17,10,8,29
1794,MIA,1,48,43,81,53.1,16,34,47.1,27,47,57.45,11,13,84.6,9,29,38,24,13,5,6,22
1795,LAC,1,48,41,81,50.6,16,35,45.7,25,46,54.35,21,24,87.5,6,28,34,28,10,5,3,19
1796,MIN,0,48,36,93,38.7,13,42,31,23,51,45.1,20,24,83.3,16,28,44,22,18,5,4,25
1797,DET,0,48,36,80,45,11,27,40.7,25,53,47.17,20,26,76.9,7,29,36,20,13,6,6,22
1798,POR,0,48,29,82,35.4,12,34,35.3,17,48,35.42,13,17,76.5,8,33,41,19,18,8,6,20
1799,OKC,0,48,25,76,32.9,11,38,28.9,14,38,36.84,18,22,81.8,8,18,26,14,20,2,5,14
1800,MIL,0,48,32,85,37.6,11,31,35.5,21,54,38.89,18,25,72,16,31,47,16,15,4,4,12
1801,SAS,1,48,44,91,48.4,14,36,38.9,30,55,54.55,12,16,75,6,42,48,32,14,10,5,15
1802,NYK,0,48,42,82,51.2,9,26,34.6,33,56,58.93,22,27,81.5,10,29,39,19,18,10,8,20
1803,MEM,1,48,60,96,62.5,19,36,52.8,41,60,68.33,13,18,72.2,14,39,53,41,10,16,9,15
1804,CHI,1,48,44,89,49.4,11,29,37.9,33,60,55,20,21,95.2,13,26,39,24,15,10,8,22
1805,TOR,1,48,37,88,42,14,40,35,23,48,47.92,9,14,64.3,15,32,47,23,14,10,7,24
1806,PHX,1,48,43,79,54.4,12,21,57.1,31,58,53.45,16,23,69.6,6,38,44,23,15,8,3,20
1807,OKC,0,48,40,85,47.1,8,32,25,32,53,60.38,22,29,75.9,10,25,35,16,13,9,6,21
1808,IND,0,48,44,90,48.9,10,33,30.3,34,57,59.65,13,16,81.3,8,32,40,23,10,8,4,18
1809,CHA,0,48,43,87,49.4,21,51,41.2,22,36,61.11,18,21,85.7,3,33,36,30,17,8,9,21
1810,PHI,0,48,33,89,37.1,8,31,25.8,25,58,43.1,13,17,76.5,8,38,46,20,7,7,9,17
1811,BOS,1,48,33,79,41.8,11,28,39.3,22,51,43.14,11,15,73.3,4,42,46,18,13,5,8,15
1812,MIL,1,48,46,94,48.9,14,36,38.9,32,58,55.17,21,26,80.8,9,36,45,29,13,10,1,20
1813,ATL,1,48,44,86,51.2,16,33,48.5,28,53,52.83,10,12,83.3,7,34,41,24,13,4,8,15
1814,HOU,1,48,40,79,50.6,15,37,40.5,25,42,59.52,19,22,86.4,8,32,40,25,19,9,12,25
1815,ORL,1,48,44,81,54.3,6,27,22.2,38,54,70.37,14,19,73.7,1,38,39,26,13,8,6,15
1816,DEN,0,48,39,80,48.8,10,34,29.4,29,46,63.04,15,21,71.4,1,34,35,22,15,5,4,19
1817,WAS,1,48,45,91,49.5,10,32,31.3,35,59,59.32,15,21,71.4,14,38,52,34,14,6,7,23
1818,SAC,1,48,46,88,52.3,15,38,39.5,31,50,62,17,20,85,7,31,38,28,12,8,1,16
1819,MIN,0,48,37,88,42,11,37,29.7,26,51,50.98,22,26,84.6,12,27,39,15,13,3,6,23
1820,DAL,1,48,57,83,68.7,18,34,52.9,39,49,79.59,7,9,77.8,9,25,34,32,18,7,2,19
1821,CLE,1,48,37,68,54.4,16,31,51.6,21,37,56.76,21,23,91.3,6,40,46,27,21,8,14,15
1822,LAC,0,48,47,100,47,9,31,29,38,69,55.07,12,16,75,17,32,49,35,13,8,6,15
1823,NOP,0,48,40,89,44.9,13,37,35.1,27,52,51.92,14,16,87.5,16,16,32,22,16,10,1,12
1824,MIA,0,48,32,85,37.6,12,37,32.4,20,48,41.67,9,13,69.2,9,19,28,21,13,8,4,17
1825,TOR,0,48,36,91,39.6,10,39,25.6,26,52,50,9,12,75,11,33,44,14,18,7,9,21
1826,GSW,0,48,36,86,41.9,14,40,35,22,46,47.83,10,14,71.4,15,36,51,25,23,7,5,13
1827,SAC,0,48,35,79,44.3,6,29,20.7,29,50,58,16,22,72.7,9,31,40,22,20,11,4,21
1828,LAL,1,48,46,92,50,11,28,39.3,35,64,54.69,14,20,70,10,37,47,21,15,10,6,20
1829,NYK,0,48,44,91,48.4,11,32,34.4,33,59,55.93,11,12,91.7,10,32,42,27,11,5,2,21
1830,PHX,1,48,43,87,49.4,12,30,40,31,57,54.39,6,11,54.5,8,27,35,28,13,12,4,12
1831,DET,0,48,29,76,38.2,9,35,25.7,20,41,48.78,25,30,83.3,7,38,45,17,19,4,7,20
1832,MEM,1,48,36,93,38.7,10,34,29.4,26,59,44.07,16,19,84.2,18,36,54,18,17,13,10,15
1833,BKN,1,48,41,85,48.2,8,28,28.6,33,57,57.89,22,25,88,9,29,38,27,9,7,7,14
1834,POR,1,48,41,96,42.7,14,42,33.3,27,54,50,14,18,77.8,10,33,43,24,11,8,5,22
1835,ORL,0,48,37,90,41.1,8,33,24.2,29,57,50.88,14,18,77.8,8,47,55,20,12,7,6,21
1836,OKC,0,48,31,87,35.6,7,43,16.3,24,44,54.55,20,26,76.9,4,41,45,16,13,10,10,14
1837,IND,0,48,36,91,39.6,9,37,24.3,27,54,50,17,21,81,8,39,47,27,14,6,3,18
1838,UTA,1,48,47,89,52.8,19,46,41.3,28,43,65.12,16,23,69.6,8,35,43,30,5,6,3,19
1839,CHA,0,48,42,88,47.7,18,39,46.2,24,49,48.98,17,21,81,5,29,34,23,9,7,9,14
1840,MIN,1,48,36,82,43.9,9,35,25.7,27,47,57.45,19,26,73.1,8,39,47,25,14,8,5,25
1841,NOP,1,48,48,94,51.1,14,35,40,34,59,57.63,13,16,81.3,14,33,47,30,8,11,1,21
1842,CLE,1,48,45,80,56.3,10,19,52.6,35,61,57.38,14,18,77.8,5,43,48,29,20,3,4,22
1843,CHI,1,48,53,89,59.6,14,30,46.7,39,59,66.1,13,19,68.4,5,36,41,35,11,3,5,19
1844,PHI,1,48,39,97,40.2,10,33,30.3,29,64,45.31,13,18,72.2,12,43,55,24,11,7,6,19
1845,HOU,1,48,40,96,41.7,15,46,32.6,25,50,50,7,11,63.6,9,51,60,31,14,7,5,19
1846,POR,0,48,42,91,46.2,11,31,35.5,31,60,51.67,12,17,70.6,12,30,42,19,9,1,3,18
1847,LAC,0,48,37,72,51.4,14,36,38.9,23,36,63.89,16,21,76.2,4,31,35,17,15,2,2,16
1848,DEN,1,48,43,74,58.1,18,35,51.4,25,39,64.1,16,21,76.2,5,30,35,32,13,2,1,18
1849,DAL,0,48,39,89,43.8,12,39,30.8,27,50,54,6,15,40,7,26,33,20,10,8,7,15
1850,SAS,1,48,49,92,53.3,8,18,44.4,41,74,55.41,10,16,62.5,15,36,51,28,10,4,6,15
1851,MIA,0,48,43,91,47.3,15,44,34.1,28,47,59.57,10,15,66.7,12,27,39,32,9,2,1,18
1852,WAS,0,48,41,92,44.6,9,31,29,32,61,52.46,8,13,61.5,12,28,40,26,7,5,3,15
1853,IND,0,48,38,92,41.3,12,45,26.7,26,47,55.32,12,16,75,12,33,45,21,13,6,2,21
1854,LAC,0,48,32,80,40,9,28,32.1,23,52,44.23,17,25,68,15,32,47,18,25,8,3,21
1855,MIL,1,48,46,90,51.1,8,35,22.9,38,55,69.09,18,22,81.8,13,39,52,27,14,7,3,14
1856,BOS,1,48,34,82,41.5,12,34,35.3,22,48,45.83,29,31,93.5,12,41,53,24,18,5,3,19
1857,TOR,0,48,35,93,37.6,13,42,31,22,51,43.14,14,16,87.5,14,30,44,19,11,6,5,24
1858,SAC,0,48,33,97,34,9,42,21.4,24,55,43.64,26,37,70.3,12,37,49,17,8,5,8,18
1859,LAL,1,48,43,86,50,9,32,28.1,34,54,62.96,15,25,60,6,36,42,32,12,11,8,18
1860,DET,0,48,38,89,42.7,13,33,39.4,25,56,44.64,17,19,89.5,12,41,53,29,17,5,4,20
1861,MEM,1,48,50,104,48.1,13,39,33.3,37,65,56.92,15,20,75,14,54,68,30,10,4,11,25
1862,GSW,1,48,38,86,44.2,17,40,42.5,21,46,45.65,12,22,54.5,11,32,43,25,17,19,2,27
1863,HOU,1,53,51,95,53.7,23,49,46.9,28,46,60.87,21,31,67.7,10,31,41,36,15,5,4,25
1864,MIA,1,48,37,86,43,14,40,35,23,46,50,19,22,86.4,9,27,36,23,10,13,1,19
1865,ATL,0,48,33,93,35.5,9,37,24.3,24,56,42.86,15,20,75,13,39,52,18,7,8,6,17
1866,PHX,1,48,41,92,44.6,13,38,34.2,28,54,51.85,18,21,85.7,11,30,41,17,13,11,1,17
1867,WAS,1,48,45,78,57.7,9,24,37.5,36,54,66.67,21,26,80.8,7,36,43,28,15,4,4,18
1868,MIN,1,58,48,96,50,14,36,38.9,34,60,56.67,11,16,68.8,11,43,54,22,21,7,6,31
1869,UTA,1,48,45,80,56.3,20,35,57.1,25,45,55.56,17,22,77.3,7,34,41,24,18,9,4,25
1870,ORL,0,48,35,88,39.8,8,32,25,27,56,48.21,14,23,60.9,8,35,43,21,9,11,5,16
1871,PHI,0,58,39,93,41.9,12,34,35.3,27,59,45.76,30,39,76.9,12,32,44,27,16,13,5,25
1872,NYK,1,48,36,82,43.9,11,29,37.9,25,53,47.17,16,22,72.7,8,42,50,20,10,4,3,17
1873,NOP,0,48,40,93,43,8,35,22.9,32,58,55.17,17,21,81,14,31,45,27,15,8,3,20
1874,CHA,0,53,48,103,46.6,20,50,40,28,53,52.83,27,30,90,16,23,39,31,11,10,5,23
1875,CHI,0,48,38,81,46.9,11,39,28.2,27,42,64.29,17,21,81,10,37,47,22,23,6,4,20
1876,CLE,1,48,41,90,45.6,14,39,35.9,27,51,52.94,9,12,75,10,41,51,28,13,3,9,18
1877,DAL,0,48,42,89,47.2,14,38,36.8,28,51,54.9,16,22,72.7,9,26,35,23,7,7,4,21
1878,BKN,0,48,42,84,50,7,23,30.4,35,61,57.38,16,21,76.2,10,37,47,25,20,7,5,15
1879,MIL,1,48,46,73,63,16,33,48.5,30,40,75,12,20,60,5,39,44,24,22,3,7,14
1880,OKC,0,48,38,94,40.4,11,33,33.3,27,61,44.26,12,14,85.7,10,31,41,23,10,7,4,15
1881,NYK,0,48,34,92,37,12,39,30.8,22,53,41.51,17,22,77.3,17,34,51,13,16,7,1,20
1882,BOS,0,48,34,92,37,10,34,29.4,24,58,41.38,10,15,66.7,12,39,51,20,11,4,8,20
1883,UTA,0,48,36,80,45,13,33,39.4,23,47,48.94,12,18,66.7,9,34,43,17,18,6,8,22
1884,GSW,1,48,47,87,54,12,37,32.4,35,50,70,12,16,75,11,37,48,31,15,8,5,19
1885,IND,1,48,47,97,48.5,11,39,28.2,36,58,62.07,9,11,81.8,17,36,53,31,13,6,4,19
1886,MIN,0,48,45,100,45,11,35,31.4,34,65,52.31,14,19,73.7,15,30,45,24,12,8,6,20
1887,LAL,0,63,51,102,50,15,44,34.1,36,58,62.07,20,28,71.4,9,42,51,32,19,9,6,27
1888,CHA,1,48,49,88,55.7,23,40,57.5,26,48,54.17,12,15,80,7,37,44,32,16,5,7,21
1889,POR,0,48,36,86,41.9,13,38,34.2,23,48,47.92,18,23,78.3,7,30,37,23,10,7,2,13
1890,LAC,1,48,39,91,42.9,11,38,28.9,28,53,52.83,18,19,94.7,11,43,54,26,15,9,4,27
1891,NOP,1,48,38,89,42.7,11,27,40.7,27,62,43.55,11,13,84.6,6,33,39,27,14,8,4,21
1892,SAS,1,48,38,87,43.7,6,24,25,32,63,50.79,14,19,73.7,8,45,53,21,11,7,6,15
1893,PHX,1,48,44,79,55.7,13,28,46.4,31,51,60.78,17,21,81,1,34,35,28,11,10,2,19
1894,DET,0,48,33,90,36.7,8,33,24.2,25,57,43.86,22,26,84.6,13,39,52,17,15,8,4,19
1895,MEM,0,48,37,91,40.7,12,38,31.6,25,53,47.17,14,19,73.7,10,26,36,27,13,8,7,19
1896,WAS,1,48,38,79,48.1,10,29,34.5,28,50,56,15,15,100,5,38,43,17,15,2,12,15
1897,SAC,1,63,54,120,45,14,45,31.1,40,75,53.33,19,29,65.5,16,40,56,32,15,11,4,26
1898,DEN,0,48,40,92,43.5,17,47,36.2,23,45,51.11,12,14,85.7,9,22,31,24,8,9,2,19
1899,ATL,1,48,52,89,58.4,13,27,48.1,39,62,62.9,15,21,71.4,9,40,49,33,12,8,5,15
1900,ORL,0,48,30,80,37.5,7,32,21.9,23,48,47.92,21,30,70,5,31,36,18,15,7,5,16
1901,CHI,1,48,48,86,55.8,17,34,50,31,52,59.62,10,16,62.5,6,41,47,32,14,11,1,24
1902,TOR,0,48,37,89,41.6,7,30,23.3,30,59,50.85,16,22,72.7,13,28,41,17,11,8,3,18
1903,BKN,1,48,43,85,50.6,14,35,40,29,50,58,23,30,76.7,10,40,50,29,10,8,4,23
1904,ATL,1,48,45,88,51.1,12,26,46.2,33,62,53.23,22,24,91.7,8,36,44,26,11,10,5,11
1905,SAC,1,48,45,86,52.3,12,33,36.4,33,53,62.26,23,34,67.6,14,29,43,21,14,4,4,21
1906,UTA,1,48,39,86,45.3,15,47,31.9,24,39,61.54,17,20,85,7,36,43,19,10,11,8,15
1907,LAL,1,53,42,95,44.2,15,37,40.5,27,58,46.55,25,29,86.2,9,43,52,20,12,5,4,21
1908,POR,0,48,44,94,46.8,12,38,31.6,32,56,57.14,21,25,84,13,30,43,27,15,9,1,26
1909,WAS,0,48,36,84,42.9,7,31,22.6,29,53,54.72,23,36,63.9,13,32,45,23,19,5,3,23
1910,IND,0,53,42,104,40.4,13,46,28.3,29,58,50,19,24,79.2,14,38,52,25,11,3,5,25
1911,CHI,0,48,44,96,45.8,15,35,42.9,29,61,47.54,10,12,83.3,8,32,40,26,14,12,6,22
1912,GSW,1,48,42,80,52.5,15,38,39.5,27,42,64.29,17,24,70.8,4,37,41,32,16,7,5,21
1913,MIA,0,48,33,74,44.6,15,42,35.7,18,32,56.25,20,29,69,4,36,40,25,21,6,2,25
1914,OKC,0,48,37,82,45.1,15,36,41.7,22,46,47.83,15,22,68.2,4,39,43,21,13,7,4,18
1915,CLE,0,48,43,97,44.3,12,39,30.8,31,58,53.45,17,25,68,13,31,44,22,10,7,0,23
1916,MIL,1,48,42,87,48.3,15,36,41.7,27,51,52.94,15,17,88.2,10,46,56,23,16,5,6,18
1917,BOS,0,48,34,91,37.4,11,48,22.9,23,43,53.49,25,28,89.3,15,30,45,25,11,6,5,24
1918,CHA,1,48,39,93,41.9,12,40,30,27,53,50.94,16,21,76.2,12,37,49,26,10,11,11,16
1919,PHX,1,48,45,86,52.3,8,22,36.4,37,64,57.81,22,28,78.6,10,37,47,26,15,4,2,23
1920,HOU,1,48,42,84,50,17,36,47.2,25,48,52.08,17,22,77.3,7,39,46,27,22,5,6,16
1921,MIN,1,48,38,93,40.9,18,55,32.7,20,38,52.63,19,21,90.5,15,37,52,24,18,10,7,26
1922,ORL,0,48,38,93,40.9,15,42,35.7,23,51,45.1,8,10,80,10,41,51,23,15,5,1,19
1923,NOP,1,48,44,96,45.8,12,29,41.4,32,67,47.76,27,32,84.4,12,40,52,33,11,13,2,26
1924,MEM,0,48,42,82,51.2,9,29,31,33,53,62.26,20,26,76.9,11,29,40,25,15,6,3,20
1925,SAS,0,48,43,100,43,12,33,36.4,31,67,46.27,8,10,80,15,29,44,27,12,8,4,16
1926,DET,0,48,34,95,35.8,11,45,24.4,23,50,46,14,19,73.7,9,35,44,16,9,7,1,18
1927,PHI,0,48,34,80,42.5,8,28,28.6,26,52,50,20,22,90.9,8,33,41,17,21,10,7,22
1928,TOR,1,48,47,89,52.8,14,30,46.7,33,59,55.93,18,21,85.7,11,23,34,25,10,8,4,20
1929,LAL,0,48,34,91,37.4,11,36,30.6,23,55,41.82,21,30,70,13,37,50,23,12,8,3,17
1930,DAL,1,53,39,89,43.8,12,39,30.8,27,50,54,22,27,81.5,12,30,42,22,15,11,5,23
1931,DEN,0,48,38,78,48.7,15,33,45.5,23,45,51.11,9,11,81.8,7,30,37,26,19,6,5,15
1932,MIA,1,48,35,76,46.1,9,29,31,26,47,55.32,21,29,72.4,12,39,51,22,17,9,3,19
1933,DET,0,48,35,84,41.7,10,38,26.3,25,46,54.35,12,14,85.7,9,26,35,22,15,7,1,23
1934,POR,1,48,45,88,51.1,15,39,38.5,30,49,61.22,14,20,70,12,31,43,25,9,12,7,18
1935,LAC,0,53,35,85,41.2,10,32,31.3,25,53,47.17,24,29,82.8,12,35,47,17,19,5,3,24
1936,NYK,1,48,37,82,45.1,15,34,44.1,22,48,45.83,17,21,81,7,45,52,23,17,7,4,23
1937,CHI,0,48,31,85,36.5,6,28,21.4,25,57,43.86,9,15,60,5,33,38,13,9,6,2,16
1938,ORL,0,48,34,93,36.6,11,41,26.8,23,52,44.23,13,18,72.2,15,32,47,16,16,6,4,17
1939,BOS,1,48,39,92,42.4,12,35,34.3,27,57,47.37,18,19,94.7,11,47,58,19,15,10,3,24
1940,NOP,0,48,37,88,42,6,32,18.8,31,56,55.36,16,18,88.9,15,33,48,24,23,6,6,23
1941,WAS,0,48,36,94,38.3,9,37,24.3,27,57,47.37,22,27,81.5,20,45,65,23,18,6,6,20
1942,UTA,0,48,41,87,47.1,17,43,39.5,24,44,54.55,19,25,76,10,36,46,26,14,5,10,20
1943,ATL,1,48,42,87,48.3,14,34,41.2,28,53,52.83,15,16,93.8,8,36,44,25,8,6,6,16
1944,PHX,1,48,45,88,51.1,12,27,44.4,33,61,54.1,13,16,81.3,11,33,44,25,15,10,0,18
1945,CHA,1,48,40,91,44,15,31,48.4,25,60,41.67,14,24,58.3,6,30,36,21,10,11,4,22
1946,MEM,1,48,42,95,44.2,13,35,37.1,29,60,48.33,22,27,81.5,16,34,50,24,7,10,4,20
1947,PHI,1,48,36,85,42.4,9,32,28.1,27,53,50.94,21,27,77.8,11,34,45,19,7,9,6,20
1948,SAS,0,48,49,93,52.7,5,20,25,44,73,60.27,8,16,50,11,33,44,23,15,9,4,16
1949,MIL,1,48,44,94,46.8,18,45,40,26,49,53.06,17,24,70.8,13,42,55,28,13,10,7,22
1950,SAC,0,48,33,80,41.3,7,31,22.6,26,49,53.06,21,29,72.4,11,38,49,17,14,4,0,19
1951,OKC,0,48,39,97,40.2,10,38,26.3,29,59,49.15,13,14,92.9,16,34,50,24,10,5,5,15
1952,HOU,0,48,31,83,37.3,11,42,26.2,20,41,48.78,17,24,70.8,4,38,42,19,15,5,4,20
1953,IND,1,48,40,90,44.4,13,31,41.9,27,59,45.76,16,18,88.9,11,48,59,27,13,7,12,15
1954,CLE,0,48,36,93,38.7,14,44,31.8,22,49,44.9,26,29,89.7,14,39,53,24,15,6,5,16
1955,BKN,1,48,45,95,47.4,11,35,31.4,34,60,56.67,16,18,88.9,8,34,42,32,10,6,6,23
1956,MIN,1,48,40,100,40,10,44,22.7,30,56,53.57,20,28,71.4,21,28,49,21,12,14,9,20
1957,NYK,0,48,35,84,41.7,7,27,25.9,28,57,49.12,26,31,83.9,12,32,44,16,14,4,11,25
1958,DET,0,48,43,97,44.3,14,40,35,29,57,50.88,16,21,76.2,8,31,39,27,11,7,6,24
1959,LAL,1,48,45,92,48.9,10,31,32.3,35,61,57.38,21,27,77.8,12,39,51,29,13,7,8,21
1960,DAL,0,48,34,83,41,6,30,20,28,53,52.83,17,18,94.4,8,31,39,21,10,6,5,21
1961,PHX,1,48,46,87,52.9,11,36,30.6,35,51,68.63,23,26,88.5,10,41,51,34,13,7,3,20
1962,GSW,1,48,39,79,49.4,22,45,48.9,17,34,50,19,24,79.2,8,39,47,31,16,5,7,18
1963,CHI,1,48,37,88,42,11,29,37.9,26,59,44.07,24,27,88.9,11,33,44,21,10,5,1,26
1964,LAC,1,48,36,75,48,12,29,41.4,24,46,52.17,13,18,72.2,8,34,42,18,15,5,2,15
1965,DEN,0,48,33,90,36.7,11,38,28.9,22,52,42.31,20,28,71.4,12,30,42,20,10,5,1,22
1966,TOR,0,48,39,99,39.4,15,37,40.5,24,62,38.71,11,20,55,18,29,47,25,11,7,4,21
1967,BOS,1,48,41,88,46.6,17,39,43.6,24,49,48.98,12,14,85.7,8,40,48,28,7,4,7,11
1968,WAS,1,48,36,74,48.6,11,30,36.7,25,44,56.82,20,23,87,9,26,35,22,20,6,2,19
1969,ATL,1,48,43,82,52.4,12,34,35.3,31,48,64.58,17,21,81,8,38,46,24,12,6,6,22
1970,PHI,0,48,41,81,50.6,10,28,35.7,31,53,58.49,19,21,90.5,3,29,32,24,12,7,4,24
1971,MIN,1,48,49,91,53.8,20,41,48.8,29,50,58,20,28,71.4,18,32,50,28,13,12,6,26
1972,NOP,0,48,35,88,39.8,6,18,33.3,29,70,41.43,18,19,94.7,11,41,52,17,16,7,5,14
1973,NYK,1,48,33,78,42.3,18,41,43.9,15,37,40.54,22,26,84.6,4,33,37,25,15,12,7,23
1974,POR,1,48,40,80,50,15,34,44.1,25,46,54.35,23,23,100,5,33,38,23,13,6,7,21
1975,MIL,1,48,37,82,45.1,19,40,47.5,18,42,42.86,24,37,64.9,11,49,60,25,14,6,5,18
1976,HOU,0,48,38,84,45.2,10,39,25.6,28,45,62.22,13,22,59.1,13,35,48,21,22,5,8,21
1977,OKC,0,48,39,96,40.6,18,42,42.9,21,54,38.89,9,16,56.3,15,39,54,23,10,5,0,15
1978,MIA,0,48,38,81,46.9,7,27,25.9,31,54,57.41,17,20,85,10,27,37,21,14,7,3,26
1979,SAC,0,48,41,91,45.1,10,31,32.3,31,60,51.67,13,21,61.9,8,27,35,20,8,8,5,14
1980,CHA,0,48,43,102,42.2,10,40,25,33,62,53.23,9,15,60,20,31,51,26,10,6,2,22
1981,IND,1,48,42,91,46.2,14,38,36.8,28,53,52.83,13,18,72.2,8,38,46,28,11,11,9,16
1982,UTA,1,48,46,91,50.5,17,39,43.6,29,52,55.77,14,17,82.4,14,38,52,20,13,5,2,16
1983,ORL,0,48,39,98,39.8,19,51,37.3,20,47,42.55,11,14,78.6,6,33,39,26,10,5,3,24
1984,MEM,0,48,29,83,34.9,9,32,28.1,20,51,39.22,28,35,80,10,23,33,21,16,7,5,24
1985,SAC,0,48,32,84,38.1,9,37,24.3,23,47,48.94,16,25,64,11,29,40,15,15,8,4,18
1986,CHI,1,48,41,93,44.1,8,31,25.8,33,62,53.23,24,24,100,17,33,50,19,11,7,3,20
1987,PHX,1,48,44,85,51.8,14,29,48.3,30,56,53.57,10,14,71.4,10,43,53,28,18,7,4,22
1988,OKC,0,48,32,91,35.2,12,48,25,20,43,46.51,13,21,61.9,11,42,53,17,12,6,4,22
1989,MIL,1,48,31,83,37.3,12,41,29.3,19,42,45.24,22,26,84.6,6,47,53,21,13,9,5,18
1990,DAL,0,48,37,90,41.1,12,40,30,25,50,50,18,23,78.3,10,30,40,25,10,15,1,17
1991,DEN,0,48,39,82,47.6,14,37,37.8,25,45,55.56,16,20,80,7,31,38,24,14,5,5,22
1992,CHA,1,48,44,81,54.3,12,31,38.7,32,50,64,21,28,75,6,39,45,28,17,8,7,26
1993,BOS,1,48,44,88,50,11,30,36.7,33,58,56.9,31,38,81.6,12,39,51,22,14,7,2,20
1994,TOR,1,48,38,84,45.2,12,31,38.7,26,53,49.06,20,24,83.3,13,40,53,20,17,9,9,24
1995,BKN,1,48,41,91,45.1,10,33,30.3,31,58,53.45,23,25,92,14,29,43,19,11,6,13,19
1996,DET,0,48,32,80,40,14,42,33.3,18,38,47.37,24,30,80,11,24,35,21,13,11,7,22
1997,NOP,1,48,38,87,43.7,13,30,43.3,25,57,43.86,5,8,62.5,12,43,55,19,13,9,1,12
1998,GSW,1,48,38,80,47.5,12,30,40,26,50,52,17,21,81,14,34,48,22,19,8,4,23
1999,LAL,0,48,39,84,46.4,12,30,40,27,54,50,18,24,75,7,26,33,20,12,5,6,29
2000,IND,0,48,41,88,46.6,11,36,30.6,30,52,57.69,25,32,78.1,8,30,38,19,10,10,6,24
2001,LAC,0,48,34,90,37.8,9,37,24.3,25,53,47.17,4,5,80,8,35,43,22,12,7,4,12
2002,ORL,0,48,40,89,44.9,14,38,36.8,26,51,50.98,19,25,76,11,34,45,26,13,7,6,25
2003,MEM,1,48,52,96,54.2,11,26,42.3,41,70,58.57,5,6,83.3,12,35,47,28,12,8,7,17
2004,LAC,0,48,42,90,46.7,16,39,41,26,51,50.98,8,8,100,7,27,34,24,14,6,6,15
2005,MIN,1,48,41,86,47.7,21,49,42.9,20,37,54.05,12,15,80,12,35,47,30,13,5,9,17
2006,PHI,1,48,43,85,50.6,11,29,37.9,32,56,57.14,6,12,50,6,39,45,22,10,5,7,18
2007,GSW,1,48,41,83,49.4,15,43,34.9,26,40,65,7,8,87.5,5,29,34,36,11,12,2,17
2008,DEN,0,48,32,89,36,12,36,33.3,20,53,37.74,13,16,81.3,10,36,46,22,11,6,4,14
2009,SAS,0,48,35,84,41.7,6,32,18.8,29,52,55.77,14,19,73.7,11,31,42,26,12,7,6,12
2010,MIA,1,48,41,82,50,10,26,38.5,31,56,55.36,20,24,83.3,7,34,41,27,6,10,1,13
2011,WAS,0,48,38,77,49.4,15,36,41.7,23,41,56.1,6,10,60,5,32,37,25,17,4,3,19
2012,UTA,1,48,44,80,55,19,46,41.3,25,34,73.53,12,13,92.3,10,36,46,34,24,8,9,18
2013,CLE,0,48,34,80,42.5,12,39,30.8,22,41,53.66,9,16,56.3,13,29,42,22,20,6,3,11
2014,TOR,0,48,39,94,41.5,10,38,26.3,29,56,51.79,15,17,88.2,14,21,35,24,13,10,3,13
2015,CHA,1,48,42,96,43.8,10,32,31.3,32,64,50,3,6,50,16,43,59,30,11,6,8,16
2016,ATL,1,48,41,81,50.6,13,37,35.1,28,44,63.64,15,18,83.3,6,34,40,28,14,9,4,17
2017,MIL,1,48,40,87,46,12,37,32.4,28,50,56,17,24,70.8,9,43,52,22,15,9,4,10
2018,NYK,0,48,37,88,42,16,49,32.7,21,39,53.85,8,12,66.7,11,34,45,25,18,5,7,20
2019,NOP,0,48,33,75,44,10,35,28.6,23,40,57.5,22,28,78.6,10,28,38,18,17,6,3,21
2020,DAL,0,48,38,91,41.8,16,32,50,22,59,37.29,6,6,100,8,41,49,28,10,5,2,14
2021,PHX,1,48,41,93,44.1,13,39,33.3,28,54,51.85,10,14,71.4,8,41,49,27,8,6,7,9
2022,WAS,0,48,33,90,36.7,8,42,19,25,48,52.08,13,16,81.3,11,37,48,23,11,7,5,12
2023,POR,1,48,37,84,44,11,31,35.5,26,53,49.06,27,28,96.4,12,32,44,26,17,10,5,19
2024,LAL,0,48,40,96,41.7,12,43,27.9,28,53,52.83,10,12,83.3,11,37,48,24,13,8,4,19
2025,CHI,0,48,39,83,47,13,29,44.8,26,54,48.15,16,20,80,10,26,36,23,15,7,9,23
2026,BOS,0,48,37,84,44,11,41,26.8,26,43,60.47,14,17,82.4,12,30,42,24,14,9,2,17
2027,HOU,0,48,32,90,35.6,12,42,28.6,20,48,41.67,13,19,68.4,9,37,46,16,14,6,4,14
2028,SAC,0,48,34,93,36.6,10,38,26.3,24,55,43.64,19,25,76,20,27,47,19,20,7,3,22
2029,CLE,0,48,35,89,39.3,11,44,25,24,45,53.33,18,21,85.7,12,38,50,20,14,9,1,17
2030,MIA,1,48,42,87,48.3,15,40,37.5,27,47,57.45,14,17,82.4,10,29,39,29,11,6,2,25
2031,DET,1,48,34,80,42.5,8,28,28.6,26,52,50,21,28,75,8,34,42,16,13,13,5,20
2032,OKC,1,48,41,92,44.6,10,39,25.6,31,53,58.49,9,16,56.3,9,47,56,18,14,10,6,19
2033,MIN,1,48,41,82,50,10,36,27.8,31,46,67.39,15,18,83.3,10,25,35,20,17,8,10,24
2034,ORL,1,48,39,96,40.6,11,38,28.9,28,58,48.28,15,18,83.3,14,37,51,20,15,7,3,19
2035,BKN,1,48,38,83,45.8,12,32,37.5,26,51,50.98,21,25,84,8,39,47,29,12,7,3,20
2036,IND,0,48,33,79,41.8,9,37,24.3,24,42,57.14,14,19,73.7,7,36,43,14,18,5,5,22
2037,GSW,1,48,41,79,51.9,13,40,32.5,28,39,71.79,22,28,78.6,9,44,53,25,22,4,8,27
2038,BKN,0,48,34,88,38.6,10,36,27.8,24,52,46.15,21,27,77.8,9,29,38,21,12,12,2,23
2039,SAS,0,48,41,95,43.2,5,22,22.7,36,73,49.32,5,7,71.4,6,35,41,26,16,10,4,17
2040,LAC,1,48,37,85,43.5,12,38,31.6,25,47,53.19,20,22,90.9,6,46,52,16,21,9,3,13
2041,PHI,0,48,33,90,36.7,6,29,20.7,27,61,44.26,13,17,76.5,6,36,42,19,9,5,5,16
2042,UTA,1,48,46,89,51.7,16,38,42.1,30,51,58.82,12,19,63.2,6,50,56,27,11,5,8,20
2043,PHX,1,48,32,85,37.6,7,31,22.6,25,54,46.3,28,36,77.8,14,38,52,21,15,8,2,23
2044,WAS,1,48,39,84,46.4,10,28,35.7,29,56,51.79,17,25,68,6,36,42,23,6,9,4,22
2045,IND,0,48,32,86,37.2,8,37,21.6,24,49,48.98,12,16,75,9,35,44,16,9,6,6,15
2046,POR,1,48,46,82,56.1,16,36,44.4,30,46,65.22,10,14,71.4,7,32,39,25,14,6,7,15
2047,BOS,1,48,36,78,46.2,10,29,34.5,26,49,53.06,16,20,80,6,40,46,23,14,7,6,16
2048,HOU,0,48,36,95,37.9,11,38,28.9,25,57,43.86,19,26,73.1,14,32,46,24,18,6,5,16
2049,NYK,1,48,37,86,43,11,34,32.4,26,52,50,7,10,70,8,38,46,22,12,1,5,15
2050,LAL,0,48,36,79,45.6,6,32,18.8,30,47,63.83,25,31,80.6,8,35,43,19,19,10,5,15
2051,MEM,1,48,52,96,54.2,16,41,39,36,55,65.45,16,20,80,7,42,49,33,10,14,8,21
2052,OKC,0,48,34,83,41,15,41,36.6,19,42,45.24,7,10,70,9,33,42,26,20,6,10,15
2053,DEN,0,48,40,84,47.6,9,32,28.1,31,52,59.62,12,17,70.6,10,36,46,20,12,4,5,16
2054,SAC,1,48,52,98,53.1,16,33,48.5,36,65,55.38,9,11,81.8,11,36,47,32,14,11,5,17
2055,NOP,0,48,30,74,40.5,11,21,52.4,19,53,35.85,29,34,85.3,7,38,45,20,12,2,3,25
2056,CLE,0,48,32,83,38.6,16,40,40,16,43,37.21,12,16,75,7,35,42,18,14,6,3,18
2057,DAL,1,48,45,90,50,14,36,38.9,31,54,57.41,7,10,70,10,34,44,30,9,7,2,19
2058,ORL,0,48,43,95,45.3,16,43,37.2,27,52,51.92,9,14,64.3,12,29,41,30,16,8,5,27
2059,MIN,0,48,31,85,36.5,13,44,29.5,18,41,43.9,21,27,77.8,13,41,54,18,21,8,3,28
2060,DET,0,48,39,96,40.6,13,47,27.7,26,49,53.06,16,17,94.1,16,31,47,23,18,7,2,10
2061,TOR,0,48,41,89,46.1,15,33,45.5,26,56,46.43,16,18,88.9,12,27,39,20,11,7,2,17
2062,MIA,1,48,37,82,45.1,18,40,45,19,42,45.24,11,13,84.6,8,37,45,22,19,11,5,13
2063,CHI,1,48,49,89,55.1,15,34,44.1,34,55,61.82,8,11,72.7,4,32,36,31,17,9,2,21
2064,ATL,1,48,47,85,55.3,14,30,46.7,33,55,60,21,32,65.6,9,37,46,32,11,10,7,17
2065,PHX,1,48,42,97,43.3,14,40,35,28,57,49.12,17,20,85,12,40,52,19,10,16,7,19
2066,BKN,1,48,41,82,50,18,43,41.9,23,39,58.97,20,21,95.2,7,37,44,31,15,8,3,15
2067,ATL,1,48,47,97,48.5,15,35,42.9,32,62,51.61,11,13,84.6,15,36,51,21,13,6,1,19
2068,GSW,0,48,38,90,42.2,9,39,23.1,29,51,56.86,17,25,68,11,38,49,31,15,8,7,17
2069,POR,0,48,35,80,43.8,13,39,33.3,22,41,53.66,12,13,92.3,8,28,36,22,13,8,4,15
2070,CHA,1,48,42,88,47.7,14,36,38.9,28,52,53.85,8,12,66.7,4,35,39,23,13,10,2,21
2071,OKC,0,48,36,90,40,14,45,31.1,22,45,48.89,10,11,90.9,10,34,44,20,14,9,2,22
2072,HOU,0,48,35,85,41.2,7,32,21.9,28,53,52.83,12,18,66.7,9,39,48,19,23,7,5,19
2073,DEN,1,48,47,90,52.2,19,40,47.5,28,50,56,11,14,78.6,14,35,49,29,11,9,1,14
2074,CHI,1,48,38,86,44.2,11,29,37.9,27,57,47.37,13,14,92.9,7,38,45,19,15,9,4,20
2075,MIL,0,48,38,84,45.2,14,41,34.1,24,43,55.81,10,16,62.5,4,26,30,24,11,8,3,17
2076,SAS,0,48,40,90,44.4,16,36,44.4,24,54,44.44,10,15,66.7,11,32,43,28,15,9,2,17
2077,LAL,1,48,43,83,51.8,15,31,48.4,28,52,53.85,13,17,76.5,9,37,46,28,16,6,5,16
2078,LAC,0,48,29,81,35.8,11,34,32.4,18,47,38.3,21,21,100,9,35,44,16,20,7,7,15
2079,LAC,1,48,53,99,53.5,16,40,40,37,59,62.71,7,9,77.8,11,46,57,35,14,6,8,17
2080,MIN,0,48,40,102,39.2,11,36,30.6,29,66,43.94,11,16,68.8,12,29,41,25,11,8,6,15
2081,MEM,0,48,38,88,43.2,8,24,33.3,30,64,46.88,17,21,81,13,26,39,21,9,6,6,19
2082,WAS,1,48,42,84,50,12,35,34.3,30,49,61.22,8,10,80,7,41,48,29,16,6,7,17
2083,IND,1,48,47,82,57.3,14,28,50,33,54,61.11,10,15,66.7,7,30,37,33,15,7,10,21
2084,MIA,1,48,42,85,49.4,13,33,39.4,29,52,55.77,14,16,87.5,13,35,48,23,21,6,3,25
2085,DET,1,48,43,79,54.4,15,35,42.9,28,44,63.64,26,30,86.7,9,25,34,34,14,5,6,23
2086,NOP,1,48,38,79,48.1,14,29,48.3,24,50,48,22,25,88,8,29,37,29,14,5,6,22
2087,CLE,1,48,31,81,38.3,10,38,26.3,21,43,48.84,19,22,86.4,9,30,39,17,11,10,4,19
2088,TOR,0,48,44,87,50.6,13,34,38.2,31,53,58.49,20,31,64.5,15,24,39,21,13,9,1,25
2089,BOS,0,48,33,78,42.3,6,23,26.1,27,55,49.09,17,18,94.4,10,37,47,20,20,7,3,16
2090,ORL,0,48,31,92,33.7,13,40,32.5,18,52,34.62,17,20,85,14,30,44,21,13,7,5,15
2091,UTA,0,48,35,85,41.2,17,53,32.1,18,32,56.25,18,25,72,12,26,38,23,17,13,2,19
2092,PHI,0,48,38,89,42.7,12,23,52.2,26,66,39.39,25,29,86.2,18,28,46,16,14,11,2,22
2093,CHI,0,48,34,78,43.6,8,27,29.6,26,51,50.98,17,22,77.3,7,31,38,18,20,9,2,16
2094,GSW,1,48,45,93,48.4,15,46,32.6,30,47,63.83,14,16,87.5,12,35,47,27,16,15,3,15
2095,PHX,1,48,46,94,48.9,18,37,48.6,28,57,49.12,9,9,100,4,42,46,28,12,12,6,22
2096,OKC,1,48,42,99,42.4,10,30,33.3,32,69,46.38,11,15,73.3,16,36,52,13,10,8,6,18
2097,MIN,1,48,43,94,45.7,12,37,32.4,31,57,54.39,9,12,75,14,40,54,24,16,10,4,21
2098,MIL,0,53,44,98,44.9,16,47,34,28,51,54.9,9,11,81.8,12,27,39,23,13,7,3,19
2099,NYK,0,48,36,93,38.7,13,35,37.1,23,58,39.66,11,18,61.1,14,37,51,17,19,8,5,22
2100,SAS,0,48,41,84,48.8,13,30,43.3,28,54,51.85,14,20,70,3,38,41,30,13,3,3,17
2101,POR,1,48,34,87,39.1,11,36,30.6,23,51,45.1,25,31,80.6,11,41,52,21,14,10,4,27
2102,BKN,1,48,41,82,50,18,34,52.9,23,48,47.92,20,27,74.1,7,27,34,27,12,9,4,20
2103,MEM,0,48,37,98,37.8,7,33,21.2,30,65,46.15,13,23,56.5,17,42,59,19,15,6,6,16
2104,CLE,1,48,39,82,47.6,14,41,34.1,25,41,60.98,6,9,66.7,8,32,40,27,21,12,6,11
2105,HOU,0,48,34,85,40,7,32,21.9,27,53,50.94,17,27,63,9,40,49,13,13,6,6,23
2106,DET,0,48,29,79,36.7,9,30,30,20,49,40.82,11,13,84.6,10,33,43,18,23,12,5,13
2107,NOP,0,48,43,88,48.9,13,32,40.6,30,56,53.57,13,16,81.3,12,31,43,26,16,6,5,26
2108,SAC,0,48,38,95,40,14,41,34.1,24,54,44.44,13,17,76.5,11,38,49,20,14,5,7,12
2109,LAL,0,48,29,82,35.4,9,41,22,20,41,48.78,16,20,80,11,33,44,17,20,12,8,14
2110,DEN,1,48,40,90,44.4,10,35,28.6,30,55,54.55,15,20,75,10,39,49,26,8,6,5,21
2111,CHA,1,48,39,90,43.3,10,36,27.8,29,54,53.7,16,24,66.7,12,37,49,25,14,10,5,18
2112,ATL,0,48,38,93,40.9,5,28,17.9,33,65,50.77,15,21,71.4,14,36,50,20,8,2,5,20
2113,DAL,1,48,46,100,46,18,45,40,28,55,50.91,13,19,68.4,10,38,48,30,6,9,7,18
2114,BOS,1,53,47,96,49,12,41,29.3,35,55,63.64,16,18,88.9,16,37,53,22,17,5,7,12
2115,LAC,1,48,43,91,47.3,11,37,29.7,32,54,59.26,15,17,88.2,9,33,42,20,12,9,9,14
2116,MIA,0,48,43,97,44.3,9,41,22,34,56,60.71,14,17,82.4,18,32,50,18,15,9,4,21
2117,UTA,0,48,39,83,47,9,32,28.1,30,51,58.82,13,23,56.5,7,30,37,22,12,6,4,16
2118,TOR,1,48,42,96,43.8,14,33,42.4,28,63,44.44,17,17,100,16,31,47,25,12,10,7,18
2119,PHI,0,48,40,88,45.5,11,34,32.4,29,54,53.7,18,19,94.7,9,30,39,29,12,8,8,16
2120,IND,1,48,43,96,44.8,11,31,35.5,32,65,49.23,14,19,73.7,15,38,53,19,13,7,5,23
2121,WAS,1,48,35,84,41.7,10,28,35.7,25,56,44.64,17,17,100,12,37,49,25,12,9,2,20
2122,MEM,0,48,45,107,42.1,9,38,23.7,36,69,52.17,9,15,60,20,37,57,27,16,14,8,18
2123,ORL,0,48,35,92,38,4,33,12.1,31,59,52.54,16,24,66.7,12,37,49,19,17,10,3,18
2124,CLE,0,48,35,76,46.1,9,31,29,26,45,57.78,15,21,71.4,6,34,40,21,15,7,4,18
2125,SAC,0,48,47,91,51.6,10,36,27.8,37,55,67.27,13,16,81.3,11,33,44,20,15,4,6,26
2126,MIN,0,48,39,95,41.1,17,44,38.6,22,51,43.14,15,20,75,17,23,40,30,17,8,4,28
2127,PHX,1,48,49,94,52.1,11,28,39.3,38,66,57.58,10,12,83.3,9,30,39,27,11,6,6,20
2128,TOR,0,48,33,77,42.9,6,25,24,27,52,51.92,16,19,84.2,6,35,41,20,18,8,8,17
2129,NYK,0,48,36,83,43.4,16,37,43.2,20,46,43.48,12,17,70.6,7,31,38,19,11,9,10,17
2130,POR,0,48,44,91,48.4,7,30,23.3,37,61,60.66,14,16,87.5,14,32,46,24,16,5,2,21
2131,NOP,0,48,34,97,35.1,9,35,25.7,25,62,40.32,23,32,71.9,19,31,50,24,10,13,5,20
2132,MIA,0,53,40,96,41.7,10,37,27,30,59,50.85,27,35,77.1,11,36,47,26,14,14,2,25
2133,MIL,1,48,40,90,44.4,26,50,52,14,40,35,6,9,66.7,13,37,50,29,15,4,4,17
2134,LAL,1,53,46,92,50,18,38,47.4,28,54,51.85,10,16,62.5,9,41,50,26,23,5,6,27
2135,HOU,0,48,35,82,42.7,12,34,35.3,23,48,47.92,22,34,64.7,8,34,42,17,16,5,5,20
2136,SAS,1,48,49,92,53.3,18,32,56.3,31,60,51.67,20,31,64.5,12,31,43,34,8,11,3,16
2137,BOS,1,48,42,94,44.7,10,29,34.5,32,65,49.23,10,15,66.7,12,32,44,21,15,10,5,13
2138,DAL,0,48,38,83,45.8,12,33,36.4,26,50,52,19,24,79.2,8,35,43,23,12,9,4,16
2139,GSW,1,48,40,85,47.1,11,40,27.5,29,45,64.44,32,40,80,20,33,53,23,16,14,6,21
2140,BKN,1,48,46,91,50.5,16,37,43.2,30,54,55.56,15,17,88.2,8,41,49,29,15,8,5,18
2141,DET,1,48,42,97,43.3,16,48,33.3,26,49,53.06,12,18,66.7,16,33,49,23,14,6,6,26
2142,CHA,1,48,41,90,45.6,15,36,41.7,26,54,48.15,21,24,87.5,9,40,49,32,17,13,7,16
2143,IND,0,48,40,84,47.6,11,31,35.5,29,53,54.72,7,11,63.6,10,38,48,22,15,5,11,19
2144,OKC,1,48,37,87,42.5,10,34,29.4,27,53,50.94,24,30,80,13,43,56,23,18,6,4,23
2145,CHI,1,48,45,89,50.6,15,31,48.4,30,58,51.72,12,14,85.7,8,38,46,26,11,9,2,15
2146,DEN,1,48,36,84,42.9,12,30,40,24,54,44.44,17,20,85,11,28,39,19,10,5,4,14
2147,LAC,1,48,44,85,51.8,16,30,53.3,28,55,50.91,13,19,68.4,5,38,43,25,8,5,0,17
2148,MIL,1,48,44,95,46.3,15,39,38.5,29,56,51.79,15,21,71.4,12,40,52,21,9,5,6,10
2149,ATL,0,48,37,85,43.5,18,35,51.4,19,50,38,6,10,60,6,26,32,22,13,6,5,18
2150,UTA,1,48,41,81,50.6,15,38,39.5,26,43,60.47,13,16,81.3,8,36,44,21,15,8,4,20
2151,POR,0,48,43,91,47.3,14,37,37.8,29,54,53.7,9,12,75,9,34,43,29,10,6,5,15
2152,PHI,0,48,42,103,40.8,14,43,32.6,28,60,46.67,11,12,91.7,13,33,46,21,7,7,7,20
2153,BKN,0,48,34,86,39.5,11,33,33.3,23,53,43.4,16,19,84.2,6,36,42,19,15,6,7,16
2154,NYK,1,48,40,91,44,13,40,32.5,27,51,52.94,10,13,76.9,14,41,55,25,13,4,4,18
2155,GSW,1,48,44,92,47.8,18,44,40.9,26,48,54.17,21,22,95.5,10,29,39,31,14,13,4,22
2156,CHA,0,53,43,99,43.4,14,42,33.3,29,57,50.88,23,28,82.1,14,41,55,23,18,5,3,23
2157,MIA,0,48,31,78,39.7,13,36,36.1,18,42,42.86,21,25,84,6,31,37,22,13,3,3,20
2158,PHX,1,48,44,93,47.3,12,30,40,32,63,50.79,9,11,81.8,5,33,38,28,15,14,9,21
2159,SAC,0,48,37,82,45.1,10,24,41.7,27,58,46.55,20,26,76.9,8,38,46,18,24,6,6,18
2160,MEM,1,53,46,92,50,11,28,39.3,35,64,54.69,22,26,84.6,15,36,51,28,16,7,8,22
2161,NOP,0,48,37,87,42.5,9,34,26.5,28,53,52.83,9,11,81.8,9,30,39,27,14,7,0,16
2162,DEN,1,48,42,91,46.2,12,41,29.3,30,50,60,17,24,70.8,12,37,49,28,10,7,5,23
2163,MIN,0,53,41,97,42.3,17,45,37.8,24,52,46.15,19,23,82.6,15,30,45,23,16,7,8,27
2164,PHI,0,48,35,91,38.5,13,40,32.5,22,51,43.14,13,16,81.3,12,35,47,20,9,7,6,13
2165,CHI,1,48,46,98,46.9,9,31,29,37,67,55.22,17,20,85,15,41,56,21,9,8,5,17
2166,DAL,1,48,43,85,50.6,14,35,40,29,50,58,8,13,61.5,9,37,46,27,13,7,3,15
2167,ATL,0,48,38,82,46.3,17,43,39.5,21,39,53.85,20,26,76.9,3,32,35,21,18,6,2,16
2168,LAL,1,53,44,91,48.4,13,32,40.6,31,59,52.54,25,35,71.4,8,43,51,30,15,11,8,23
2169,MIL,0,48,37,94,39.4,10,36,27.8,27,58,46.55,10,18,55.6,16,33,49,17,13,14,3,10
2170,OKC,1,48,35,94,37.2,12,42,28.6,23,52,44.23,17,20,85,15,42,57,21,15,5,7,14
2171,BKN,1,48,41,80,51.3,17,38,44.7,24,42,57.14,17,20,85,12,36,48,29,16,3,0,15
2172,TOR,0,48,41,87,47.1,7,30,23.3,34,57,59.65,14,18,77.8,8,27,35,23,8,10,6,16
2173,UTA,0,48,34,89,38.2,8,42,19,26,47,55.32,24,29,82.8,16,34,50,21,18,10,7,17
2174,GSW,1,48,44,85,51.8,15,46,32.6,29,39,74.36,17,20,85,7,34,41,31,17,12,3,28
2175,WAS,1,48,41,81,50.6,11,27,40.7,30,54,55.56,8,13,61.5,4,38,42,24,19,8,8,16
2176,LAC,1,48,41,86,47.7,18,48,37.5,23,38,60.53,20,21,95.2,7,43,50,24,20,8,5,16
2177,CLE,1,48,49,90,54.4,19,35,54.3,30,55,54.55,9,11,81.8,11,37,48,31,17,8,2,18
2178,IND,1,48,37,83,44.6,6,25,24,31,58,53.45,14,18,77.8,13,41,54,13,21,8,7,24
2179,HOU,0,48,36,79,45.6,10,33,30.3,26,46,56.52,25,37,67.6,12,30,42,17,21,11,3,16
2180,CHA,0,48,41,101,40.6,10,33,30.3,31,68,45.59,14,18,77.8,12,32,44,20,13,13,2,21
2181,NYK,0,48,39,85,45.9,9,31,29,30,54,55.56,22,24,91.7,7,25,32,21,11,9,9,14
2182,ORL,1,48,43,87,49.4,12,32,37.5,31,55,56.36,9,11,81.8,7,32,39,24,13,8,8,22
2183,SAC,0,48,31,84,36.9,10,34,29.4,21,50,42,19,22,86.4,8,25,33,20,12,14,6,18
2184,SAS,0,48,41,100,41,6,30,20,35,70,50,6,9,66.7,11,35,46,29,10,9,10,16
2185,UTA,0,48,43,83,51.8,15,45,33.3,28,38,73.68,14,19,73.7,7,24,31,26,6,10,3,19
2186,PHI,1,48,43,81,53.1,13,26,50,30,55,54.55,15,19,78.9,6,35,41,22,14,6,5,22
2187,HOU,0,48,35,75,46.7,8,28,28.6,27,47,57.45,16,24,66.7,7,40,47,19,17,8,6,16
2188,ATL,0,48,42,97,43.3,13,33,39.4,29,64,45.31,20,23,87,14,36,50,18,12,3,1,16
2189,POR,1,48,36,95,37.9,15,55,27.3,21,40,52.5,18,24,75,12,40,52,22,12,14,7,21
2190,PHX,1,48,45,88,51.1,14,43,32.6,31,45,68.89,17,21,81,5,37,42,26,12,8,6,22
2191,MIA,1,48,47,78,60.3,11,21,52.4,36,57,63.16,13,17,76.5,7,29,36,30,14,3,1,18
2192,BOS,0,48,42,86,48.8,9,31,29,33,55,60,11,16,68.8,8,28,36,20,11,6,2,14
2193,DEN,1,48,36,89,40.4,9,40,22.5,27,49,55.1,14,17,82.4,10,35,45,19,11,10,5,20
2194,DAL,1,48,41,78,52.6,13,39,33.3,28,39,71.79,12,14,85.7,7,33,40,19,15,7,6,18
2195,LAL,0,48,31,90,34.4,9,32,28.1,22,58,37.93,19,24,79.2,11,48,59,20,19,8,5,17
2196,CHI,0,48,37,92,40.2,7,29,24.1,30,63,47.62,24,30,80,18,28,46,20,9,7,1,19
2197,POR,1,48,40,82,48.8,17,39,43.6,23,43,53.49,13,15,86.7,6,36,42,27,14,7,4,15
2198,GSW,1,48,47,91,51.6,20,50,40,27,41,65.85,12,14,85.7,9,40,49,36,11,10,4,16
2199,DET,0,48,33,87,37.9,11,34,32.4,22,53,41.51,13,18,72.2,7,37,44,17,14,11,6,22
2200,TOR,0,48,42,99,42.4,12,27,44.4,30,72,41.67,5,9,55.6,19,26,45,20,10,10,8,19
2201,SAS,1,48,40,90,44.4,6,19,31.6,34,71,47.89,16,18,88.9,5,43,48,23,13,11,7,14
2202,MEM,0,48,34,96,35.4,6,31,19.4,28,65,43.08,13,17,76.5,12,27,39,19,9,12,4,15
2203,NYK,1,48,41,96,42.7,10,40,25,31,56,55.36,21,26,80.8,20,39,59,16,15,12,4,17
2204,IND,0,48,43,88,48.9,14,42,33.3,29,46,63.04,6,10,60,7,33,40,28,11,8,2,18
2205,CLE,1,48,38,83,45.8,10,30,33.3,28,53,52.83,16,19,84.2,11,28,39,22,18,4,3,13
2206,NOP,0,48,31,88,35.2,11,44,25,20,44,45.45,12,16,75,11,31,42,23,19,6,3,18
2207,MIL,0,48,33,82,40.2,16,43,37.2,17,39,43.59,16,21,76.2,7,30,37,19,15,5,5,20
2208,MIN,0,48,31,89,34.8,17,52,32.7,14,37,37.84,5,7,71.4,7,35,42,17,22,8,7,33
2209,ORL,0,48,35,89,39.3,12,41,29.3,23,48,47.92,7,10,70,7,36,43,23,18,9,12,13
2210,CHA,0,48,43,92,46.7,11,35,31.4,32,57,56.14,13,21,61.9,7,21,28,29,10,8,5,19
2211,BKN,1,48,36,80,45,11,27,40.7,25,53,47.17,13,14,92.9,4,41,45,25,17,3,4,21
2212,LAC,1,48,36,88,40.9,6,28,21.4,30,60,50,26,32,81.3,15,47,62,18,17,12,4,16
2213,WAS,1,48,49,84,58.3,10,25,40,39,59,66.1,7,13,53.8,5,48,53,34,19,4,6,13
2214,SAC,1,48,48,87,55.2,22,44,50,26,43,60.47,22,26,84.6,13,43,56,29,18,5,1,21
2215,PHI,1,48,41,83,49.4,12,32,37.5,29,51,56.86,15,22,68.2,15,34,49,22,15,8,3,17
2216,LAL,0,48,39,94,41.5,12,33,36.4,27,61,44.26,14,17,82.4,16,33,49,22,14,8,5,21
2217,BOS,1,48,31,78,39.7,16,41,39,15,37,40.54,17,20,85,11,35,46,16,16,7,4,16
2218,PHX,1,48,44,93,47.3,14,31,45.2,30,62,48.39,21,23,91.3,13,33,46,29,12,12,8,24
2219,OKC,1,48,37,87,42.5,15,41,36.6,22,46,47.83,18,26,69.2,12,38,50,23,16,7,2,16
2220,UTA,1,48,41,81,50.6,17,41,41.5,24,40,60,17,23,73.9,8,38,46,30,17,6,4,20
2221,MIA,0,48,28,81,34.6,9,41,22,19,40,47.5,13,19,68.4,13,32,45,18,18,8,0,19
2222,HOU,0,48,38,88,43.2,11,32,34.4,27,56,48.21,24,28,85.7,7,36,43,25,19,4,4,21
2223,ATL,0,48,35,82,42.7,7,28,25,28,54,51.85,21,26,80.8,5,27,32,18,9,11,4,24
2224,DET,0,48,35,87,40.2,11,36,30.6,24,51,47.06,17,19,89.5,12,29,41,21,11,6,2,18
2225,PHI,1,48,38,77,49.4,12,28,42.9,26,49,53.06,15,21,71.4,5,30,35,24,14,9,4,15
2226,NOP,0,48,37,86,43,12,34,35.3,25,52,48.08,13,15,86.7,8,32,40,24,17,1,3,16
2227,BOS,1,48,33,79,41.8,10,37,27,23,42,54.76,16,25,64,9,41,50,24,11,7,9,20
2228,ORL,0,48,27,84,32.1,9,43,20.9,18,41,43.9,16,20,80,8,38,46,15,15,8,1,20
2229,BKN,1,48,43,88,48.9,22,48,45.8,21,40,52.5,9,12,75,7,35,42,34,16,7,8,18
2230,WAS,0,48,34,78,43.6,8,32,25,26,46,56.52,24,30,80,10,34,44,19,13,6,7,15
2231,ATL,0,48,41,94,43.6,13,35,37.1,28,59,47.46,13,15,86.7,12,40,52,23,14,8,4,16
2232,SAS,0,48,43,88,48.9,7,21,33.3,36,67,53.73,15,20,75,5,35,40,25,15,10,10,24
2233,CHA,0,48,34,91,37.4,10,36,27.8,24,55,43.64,14,19,73.7,9,40,49,18,16,10,2,14
2234,GSW,1,48,42,86,48.8,18,45,40,24,41,58.54,12,18,66.7,7,46,53,33,17,14,4,17
2235,TOR,1,48,41,88,46.6,10,25,40,31,63,49.21,17,20,85,10,32,42,17,12,10,3,23
2236,MEM,1,48,42,81,51.9,16,34,47.1,26,47,55.32,8,14,57.1,3,33,36,28,12,9,7,16
2237,IND,1,48,42,91,46.2,16,41,39,26,50,52,11,14,78.6,10,39,49,26,13,7,7,22
2238,MIN,0,48,43,94,45.7,14,40,35,29,54,53.7,15,16,93.8,15,24,39,27,17,11,2,16
2239,POR,0,48,40,90,44.4,13,37,35.1,27,53,50.94,11,17,64.7,10,29,39,24,9,12,6,19
2240,LAC,1,48,47,78,60.3,21,36,58.3,26,42,61.9,11,12,91.7,3,32,35,33,21,6,7,14
2241,CLE,1,48,39,74,52.7,15,30,50,24,44,54.55,14,18,77.8,5,38,43,29,19,4,2,14
2242,NYK,0,48,36,87,41.4,5,24,20.8,31,63,49.21,21,27,77.8,14,32,46,23,10,7,6,19
2243,DEN,0,48,43,91,47.3,8,27,29.6,35,64,54.69,12,13,92.3,11,33,44,24,12,7,4,16
2244,SAC,1,48,42,80,52.5,10,30,33.3,32,50,64,18,22,81.8,4,33,37,27,8,8,7,21
2245,DAL,1,48,40,93,43,8,34,23.5,32,59,54.24,21,29,72.4,15,41,56,21,19,10,4,23
2246,CHI,0,48,38,82,46.3,6,21,28.6,32,61,52.46,16,18,88.9,9,38,47,19,16,11,4,17
2247,DAL,0,48,37,84,44,14,42,33.3,23,42,54.76,22,31,71,11,30,41,17,10,1,3,21
2248,SAC,0,48,42,93,45.2,12,31,38.7,30,62,48.39,17,24,70.8,6,32,38,24,11,8,8,24
2249,HOU,0,48,48,91,52.7,16,42,38.1,32,49,65.31,5,12,41.7,11,27,38,27,25,8,4,21
2250,LAL,1,48,49,93,52.7,6,25,24,43,68,63.24,15,20,75,11,32,43,26,17,10,4,19
2251,UTA,1,48,43,98,43.9,14,48,29.2,29,50,58,19,27,70.4,15,44,59,16,17,7,6,23
2252,NOP,0,48,36,91,39.6,13,39,33.3,23,52,44.23,15,16,93.8,14,29,43,21,18,17,6,16
2253,MIA,1,48,43,83,51.8,13,25,52,30,58,51.72,26,30,86.7,9,36,45,25,7,6,5,25
2254,DET,0,48,30,93,32.3,8,47,17,22,46,47.83,21,30,70,14,29,43,21,14,5,5,22
2255,MIL,1,48,42,84,50,17,37,45.9,25,47,53.19,16,21,76.2,9,43,52,28,17,7,8,23
2256,PHX,1,48,43,82,52.4,9,26,34.6,34,56,60.71,17,18,94.4,7,35,42,32,19,8,4,17
2257,CHA,0,48,42,101,41.6,15,39,38.5,27,62,43.55,11,15,73.3,20,26,46,27,17,12,12,23
2258,BOS,0,48,42,96,43.8,15,33,45.5,27,63,42.86,15,20,75,13,25,38,20,9,10,1,15
2259,SAS,0,48,47,89,52.8,14,28,50,33,61,54.1,10,14,71.4,8,28,36,34,17,6,4,9
2260,NYK,0,48,35,76,46.1,16,38,42.1,19,38,50,18,24,75,7,34,41,20,17,3,4,13
2261,WAS,0,48,41,86,47.7,13,39,33.3,28,47,59.57,16,16,100,7,29,36,27,12,7,4,24
2262,CLE,1,48,39,90,43.3,9,28,32.1,30,62,48.39,26,38,68.4,17,32,49,21,16,12,7,14
2263,ATL,1,48,38,83,45.8,13,34,38.2,25,49,51.02,29,29,100,13,34,47,24,11,9,5,17
2264,OKC,0,48,35,90,38.9,11,37,29.7,24,53,45.28,13,16,81.3,10,41,51,17,16,8,6,18
2265,DEN,0,48,39,88,44.3,9,38,23.7,30,50,60,10,15,66.7,6,34,40,27,12,8,8,10
2266,POR,0,48,40,84,47.6,12,34,35.3,28,50,56,11,18,61.1,13,32,45,21,15,5,2,15
2267,IND,1,48,52,91,57.1,18,38,47.4,34,53,64.15,9,12,75,10,29,39,37,16,11,4,19
2268,MIN,0,48,36,97,37.1,14,51,27.5,22,46,47.83,11,19,57.9,16,31,47,21,14,8,1,20
2269,PHI,1,48,43,83,51.8,13,36,36.1,30,47,63.83,14,16,87.5,7,27,34,34,11,11,6,18
2270,TOR,1,48,43,99,43.4,14,42,33.3,29,57,50.88,13,14,92.9,13,35,48,24,9,12,4,20
2271,LAC,1,48,35,92,38,15,42,35.7,20,50,40,14,19,73.7,13,38,51,18,14,8,5,14
2272,CHI,1,48,49,86,57,13,31,41.9,36,55,65.45,17,18,94.4,10,40,50,30,18,7,8,19
2273,ORL,1,48,37,82,45.1,17,43,39.5,20,39,51.28,24,30,80,12,39,51,21,16,5,7,19
2274,MEM,1,48,44,97,45.4,13,34,38.2,31,63,49.21,5,7,71.4,11,44,55,20,13,8,4,18
2275,DET,0,48,32,79,40.5,12,33,36.4,20,46,43.48,15,22,68.2,7,22,29,21,15,12,3,18
2276,DAL,1,48,40,90,44.4,12,37,32.4,28,53,52.83,13,20,65,10,35,45,24,10,8,4,20
2277,UTA,1,48,35,75,46.7,12,37,32.4,23,38,60.53,25,27,92.6,7,37,44,13,13,6,10,10
2278,BKN,1,48,47,72,65.3,13,25,52,34,47,72.34,10,16,62.5,2,39,41,30,20,7,2,19
2279,HOU,0,48,32,76,42.1,6,28,21.4,26,48,54.17,15,29,51.7,10,45,55,18,27,8,3,18
2280,SAC,0,48,38,96,39.6,7,36,19.4,31,60,51.67,16,20,80,17,39,56,20,13,6,3,19
2281,LAL,1,48,39,96,40.6,9,31,29,30,65,46.15,8,13,61.5,10,33,43,22,14,15,9,20
2282,POR,0,48,43,97,44.3,17,54,31.5,26,43,60.47,10,11,90.9,15,32,47,30,12,4,5,18
2283,MIL,0,48,39,96,40.6,12,41,29.3,27,55,49.09,5,6,83.3,13,31,44,16,11,7,3,22
2284,CHA,1,48,46,89,51.7,20,42,47.6,26,47,55.32,13,21,61.9,10,34,44,36,9,4,6,18
2285,WAS,1,58,38,104,36.5,10,36,27.8,28,68,41.18,29,36,80.6,12,50,62,19,13,6,7,22
2286,UTA,0,48,35,92,38,11,38,28.9,24,54,44.44,18,19,94.7,14,40,54,15,20,5,7,21
2287,PHI,1,48,46,86,53.5,12,38,31.6,34,48,70.83,18,19,94.7,5,32,37,24,12,11,6,24
2288,MIL,0,48,36,89,40.4,10,39,25.6,26,50,52,11,16,68.8,9,43,52,20,21,6,2,18
2289,TOR,1,48,39,92,42.4,11,32,34.4,28,60,46.67,8,12,66.7,12,36,48,18,18,8,4,17
2290,NYK,1,48,42,81,51.9,19,33,57.6,23,48,47.92,20,25,80,5,32,37,22,12,7,4,21
2291,MIA,1,48,46,88,52.3,21,37,56.8,25,51,49.02,16,19,84.2,11,39,50,31,18,12,2,17
2292,DET,1,48,36,89,40.4,14,43,32.6,22,46,47.83,24,30,80,17,31,48,26,16,12,6,18
2293,SAS,1,48,39,95,41.1,7,31,22.6,32,64,50,17,24,70.8,8,41,49,28,10,12,3,13
2294,DEN,1,48,36,88,40.9,9,37,24.3,27,51,52.94,12,16,75,14,34,48,24,18,11,10,15
2295,MEM,0,48,34,88,38.6,16,50,32,18,38,47.37,19,21,90.5,8,24,32,26,14,14,7,17
2296,OKC,0,48,29,83,34.9,8,39,20.5,21,44,47.73,16,21,76.2,3,42,45,14,16,8,6,8
2297,GSW,1,48,39,92,42.4,21,54,38.9,18,38,47.37,4,8,50,10,46,56,30,16,9,8,21
2298,IND,0,48,35,81,43.2,13,43,30.2,22,38,57.89,11,16,68.8,8,32,40,25,20,8,10,17
2299,MIN,0,48,35,89,39.3,13,41,31.7,22,48,45.83,8,9,88.9,15,31,46,21,20,8,6,23
2300,CHI,1,48,39,91,42.9,5,21,23.8,34,70,48.57,24,30,80,9,36,45,16,9,8,5,19
2301,CLE,0,48,36,91,39.6,14,44,31.8,22,47,46.81,6,7,85.7,10,37,47,21,19,8,3,21
2302,ATL,0,48,36,95,37.9,8,22,36.4,28,73,38.36,14,19,73.7,20,29,49,24,19,6,1,17
2303,ORL,0,48,38,87,43.7,16,32,50,22,55,40,11,15,73.3,12,34,46,21,18,5,6,21
2304,BOS,0,58,44,107,41.1,2,26,7.7,42,81,51.85,22,25,88,8,46,54,23,12,8,10,32
2305,PHX,1,48,39,84,46.4,6,26,23.1,33,58,56.9,17,27,63,8,44,52,27,15,12,3,14
2306,NOP,0,48,42,92,45.7,11,33,33.3,31,59,52.54,22,24,91.7,12,31,43,30,12,7,3,24
2307,IND,0,48,37,93,39.8,8,29,27.6,29,64,45.31,16,23,69.6,11,35,46,20,14,9,7,27
2308,MIA,1,48,43,91,47.3,9,35,25.7,34,56,60.71,19,19,100,16,44,60,23,18,6,3,20
2309,DEN,1,48,43,83,51.8,11,36,30.6,32,47,68.09,9,13,69.2,5,46,51,28,20,8,3,24
2310,DAL,0,48,23,78,29.5,8,37,21.6,15,41,36.59,21,27,77.8,6,30,36,14,15,8,3,17
2311,CLE,0,48,37,87,42.5,12,34,35.3,25,53,47.17,15,22,68.2,16,20,36,28,15,10,1,13
2312,NOP,0,48,42,98,42.9,9,34,26.5,33,64,51.56,16,25,64,13,36,49,18,10,9,6,22
2313,POR,1,48,41,98,41.8,19,41,46.3,22,57,38.6,10,16,62.5,16,47,63,21,14,8,6,19
2314,TOR,1,48,43,86,50,9,30,30,34,56,60.71,15,22,68.2,9,31,40,18,8,11,2,18
2315,BKN,1,48,34,76,44.7,6,26,23.1,28,50,56,31,41,75.6,10,40,50,20,18,9,6,21
2316,SAC,1,48,40,80,50,9,27,33.3,31,53,58.49,24,25,96,3,42,45,19,14,4,5,20
2317,LAC,0,48,34,87,39.1,15,42,35.7,19,45,42.22,9,16,56.3,6,37,43,17,13,7,5,14
2318,LAL,1,48,46,84,54.8,12,27,44.4,34,57,59.65,9,10,90,11,31,42,24,22,9,6,20
2319,ORL,0,48,41,87,47.1,16,34,47.1,25,53,47.17,11,16,68.8,12,34,46,24,17,1,5,24
2320,CHA,0,48,35,90,38.9,13,37,35.1,22,53,41.51,16,22,72.7,11,26,37,21,11,8,6,17
2321,SAS,0,48,39,88,44.3,12,30,40,27,58,46.55,9,15,60,11,37,48,21,15,6,11,16
2322,MEM,1,53,39,97,40.2,12,48,25,27,49,55.1,14,14,100,10,41,51,25,18,17,9,14
2323,GSW,0,53,39,90,43.3,14,40,35,25,50,50,9,12,75,7,41,48,29,23,8,7,17
2324,UTA,1,48,41,85,48.2,16,46,34.8,25,39,64.1,24,30,80,10,48,58,24,20,8,4,23
2325,WAS,1,48,46,99,46.5,13,34,38.2,33,65,50.77,17,21,81,14,37,51,26,9,6,4,16
2326,CHI,0,48,36,84,42.9,11,32,34.4,25,52,48.08,20,22,90.9,5,32,37,25,7,6,5,18
2327,PHI,1,48,38,76,50,12,27,44.4,26,49,53.06,22,24,91.7,6,40,46,22,21,7,9,23
2328,DET,0,48,35,86,40.7,13,39,33.3,22,47,46.81,19,27,70.4,10,27,37,22,14,11,4,22
2329,ATL,0,48,48,88,54.5,6,21,28.6,42,67,62.69,9,14,64.3,6,37,43,26,13,4,3,16
2330,DAL,1,48,41,89,46.1,18,45,40,23,44,52.27,4,13,30.8,9,36,45,18,13,4,7,19
2331,NYK,1,48,39,85,45.9,11,29,37.9,28,56,50,15,20,75,11,38,49,16,13,5,7,21
2332,HOU,0,48,31,95,32.6,9,44,20.5,22,51,43.14,20,23,87,13,28,41,15,11,8,3,24
2333,NOP,0,48,40,93,43,11,36,30.6,29,57,50.88,8,9,88.9,9,35,44,24,10,5,6,19
2334,MEM,0,48,35,96,36.5,17,50,34,18,46,39.13,9,19,47.4,21,29,50,27,22,9,3,25
2335,IND,0,48,38,79,48.1,10,29,34.5,28,50,56,14,17,82.4,9,31,40,19,23,6,7,19
2336,OKC,1,48,43,86,50,15,37,40.5,28,49,57.14,22,29,75.9,10,32,42,21,16,8,3,16
2337,TOR,1,48,46,100,46,14,30,46.7,32,70,45.71,12,19,63.2,16,25,41,22,12,18,6,20
2338,BKN,0,48,33,85,38.8,14,43,32.6,19,42,45.24,13,14,92.9,4,38,42,21,16,7,7,24
2339,ORL,0,48,43,88,48.9,15,40,37.5,28,48,58.33,10,13,76.9,8,25,33,22,19,6,2,21
2340,CHA,1,48,43,83,51.8,14,30,46.7,29,53,54.72,20,24,83.3,10,30,40,22,17,14,4,14
2341,BOS,0,48,37,85,43.5,10,29,34.5,27,56,48.21,23,28,82.1,10,27,37,18,13,9,5,21
2342,LAC,0,48,31,87,35.6,9,41,22,22,46,47.83,8,13,61.5,9,27,36,19,14,13,2,24
2343,MIL,0,48,39,95,41.1,14,51,27.5,25,44,56.82,16,21,76.2,13,30,43,22,9,10,3,18
2344,MIA,1,48,38,96,39.6,8,29,27.6,30,67,44.78,22,26,84.6,17,45,62,21,15,6,2,19
2345,ATL,1,48,40,96,41.7,8,30,26.7,32,66,48.48,14,17,82.4,21,34,55,21,11,4,4,14
2346,PHX,0,48,42,93,45.2,6,22,27.3,36,71,50.7,17,24,70.8,14,42,56,23,11,6,6,16
2347,SAC,1,48,42,95,44.2,15,38,39.5,27,57,47.37,11,15,73.3,8,32,40,28,12,7,6,20
2348,LAL,0,48,46,92,50,11,35,31.4,35,57,61.4,12,14,85.7,10,30,40,29,17,8,2,22
2349,MIN,1,48,43,91,47.3,13,45,28.9,30,46,65.22,14,17,82.4,10,39,49,29,17,5,4,20
2350,WAS,1,48,43,84,51.2,9,25,36,34,59,57.63,21,29,72.4,11,36,47,18,16,8,7,20
2351,CLE,1,48,33,81,40.7,3,20,15,30,61,49.18,23,27,85.2,14,43,57,12,21,9,3,14
2352,POR,1,48,39,84,46.4,15,36,41.7,24,48,50,23,31,74.2,13,35,48,22,14,11,6,20
2353,GSW,1,48,39,83,47,14,40,35,25,43,58.14,14,18,77.8,7,39,46,30,15,9,8,20
2354,SAS,0,53,48,108,44.4,13,36,36.1,35,72,48.61,12,22,54.5,16,43,59,33,16,10,6,22
2355,DAL,1,48,43,93,46.2,12,43,27.9,31,50,62,18,25,72,14,36,50,25,15,9,7,22
2356,PHI,0,48,36,82,43.9,12,41,29.3,24,41,58.54,15,17,88.2,12,28,40,24,15,9,4,14
2357,DEN,0,48,42,83,50.6,10,28,35.7,32,55,58.18,16,24,66.7,5,30,35,19,13,9,3,23
2358,HOU,0,48,36,86,41.9,16,39,41,20,47,42.55,18,26,69.2,11,38,49,24,17,7,3,21
2359,UTA,1,48,44,85,51.8,12,39,30.8,32,46,69.57,22,29,75.9,8,33,41,20,14,5,6,22
2360,OKC,0,48,36,86,41.9,12,34,35.3,24,52,46.15,14,17,82.4,9,33,42,19,14,7,3,18
2361,NYK,1,48,41,87,47.1,16,37,43.2,25,50,50,14,15,93.3,13,32,45,24,15,7,5,18
2362,LAL,1,53,50,105,47.6,8,30,26.7,42,75,56,17,22,77.3,9,47,56,20,13,8,10,21
2363,WAS,0,48,33,95,34.7,9,39,23.1,24,56,42.86,15,20,75,10,43,53,16,12,5,5,17
2364,POR,0,48,32,85,37.6,8,37,21.6,24,48,50,14,18,77.8,7,40,47,15,30,11,4,18
2365,MIN,0,48,31,90,34.4,15,50,30,16,40,40,21,27,77.8,11,30,41,20,11,10,7,19
2366,DET,0,48,40,91,44,9,33,27.3,31,58,53.45,15,18,83.3,11,25,36,26,14,7,6,15
2367,BKN,1,48,40,94,42.6,10,35,28.6,30,59,50.85,14,17,82.4,7,47,54,23,9,6,4,19
2368,CHA,0,53,46,103,44.7,19,44,43.2,27,59,45.76,18,28,64.3,14,38,52,26,14,4,6,25
2369,DEN,0,48,35,86,40.7,9,38,23.7,26,48,54.17,8,12,66.7,11,36,47,21,22,10,3,22
2370,ORL,0,48,33,81,40.7,12,44,27.3,21,37,56.76,12,19,63.2,6,33,39,21,18,7,6,22
2371,CHI,1,48,39,81,48.1,12,27,44.4,27,54,50,21,22,95.5,5,24,29,24,13,11,3,16
2372,LAC,1,48,44,93,47.3,14,43,32.6,30,50,60,14,19,73.7,5,38,43,37,17,21,6,23
2373,NOP,1,48,39,87,44.8,10,30,33.3,29,57,50.88,19,23,82.6,15,45,60,19,20,5,5,20
2374,IND,0,48,40,90,44.4,14,36,38.9,26,54,48.15,15,17,88.2,12,35,47,23,19,6,1,24
2375,CLE,1,48,38,82,46.3,7,25,28,31,57,54.39,16,20,80,11,38,49,26,16,8,5,18
2376,TOR,0,48,40,83,48.2,12,30,40,28,53,52.83,16,20,80,13,34,47,27,21,8,1,18
2377,MIL,1,48,41,85,48.2,11,32,34.4,30,53,56.6,26,31,83.9,7,35,42,24,14,13,6,19
2378,ATL,1,48,46,90,51.1,12,32,37.5,34,58,58.62,18,21,85.7,10,39,49,24,16,11,3,19
2379,MIA,1,48,41,87,47.1,6,27,22.2,35,60,58.33,19,19,100,9,33,42,28,11,10,2,19
2380,BOS,1,53,50,101,49.5,19,50,38,31,51,60.78,21,25,84,11,42,53,33,12,8,9,23
2381,GSW,1,48,43,97,44.3,13,37,35.1,30,60,50,20,24,83.3,14,29,43,26,7,12,3,13
2382,NYK,0,48,37,100,37,13,48,27.1,24,52,46.15,17,25,68,16,36,52,20,12,8,8,21
2383,PHI,1,48,41,88,46.6,17,41,41.5,24,47,51.06,16,20,80,12,35,47,25,12,4,9,17
2384,BOS,1,48,38,86,44.2,15,47,31.9,23,39,58.97,16,20,80,6,37,43,22,12,10,6,22
2385,BKN,0,48,38,87,43.7,9,35,25.7,29,52,55.77,10,12,83.3,9,35,44,18,17,10,8,19
2386,LAL,1,48,45,84,53.6,16,30,53.3,29,54,53.7,15,22,68.2,9,27,36,29,17,10,12,14
2387,ORL,1,48,36,88,40.9,12,43,27.9,24,45,53.33,26,34,76.5,10,47,57,22,13,7,4,25
2388,MEM,0,48,45,100,45,13,35,37.1,32,65,49.23,15,18,83.3,18,31,49,25,17,13,4,20
2389,SAC,0,48,42,86,48.8,15,46,32.6,27,40,67.5,8,13,61.5,10,37,47,26,19,0,4,16
2390,OKC,0,48,40,84,47.6,8,31,25.8,32,53,60.38,15,19,78.9,6,36,42,24,11,9,4,17
2391,HOU,0,48,32,75,42.7,14,32,43.8,18,43,41.86,19,24,79.2,5,35,40,20,20,7,4,20
2392,CHA,1,48,43,94,45.7,10,30,33.3,33,64,51.56,15,19,78.9,10,38,48,26,12,10,5,17
2393,POR,1,48,51,94,54.3,21,50,42,30,44,68.18,11,17,64.7,8,40,48,24,9,8,5,15
2394,MIA,0,53,35,91,38.5,9,33,27.3,26,58,44.83,12,14,85.7,10,45,55,18,22,4,2,25
2395,CLE,1,48,37,89,41.6,7,28,25,30,61,49.18,20,27,74.1,12,42,54,23,10,6,6,16
2396,ATL,0,48,38,99,38.4,10,34,29.4,28,65,43.08,9,15,60,17,37,54,20,9,5,3,23
2397,CHI,1,48,35,84,41.7,11,26,42.3,24,58,41.38,16,19,84.2,3,39,42,24,13,13,11,17
2398,MEM,1,48,42,90,46.7,15,36,41.7,27,54,50,21,25,84,13,35,48,26,11,5,3,19
2399,MIN,1,48,39,96,40.6,12,38,31.6,27,58,46.55,6,10,60,13,34,47,22,20,13,8,25
2400,LAC,0,48,43,99,43.4,13,39,33.3,30,60,50,15,17,88.2,14,30,44,23,7,7,4,21
2401,NOP,0,48,31,89,34.8,9,40,22.5,22,49,44.9,18,23,78.3,21,40,61,15,30,10,5,22
2402,TOR,0,48,34,85,40,11,37,29.7,23,48,47.92,16,23,69.6,11,38,49,17,12,7,6,23
2403,IND,1,53,38,97,39.2,10,39,25.6,28,58,48.28,16,21,76.2,14,41,55,18,16,10,5,18
2404,PHX,0,48,43,89,48.3,9,28,32.1,34,61,55.74,10,15,66.7,7,31,38,27,14,6,1,19
2405,DET,0,48,34,88,38.6,5,28,17.9,29,60,48.33,9,15,60,11,42,53,14,23,9,8,17
2406,MIL,1,48,44,83,53,15,35,42.9,29,48,60.42,18,22,81.8,7,37,44,21,22,6,5,15
2407,SAS,0,48,48,99,48.5,10,39,25.6,38,60,63.33,5,6,83.3,10,28,38,29,13,10,4,18
2408,DAL,1,48,38,91,41.8,14,42,33.3,24,49,48.98,13,18,72.2,13,37,50,24,9,6,6,22
2409,TOR,1,48,42,100,42,10,35,28.6,32,65,49.23,21,21,100,21,39,60,22,12,16,2,13
2410,SAS,0,48,40,84,47.6,6,24,25,34,60,56.67,10,14,71.4,7,32,39,24,20,11,2,17
2411,UTA,1,48,37,90,41.1,16,42,38.1,21,48,43.75,20,23,87,13,38,51,16,19,14,3,17
2412,CLE,0,48,43,84,51.2,9,31,29,34,53,64.15,17,20,85,7,29,36,26,19,9,3,15
2413,DEN,1,48,44,86,51.2,9,30,30,35,56,62.5,5,8,62.5,8,33,41,26,21,10,2,21
2414,IND,0,53,52,97,53.6,15,34,44.1,37,63,58.73,15,20,75,7,35,42,28,12,5,6,22
2415,PHX,1,48,42,86,48.8,10,32,31.3,32,54,59.26,21,28,75,7,40,47,31,12,8,2,22
2416,OKC,0,48,34,91,37.4,14,43,32.6,20,48,41.67,9,16,56.3,8,31,39,22,19,9,4,21
2417,NOP,0,48,42,87,48.3,15,29,51.7,27,58,46.55,13,16,81.3,9,33,42,26,17,7,5,20
2418,LAL,0,48,34,86,39.5,15,34,44.1,19,52,36.54,22,29,75.9,12,34,46,25,16,7,3,26
2419,CHA,1,48,48,91,52.7,13,32,40.6,35,59,59.32,14,17,82.4,11,35,46,32,18,13,1,16
2420,SAC,0,48,39,99,39.4,8,36,22.2,31,63,49.21,15,21,71.4,16,36,52,20,15,15,5,22
2421,BOS,0,48,32,82,39,11,34,32.4,21,48,43.75,8,11,72.7,10,32,42,19,25,6,12,19
2422,BKN,1,48,41,88,46.6,12,38,31.6,29,50,58,20,24,83.3,11,36,47,26,13,6,6,16
2423,PHI,0,48,43,91,47.3,14,36,38.9,29,55,52.73,9,11,81.8,5,30,35,17,10,8,9,21
2424,CHI,1,48,47,89,52.8,14,28,50,33,61,54.1,20,25,80,11,35,46,32,14,9,7,14
2425,NYK,1,48,44,88,50,24,54,44.4,20,34,58.82,9,17,52.9,6,32,38,34,11,10,4,19
2426,ORL,0,48,33,83,39.8,17,43,39.5,16,40,40,13,15,86.7,9,37,46,24,19,5,3,18
2427,HOU,1,48,48,95,50.5,17,38,44.7,31,57,54.39,11,14,78.6,10,44,54,29,17,12,10,18
2428,WAS,1,53,49,94,52.1,19,38,50,30,56,53.57,18,19,94.7,6,32,38,24,9,5,6,21
2429,DAL,0,48,31,93,33.3,13,43,30.2,18,50,36,12,13,92.3,10,40,50,16,15,7,3,21
2430,MIL,0,48,32,84,38.1,12,42,28.6,20,42,47.62,19,29,65.5,5,33,38,19,15,6,0,26
2431,MIA,1,48,51,96,53.1,15,35,42.9,36,61,59.02,20,31,64.5,11,47,58,28,11,8,2,26
2432,GSW,1,48,43,83,51.8,15,31,48.4,28,52,53.85,14,22,63.6,10,43,53,27,21,5,4,20
2433,LAC,0,48,42,96,43.8,14,40,35,28,56,50,15,21,71.4,8,31,39,24,7,9,2,25
2434,ATL,1,48,45,94,47.9,15,35,42.9,30,59,50.85,8,9,88.9,6,49,55,31,13,8,9,16
2435,WAS,1,48,36,81,44.4,5,27,18.5,31,54,57.41,21,26,80.8,7,44,51,20,22,14,8,17
2436,DET,0,48,36,90,40,6,28,21.4,30,62,48.39,10,13,76.9,11,36,47,17,17,7,5,16
2437,TOR,0,48,30,97,30.9,7,34,20.6,23,63,36.51,16,22,72.7,19,35,54,14,19,10,4,21
2438,PHX,0,48,36,87,41.4,14,37,37.8,22,50,44,12,17,70.6,11,34,45,23,18,9,3,18
2439,NYK,1,58,51,105,48.6,17,45,37.8,34,60,56.67,19,27,70.4,7,48,55,27,19,9,10,22
2440,SAC,1,48,42,92,45.7,17,41,41.5,25,51,49.02,23,29,79.3,7,36,43,24,10,6,4,22
2441,CHI,1,48,37,86,43,7,23,30.4,30,63,47.62,13,15,86.7,9,39,48,18,17,8,5,19
2442,SAS,1,48,49,98,50,13,30,43.3,36,68,52.94,12,18,66.7,13,30,43,32,8,8,3,22
2443,OKC,0,48,34,91,37.4,7,35,20,27,56,48.21,11,18,61.1,15,35,50,19,15,4,2,15
2444,MIN,1,48,42,87,48.3,16,38,42.1,26,49,53.06,24,31,77.4,13,33,46,26,18,18,12,22
2445,ORL,0,48,35,86,40.7,9,29,31,26,57,45.61,18,23,78.3,13,31,44,17,16,6,6,20
2446,DEN,1,48,44,83,53,17,39,43.6,27,44,61.36,5,9,55.6,6,40,46,25,19,9,1,20
2447,CLE,0,48,47,93,50.5,14,38,36.8,33,55,60,13,18,72.2,7,29,36,38,11,6,5,17
2448,MEM,1,48,53,100,53,14,33,42.4,39,67,58.21,12,12,100,13,40,53,28,12,8,8,15
2449,CHA,1,48,46,107,43,13,31,41.9,33,76,43.42,18,27,66.7,12,34,46,29,8,9,5,21
2450,UTA,1,48,40,91,44,14,47,29.8,26,44,59.09,13,15,86.7,12,41,53,18,10,6,5,19
2451,POR,0,48,45,93,48.4,12,35,34.3,33,58,56.9,19,22,86.4,9,40,49,25,13,5,5,22
2452,PHI,1,48,44,85,51.8,13,25,52,31,60,51.67,16,20,80,6,41,47,24,13,9,5,11
2453,NOP,0,48,39,93,41.9,13,30,43.3,26,63,41.27,6,9,66.7,10,34,44,28,14,5,6,16
2454,HOU,0,48,40,88,45.5,11,33,33.3,29,55,52.73,15,22,68.2,12,29,41,21,24,13,3,25
2455,IND,0,48,42,90,46.7,17,47,36.2,25,43,58.14,21,24,87.5,8,43,51,29,17,2,10,24
2456,BOS,0,58,48,117,41,21,57,36.8,27,60,45,17,23,73.9,15,41,56,34,18,13,9,24
2457,BKN,0,48,37,84,44,17,32,53.1,20,52,38.46,13,23,56.5,5,39,44,19,13,3,9,17
2458,MIL,1,48,48,105,45.7,17,45,37.8,31,60,51.67,14,18,77.8,13,41,54,25,8,8,9,19
2459,LAL,0,48,45,95,47.4,15,42,35.7,30,53,56.6,9,19,47.4,5,40,45,21,18,7,4,25
2460,GSW,1,48,41,93,44.1,14,39,35.9,27,54,50,25,30,83.3,9,41,50,30,17,9,2,18
1,GSW,1,48,58,96,60.4,27,49,55.1,31,47,65.96,14,16,87.5,9,49,58,47,16,13,6,18
2,BKN,0,48,35,83,42.2,12,32,37.5,23,51,45.1,23,28,82.1,10,32,42,22,19,6,6,22
3,DET,0,48,31,85,36.5,9,33,27.3,22,52,42.31,10,13,76.9,15,44,59,20,25,1,3,16
4,DAL,0,48,46,108,42.6,17,53,32.1,29,55,52.73,8,16,50,8,38,46,28,4,4,3,21
5,MIL,0,48,38,82,46.3,12,34,35.3,26,48,54.17,17,21,81,7,31,38,28,14,5,2,13
6,MEM,0,48,40,92,43.5,7,37,18.9,33,55,60,13,18,72.2,11,32,43,25,12,8,4,16
7,SAC,0,48,37,85,43.5,11,43,25.6,26,42,61.9,10,15,66.7,10,24,34,24,15,7,6,18
8,ORL,0,48,38,90,42.2,17,47,36.2,21,43,48.84,17,24,70.8,13,30,43,29,14,13,1,17
9,UTA,0,48,51,101,50.5,10,35,28.6,41,66,62.12,5,6,83.3,7,38,45,31,11,4,4,16
10,CLE,0,48,35,89,39.3,10,37,27,25,52,48.08,15,16,93.8,11,33,44,27,16,9,5,24
11,ATL,0,48,44,97,45.4,11,39,28.2,33,58,56.9,15,19,78.9,16,34,50,27,9,11,5,12
12,NOP,0,48,40,90,44.4,3,21,14.3,37,69,53.62,25,29,86.2,11,38,49,18,15,13,3,24
13,PHX,0,48,42,99,42.4,14,37,37.8,28,62,45.16,16,22,72.7,12,35,47,29,7,4,3,21
14,WAS,0,48,41,97,42.3,14,45,31.1,27,52,51.92,13,21,61.9,14,37,51,28,13,11,5,21
15,NYK,0,48,52,108,48.1,15,40,37.5,37,68,54.41,17,22,77.3,19,34,53,29,15,8,8,24
16,POR,0,48,38,95,40,9,35,25.7,29,60,48.33,16,24,66.7,6,24,30,25,14,5,3,9
17,IND,1,48,46,89,51.7,19,34,55.9,27,55,49.09,30,38,78.9,8,36,44,33,15,8,9,24
18,LAC,1,48,49,100,49,5,23,21.7,44,77,57.14,16,24,66.7,14,39,53,22,10,3,5,18
19,HOU,1,48,44,90,48.9,6,21,28.6,38,69,55.07,20,28,71.4,13,38,51,24,15,8,6,15
20,MIN,1,48,39,82,47.6,13,36,36.1,26,46,56.52,22,31,71,8,34,42,25,17,7,8,22
21,BOS,1,48,42,89,47.2,25,54,46.3,17,35,48.57,11,14,78.6,12,35,47,33,15,5,3,13
22,CHA,1,48,37,81,45.7,6,32,18.8,31,49,63.27,26,30,86.7,10,39,49,23,19,8,5,14
23,LAL,1,48,47,97,48.5,18,45,40,29,52,55.77,16,21,76.2,10,39,49,28,11,4,7,9
24,MIA,1,48,45,83,54.2,18,44,40.9,27,39,69.23,15,20,75,7,37,44,30,18,10,3,20
25,DEN,1,48,42,84,50,7,28,25,35,56,62.5,18,25,72,15,36,51,25,20,11,2,15
26,OKC,1,48,45,90,50,12,36,33.3,33,54,61.11,13,16,81.3,8,41,49,30,16,5,2,17
27,TOR,1,48,48,95,50.5,11,33,33.3,37,62,59.68,14,16,87.5,7,38,45,29,9,8,2,19
28,SAS,1,48,51,104,49,15,38,39.5,36,66,54.55,21,30,70,13,56,69,31,12,2,3,13
29,CHI,1,48,40,95,42.1,6,30,20,34,65,52.31,17,22,77.3,11,37,48,21,4,15,7,16
30,PHI,1,48,53,101,52.5,14,32,43.8,39,69,56.52,14,19,73.7,13,37,50,31,13,10,5,23
31,POR,0,48,47,89,52.8,14,32,43.8,33,57,57.89,17,23,73.9,7,27,34,32,10,8,4,20
32,DEN,0,48,41,90,45.6,15,46,32.6,26,44,59.09,17,24,70.8,5,36,41,32,14,7,9,20
33,LAC,1,48,49,93,52.7,12,35,34.3,37,58,63.79,26,30,86.7,13,38,51,30,12,7,5,17
34,MIN,1,48,56,101,55.4,24,43,55.8,32,58,55.17,15,21,71.4,11,34,45,42,7,8,8,18
35,UTA,1,48,44,100,44,11,35,31.4,33,65,50.77,19,23,82.6,17,42,59,30,16,9,2,18
36,SAS,0,48,50,95,52.6,13,29,44.8,37,66,56.06,18,24,75,10,35,45,34,13,5,4,16
37,CHI,1,48,46,88,52.3,11,31,35.5,35,57,61.4,12,18,66.7,8,42,50,24,12,6,4,15
38,TOR,0,48,40,93,43,9,31,29,31,62,50,13,17,76.5,12,23,35,21,8,12,2,17
39,HOU,1,48,42,89,47.2,7,21,33.3,35,68,51.47,21,28,75,14,34,48,21,19,11,9,23
40,BKN,1,48,35,89,39.3,9,42,21.4,26,47,55.32,22,25,88,10,35,45,27,10,14,3,12
41,CHA,0,48,38,88,43.2,13,41,31.7,25,47,53.19,20,27,74.1,7,34,41,22,17,10,9,21
42,DAL,0,48,42,93,45.2,18,55,32.7,24,38,63.16,10,13,76.9,7,36,43,23,10,7,3,15
43,MEM,1,48,53,93,57,20,42,47.6,33,51,64.71,11,15,73.3,11,33,44,39,12,9,6,20
44,PHX,0,48,43,104,41.3,9,36,25,34,68,50,12,14,85.7,13,34,47,23,9,7,10,12
45,BOS,1,48,45,81,55.6,15,44,34.1,30,37,81.08,16,21,76.2,13,40,53,37,21,4,7,14
46,ATL,0,53,51,92,55.4,10,33,30.3,41,59,69.49,19,28,67.9,4,34,38,32,21,11,7,19
47,PHI,1,53,51,102,50,11,22,50,40,80,50,23,29,79.3,13,39,52,33,20,10,2,22
48,NYK,0,48,38,88,43.2,14,43,32.6,24,45,53.33,15,20,75,7,30,37,19,10,5,2,17
49,LAL,1,48,45,92,48.9,18,36,50,27,56,48.21,13,17,76.5,10,44,54,25,16,6,6,12
50,NOP,1,48,42,79,53.2,10,28,35.7,32,51,62.75,19,20,95,4,39,43,27,12,4,7,17
51,MIL,0,48,42,92,45.7,21,49,42.9,21,43,48.84,9,11,81.8,11,27,38,30,19,5,3,15
52,ORL,0,48,31,87,35.6,7,38,18.4,24,49,48.98,15,17,88.2,15,42,57,17,21,6,6,19
53,IND,0,48,41,83,49.4,11,31,35.5,30,52,57.69,22,28,78.6,9,33,42,29,19,7,3,22
54,MIA,0,48,43,98,43.9,15,47,31.9,28,51,54.9,7,12,58.3,14,33,47,26,16,7,4,29
55,GSW,1,48,41,78,52.6,16,36,44.4,25,42,59.52,21,24,87.5,10,37,47,36,24,6,7,22
56,SAC,0,48,38,98,38.8,11,39,28.2,27,59,45.76,10,18,55.6,18,22,40,24,12,10,3,16
57,DET,1,48,44,90,48.9,13,31,41.9,31,59,52.54,21,26,80.8,10,32,42,24,13,12,6,24
58,WAS,1,48,39,84,46.4,7,33,21.2,32,51,62.75,29,37,78.4,12,38,50,23,17,4,3,18
59,DEN,0,48,44,83,53,8,23,34.8,36,60,60,19,23,82.6,9,29,38,24,13,7,2,19
60,POR,0,48,51,96,53.1,10,28,35.7,41,68,60.29,15,18,83.3,8,28,36,34,16,7,14,22
61,UTA,0,48,41,83,49.4,5,31,16.1,36,52,69.23,11,16,68.8,7,38,45,24,19,5,2,23
62,PHI,0,48,39,76,51.3,10,36,27.8,29,40,72.5,13,15,86.7,3,29,32,23,17,7,4,18
63,CLE,1,48,46,88,52.3,18,38,47.4,28,50,56,8,9,88.9,9,33,42,31,17,13,7,21
64,PHX,1,48,41,79,51.9,17,36,47.2,24,43,55.81,20,25,80,7,26,33,26,10,4,6,16
65,ORL,0,48,33,83,39.8,13,39,33.3,20,44,45.45,15,19,78.9,9,30,39,21,22,8,8,11
66,MIA,1,48,49,88,55.7,18,39,46.2,31,49,63.27,13,15,86.7,10,32,42,39,11,3,0,13
67,SAS,1,48,47,106,44.3,10,35,28.6,37,71,52.11,25,28,89.3,18,29,47,29,15,9,4,12
68,OKC,1,48,39,97,40.2,15,45,33.3,24,52,46.15,21,26,80.8,17,33,50,29,13,12,2,17
69,MEM,0,53,50,104,48.1,12,36,33.3,38,68,55.88,19,25,76,15,34,49,33,14,10,6,25
70,BOS,1,48,38,89,42.7,11,38,28.9,27,51,52.94,10,18,55.6,11,37,48,20,15,5,7,14
71,BKN,1,48,45,86,52.3,17,43,39.5,28,43,65.12,16,23,69.6,11,27,38,36,13,6,7,12
72,DAL,1,48,44,89,49.4,20,44,45.5,24,45,53.33,15,18,83.3,7,32,39,24,10,4,7,18
73,LAC,1,48,43,82,52.4,16,36,44.4,27,46,58.7,23,27,85.2,5,33,38,23,13,9,4,18
74,NOP,1,53,44,88,50,21,39,53.8,23,49,46.94,29,39,74.4,8,36,44,35,16,9,8,22
75,ATL,1,48,43,84,51.2,13,30,43.3,30,54,55.56,35,40,87.5,12,36,48,30,17,10,5,23
76,NYK,1,48,52,100,52,18,46,39.1,34,54,62.96,16,25,64,20,32,52,34,18,13,8,21
77,IND,0,48,45,87,51.7,15,30,50,30,57,52.63,24,30,80,10,27,37,33,17,6,5,17
78,LAL,0,48,45,89,50.6,12,29,41.4,33,60,55,16,24,66.7,10,34,44,27,14,4,3,17
79,TOR,0,48,37,90,41.1,6,33,18.2,31,57,54.39,13,17,76.5,13,37,50,20,12,10,7,19
80,DET,0,48,41,84,48.8,13,28,46.4,28,56,50,13,14,92.9,9,25,34,27,14,5,3,18
81,WAS,0,48,45,94,47.9,6,28,21.4,39,66,59.09,20,26,76.9,12,27,39,23,14,10,9,26
82,CHI,0,48,36,83,43.4,11,33,33.3,25,50,50,9,11,81.8,5,33,38,28,15,10,3,11
83,SAC,0,48,46,106,43.4,12,37,32.4,34,69,49.28,15,19,78.9,22,35,57,31,9,7,1,19
84,MIL,1,48,39,92,42.4,18,46,39.1,21,46,45.65,9,11,81.8,13,40,53,26,13,7,3,13
85,MIA,1,48,41,80,51.3,13,36,36.1,28,44,63.64,23,26,88.5,5,28,33,26,8,12,2,18
86,NOP,0,48,37,84,44,7,20,35,30,64,46.88,22,27,81.5,9,28,37,20,14,6,4,14
87,BKN,0,48,39,90,43.3,13,35,37.1,26,55,47.27,11,14,78.6,7,33,40,21,10,6,8,18
88,CHA,0,48,36,77,46.8,12,31,38.7,24,46,52.17,16,19,84.2,6,36,42,27,18,3,4,22
89,TOR,1,48,42,88,47.7,15,33,45.5,27,55,49.09,21,28,75,10,31,41,27,7,13,7,18
90,CLE,1,48,42,84,50,15,31,48.4,27,53,50.94,18,20,90,5,25,30,23,9,3,7,16
91,POR,0,48,42,97,43.3,14,42,33.3,28,55,50.91,11,17,64.7,13,36,49,23,10,7,7,18
92,UTA,0,53,47,90,52.2,15,33,45.5,32,57,56.14,24,31,77.4,6,35,41,29,14,4,3,28
93,DEN,0,48,41,87,47.1,11,36,30.6,30,51,58.82,10,18,55.6,13,34,47,26,20,9,13,18
94,DET,0,48,36,73,49.3,11,28,39.3,25,45,55.56,22,27,81.5,6,29,35,21,14,5,2,22
95,MEM,1,48,42,87,48.3,18,48,37.5,24,39,61.54,17,22,77.3,8,41,49,30,12,5,5,10
96,PHI,1,48,39,78,50,11,29,37.9,28,49,57.14,14,16,87.5,6,31,37,21,12,3,7,21
97,PHX,1,48,43,89,48.3,10,33,30.3,33,56,58.93,19,26,73.1,15,42,57,25,14,7,7,12
98,ATL,1,48,48,86,55.8,10,28,35.7,38,58,65.52,17,19,89.5,7,41,48,26,17,5,7,18
99,SAS,0,48,35,90,38.9,13,40,32.5,22,50,44,11,14,78.6,9,29,38,25,12,7,5,16
100,LAL,1,53,48,96,50,12,34,35.3,36,62,58.06,27,35,77.1,11,33,44,27,12,6,7,21
101,OKC,0,48,44,93,47.3,11,32,34.4,33,61,54.1,26,35,74.3,13,25,38,23,10,4,1,22
102,CHI,0,48,41,89,46.1,7,31,22.6,34,58,58.62,16,20,80,6,26,32,16,8,8,6,18
103,GSW,1,48,47,95,49.5,20,47,42.6,27,48,56.25,22,30,73.3,19,35,54,25,14,6,6,22
104,MIN,1,48,41,85,48.2,8,24,33.3,33,61,54.1,17,22,77.3,7,37,44,21,12,7,6,13
105,MIL,1,48,50,92,54.3,23,42,54.8,27,50,54,17,29,58.6,12,44,56,33,18,6,7,19
106,SAC,1,48,46,91,50.5,17,42,40.5,29,49,59.18,12,15,80,11,32,43,35,12,8,4,22
107,WAS,0,48,50,99,50.5,13,27,48.1,37,72,51.39,15,21,71.4,9,33,42,30,9,7,4,21
108,HOU,1,48,47,102,46.1,12,31,38.7,35,71,49.3,18,24,75,20,35,55,23,13,12,3,16
109,ORL,0,48,45,89,50.6,10,23,43.5,35,66,53.03,13,17,76.5,13,34,47,25,13,6,1,22
110,BOS,0,48,38,91,41.8,15,45,33.3,23,46,50,10,16,62.5,13,30,43,28,8,4,4,17
111,POR,1,48,43,93,46.2,9,30,30,34,63,53.97,12,20,60,11,31,42,29,10,12,3,26
112,MIL,1,48,46,80,57.5,10,28,35.7,36,52,69.23,15,21,71.4,7,35,42,28,12,8,5,17
113,BKN,1,48,38,86,44.2,9,32,28.1,29,54,53.7,26,34,76.5,7,33,40,25,9,6,2,26
114,DAL,0,53,49,95,51.6,10,38,26.3,39,57,68.42,22,32,68.8,10,37,47,24,14,4,3,15
115,SAC,0,53,49,103,47.6,11,44,25,38,59,64.41,25,32,78.1,13,30,43,24,15,9,5,23
116,LAL,1,48,52,93,55.9,9,30,30,43,63,68.25,21,28,75,11,40,51,36,6,4,8,9
117,TOR,1,48,56,104,53.8,8,28,28.6,48,76,63.16,8,8,100,15,30,45,38,8,8,6,14
118,UTA,0,48,40,91,44,8,32,25,32,59,54.24,22,30,73.3,11,41,52,24,11,5,1,23
119,CHI,1,48,50,94,53.2,9,31,29,41,63,65.08,19,22,86.4,4,32,36,29,3,9,6,13
120,MEM,0,48,39,84,46.4,19,43,44.2,20,41,48.78,10,12,83.3,8,39,47,29,18,1,3,22
121,SAS,1,53,52,98,53.1,13,34,38.2,39,64,60.94,25,29,86.2,14,38,52,31,18,8,3,25
122,ORL,1,48,43,75,57.3,17,33,51.5,26,42,61.9,25,40,62.5,7,34,41,30,16,11,6,26
123,DEN,1,48,44,100,44,9,33,27.3,35,67,52.24,15,18,83.3,17,30,47,24,13,11,7,17
124,PHX,1,48,46,81,56.8,13,34,38.2,33,47,70.21,23,28,82.1,5,33,38,31,13,4,6,30
125,DET,0,48,32,78,41,9,33,27.3,23,45,51.11,29,36,80.6,9,29,38,22,16,4,1,29
126,ATL,1,53,51,108,47.2,12,35,34.3,39,73,53.42,18,22,81.8,16,37,53,28,11,10,3,22
127,PHI,0,48,40,87,46,12,36,33.3,28,51,54.9,12,13,92.3,11,25,36,19,11,3,2,17
128,CLE,1,48,44,90,48.9,9,24,37.5,35,66,53.03,18,26,69.2,13,30,43,23,13,7,7,22
129,MIN,0,48,38,79,48.1,11,26,42.3,27,53,50.94,18,23,78.3,7,40,47,29,18,3,5,17
130,OKC,0,48,36,88,40.9,11,32,34.4,25,56,44.64,35,41,85.4,13,28,41,21,8,7,0,23
131,HOU,0,48,44,102,43.1,13,34,38.2,31,68,45.59,8,10,80,16,28,44,23,10,4,4,18
132,NYK,1,48,46,88,52.3,13,32,40.6,33,56,58.93,13,18,72.2,7,32,39,31,12,12,4,17
133,IND,0,48,36,83,43.4,9,24,37.5,27,59,45.76,24,29,82.8,11,33,44,21,17,5,6,26
134,GSW,0,48,42,105,40,9,42,21.4,33,63,52.38,17,17,100,22,35,57,26,15,9,4,22
135,CHA,0,48,42,85,49.4,15,31,48.4,27,54,50,9,13,69.2,10,27,37,26,18,3,4,11
136,WAS,0,48,39,79,49.4,16,37,43.2,23,42,54.76,15,18,83.3,5,33,38,26,19,9,5,18
137,LAC,0,48,42,85,49.4,11,29,37.9,31,56,55.36,19,23,82.6,11,26,37,25,13,5,4,29
138,NOP,1,48,42,86,48.8,7,17,41.2,35,69,50.72,31,35,88.6,14,26,40,21,7,6,5,15
139,DAL,0,48,47,77,61,14,34,41.2,33,43,76.74,14,16,87.5,1,30,31,32,14,3,2,23
140,MIA,1,48,45,86,52.3,13,37,35.1,32,49,65.31,26,29,89.7,10,26,36,27,11,6,0,16
141,CLE,0,48,44,86,51.2,17,37,45.9,27,49,55.1,11,13,84.6,3,30,33,33,10,2,9,21
142,BOS,1,48,42,96,43.8,17,51,33.3,25,45,55.56,21,22,95.5,10,32,42,27,12,8,4,14
143,UTA,0,48,46,96,47.9,9,29,31,37,67,55.22,13,14,92.9,13,39,52,23,18,3,7,17
144,ORL,1,48,44,88,50,8,24,33.3,36,64,56.25,20,26,76.9,6,42,48,26,11,2,14,16
145,SAS,0,48,42,91,46.2,15,38,39.5,27,53,50.94,16,23,69.6,14,32,46,27,15,8,4,20
146,NYK,1,48,49,93,52.7,17,36,47.2,32,57,56.14,15,24,62.5,16,32,48,24,10,6,5,12
147,LAL,1,48,45,90,50,9,22,40.9,36,68,52.94,24,30,80,15,38,53,28,16,10,5,17
148,MEM,1,48,43,96,44.8,9,33,27.3,34,63,53.97,13,17,76.5,12,39,51,25,15,11,7,16
149,LAC,0,48,34,90,37.8,11,35,31.4,23,55,41.82,15,18,83.3,12,38,50,26,18,5,8,14
150,TOR,0,48,42,84,50,8,26,30.8,34,58,58.62,18,23,78.3,14,20,34,26,13,6,3,19
151,GSW,1,48,47,93,50.5,21,49,42.9,26,44,59.09,15,21,71.4,14,31,45,37,15,5,4,18
152,ATL,0,48,39,91,42.9,8,37,21.6,31,54,57.41,21,23,91.3,16,30,46,23,11,6,3,14
153,BKN,1,48,49,88,55.7,15,33,45.5,34,55,61.82,11,13,84.6,9,32,41,33,13,9,3,17
154,MIN,0,48,41,95,43.2,13,39,33.3,28,56,50,16,19,84.2,12,27,39,25,16,10,4,22
155,WAS,0,48,41,105,39,17,50,34,24,55,43.64,10,12,83.3,15,36,51,24,13,5,5,24
156,PHX,1,48,37,88,42,10,27,37,27,61,44.26,16,21,76.2,13,38,51,28,16,8,7,16
157,DEN,0,48,38,95,40,6,26,23.1,32,69,46.38,11,20,55,15,36,51,19,11,11,5,16
158,SAC,1,48,54,88,61.4,19,39,48.7,35,49,71.43,11,15,73.3,8,33,41,38,13,11,7,21
159,PHI,1,48,41,73,56.2,12,31,38.7,29,42,69.05,23,25,92,9,28,37,28,18,7,6,20
160,CHI,1,48,45,88,51.1,13,31,41.9,32,57,56.14,18,22,81.8,9,33,42,25,7,12,4,13
161,DET,0,48,43,89,48.3,11,35,31.4,32,54,59.26,18,27,66.7,13,27,40,24,12,7,7,28
162,CHA,0,48,35,77,45.5,14,37,37.8,21,40,52.5,7,10,70,4,32,36,27,22,3,5,21
163,HOU,1,48,38,83,45.8,11,31,35.5,27,52,51.92,34,45,75.6,14,32,46,18,12,9,5,24
164,OKC,0,48,42,88,47.7,4,30,13.3,38,58,65.52,29,34,85.3,11,34,45,21,11,10,3,24
165,POR,0,48,40,85,47.1,19,38,50,21,47,44.68,15,23,65.2,9,24,33,29,20,9,6,15
166,IND,1,48,45,98,45.9,12,41,29.3,33,57,57.89,19,28,67.9,20,36,56,30,16,5,4,21
167,BOS,1,48,51,91,56,22,43,51.2,29,48,60.42,16,20,80,7,40,47,28,9,8,5,18
168,MIL,0,48,38,101,37.6,14,43,32.6,24,58,41.38,9,13,69.2,15,30,45,22,13,4,1,16
169,NOP,1,48,38,80,47.5,13,27,48.1,25,53,47.17,18,22,81.8,8,38,46,22,12,6,1,24
170,DEN,0,48,32,80,40,4,28,14.3,28,52,53.85,20,32,62.5,11,29,40,21,10,4,5,21
171,DET,0,48,40,80,50,16,33,48.5,24,47,51.06,10,14,71.4,10,32,42,27,18,1,3,22
172,UTA,1,48,49,90,54.4,12,31,38.7,37,59,62.71,18,20,90,8,37,45,28,16,5,6,17
173,PHI,1,48,37,80,46.3,17,36,47.2,20,44,45.45,25,30,83.3,11,32,43,26,11,9,4,19
174,SAS,0,48,45,95,47.4,10,35,28.6,35,60,58.33,17,21,81,9,30,39,31,15,10,4,16
175,LAL,1,48,45,86,52.3,7,20,35,38,66,57.58,24,30,80,13,32,45,22,16,10,3,14
176,CHI,0,48,45,88,51.1,9,33,27.3,36,55,65.45,11,13,84.6,6,26,32,31,14,10,4,22
177,IND,0,48,53,101,52.5,14,30,46.7,39,71,54.93,16,22,72.7,10,19,29,36,8,9,4,25
178,MIL,1,48,58,93,62.4,10,25,40,48,68,70.59,23,30,76.7,14,38,52,28,19,5,5,18
179,SAC,1,48,42,92,45.7,18,48,37.5,24,44,54.55,18,24,75,10,49,59,30,10,9,4,11
180,PHX,1,48,40,96,41.7,6,20,30,34,76,44.74,21,27,77.8,15,33,48,23,8,11,8,16
181,DAL,0,48,38,83,45.8,18,46,39.1,20,37,54.05,14,18,77.8,8,32,40,24,14,3,3,22
182,MEM,0,48,49,95,51.6,11,32,34.4,38,63,60.32,23,28,82.1,14,31,45,26,13,8,4,20
183,BKN,1,48,44,82,53.7,17,35,48.6,27,47,57.45,18,27,66.7,8,33,41,33,12,4,9,18
184,MIA,0,48,35,79,44.3,13,39,33.3,22,40,55,9,14,64.3,6,29,35,20,11,5,0,18
185,HOU,0,48,46,98,46.9,9,30,30,37,68,54.41,13,21,61.9,20,32,52,21,10,9,2,18
186,OKC,1,48,39,87,44.8,10,29,34.5,29,58,50,19,25,76,10,28,38,19,10,7,3,18
187,NYK,1,48,38,76,50,13,31,41.9,25,45,55.56,12,23,52.2,9,38,47,22,16,8,3,14
188,MIN,0,48,40,90,44.4,12,35,34.3,28,55,50.91,8,12,66.7,16,38,54,24,21,4,4,24
189,POR,0,48,30,93,32.3,9,39,23.1,21,54,38.89,11,12,91.7,8,37,45,18,14,5,6,15
190,LAC,1,48,48,78,61.5,22,37,59.5,26,41,63.41,23,31,74.2,3,29,32,28,16,8,4,21
191,ORL,0,48,41,100,41,14,49,28.6,27,51,52.94,12,15,80,8,39,47,24,16,9,8,15
192,NOP,0,48,42,90,46.7,12,27,44.4,30,63,47.62,13,14,92.9,11,30,41,30,19,6,4,18
193,WAS,1,48,54,99,54.5,13,37,35.1,41,62,66.13,9,13,69.2,6,37,43,33,11,7,3,13
194,GSW,1,48,43,82,52.4,18,40,45,25,42,59.52,16,22,72.7,11,30,41,32,19,11,4,18
195,CHA,1,48,52,94,55.3,14,35,40,38,59,64.41,19,30,63.3,15,37,52,34,18,6,7,24
196,MEM,1,48,42,88,47.7,12,34,35.3,30,54,55.56,17,23,73.9,7,42,49,26,17,11,6,17
197,BOS,0,48,45,93,48.4,11,44,25,34,49,69.39,10,11,90.9,7,31,38,29,12,5,8,14
198,OKC,0,48,50,96,52.1,11,30,36.7,39,66,59.09,23,29,79.3,7,32,39,25,11,11,3,21
199,ATL,1,48,41,89,46.1,12,27,44.4,29,62,46.77,26,33,78.8,14,37,51,25,15,5,3,16
200,MIA,0,48,32,80,40,10,33,30.3,22,47,46.81,18,19,94.7,12,31,43,18,16,6,3,10
201,TOR,1,48,45,93,48.4,8,36,22.2,37,57,64.91,8,9,88.9,15,32,47,32,9,8,7,13
202,CLE,0,48,47,93,50.5,9,25,36,38,68,55.88,15,22,68.2,10,30,40,20,8,5,6,24
203,SAC,0,48,39,84,46.4,5,27,18.5,34,57,59.65,32,40,80,12,30,42,16,10,4,4,23
204,MIN,1,48,44,86,51.2,9,24,37.5,35,62,56.45,22,34,64.7,11,29,40,33,6,6,3,27
205,CHI,0,48,44,82,53.7,9,23,39.1,35,59,59.32,15,21,71.4,8,26,34,26,15,9,3,11
206,IND,0,48,39,93,41.9,8,28,28.6,31,65,47.69,18,23,78.3,14,29,43,20,14,6,3,19
207,POR,0,48,35,90,38.9,7,33,21.2,28,57,49.12,13,15,86.7,6,23,29,15,12,6,2,16
208,NOP,1,48,49,86,57,12,28,42.9,37,58,63.79,14,17,82.4,8,45,53,31,17,5,6,16
209,UTA,0,48,38,86,44.2,9,36,25,29,50,58,18,27,66.7,10,37,47,25,13,2,7,19
210,PHX,1,48,43,101,42.6,11,36,30.6,32,65,49.23,20,22,90.9,18,31,49,31,7,7,7,20
211,PHI,0,48,43,89,48.3,8,30,26.7,35,59,59.32,17,22,77.3,11,29,40,18,11,10,3,20
212,DEN,1,48,43,85,50.6,11,32,34.4,32,53,60.38,19,22,86.4,10,32,42,34,12,8,4,16
213,DAL,1,48,47,83,56.6,18,37,48.6,29,46,63.04,15,17,88.2,4,29,33,29,13,7,8,23
214,LAC,1,48,48,81,59.3,20,40,50,28,41,68.29,8,16,50,6,31,37,41,18,10,4,17
215,DET,0,48,41,92,44.6,7,24,29.2,34,68,50,28,36,77.8,14,33,47,22,10,5,0,20
216,MIL,1,48,45,95,47.4,14,45,31.1,31,50,62,22,26,84.6,15,35,50,28,9,5,4,23
217,NYK,1,48,50,86,58.1,17,39,43.6,33,47,70.21,20,28,71.4,7,32,39,35,11,11,8,20
218,HOU,0,48,42,87,48.3,7,26,26.9,35,61,57.38,24,29,82.8,13,27,40,24,14,6,4,18
219,CHI,1,48,47,87,54,14,31,45.2,33,56,58.93,10,13,76.9,8,34,42,32,9,8,2,23
220,HOU,0,48,35,80,43.8,6,25,24,29,55,52.73,15,18,83.3,12,24,36,20,19,6,1,22
221,WAS,0,48,38,86,44.2,16,36,44.4,22,50,44,12,20,60,12,33,45,25,18,6,2,12
222,DAL,0,48,32,84,38.1,19,49,38.8,13,35,37.14,21,22,95.5,3,34,37,18,8,8,7,24
223,SAS,0,48,36,97,37.1,8,36,22.2,28,61,45.9,13,18,72.2,3,35,38,22,10,7,0,16
224,MIN,1,48,34,80,42.5,17,40,42.5,17,40,42.5,14,25,56,9,40,49,25,17,10,2,20
225,LAL,0,48,38,75,50.7,13,36,36.1,25,39,64.1,19,28,67.9,8,30,38,24,18,5,4,18
226,ATL,0,48,45,98,45.9,7,31,22.6,38,67,56.72,22,26,84.6,14,34,48,27,10,4,5,15
227,MEM,1,48,48,89,53.9,13,33,39.4,35,56,62.5,14,19,73.7,6,33,39,28,11,8,7,22
228,BKN,0,48,37,91,40.7,8,35,22.9,29,56,51.79,24,28,85.7,15,29,44,17,15,7,8,20
229,TOR,1,48,45,98,45.9,11,31,35.5,34,67,50.75,13,16,81.3,18,35,53,22,13,13,6,19
230,POR,0,48,39,82,47.6,14,32,43.8,25,50,50,20,27,74.1,8,29,37,18,18,5,7,22
231,CHA,1,48,39,88,44.3,12,29,41.4,27,59,45.76,20,24,83.3,14,44,58,27,14,6,2,18
232,CLE,1,48,39,83,47,9,30,30,30,53,56.6,21,24,87.5,13,28,41,20,11,5,7,16
233,OKC,1,48,41,94,43.6,12,35,34.3,29,59,49.15,24,28,85.7,13,29,42,23,11,13,2,19
234,ORL,1,48,45,85,52.9,7,22,31.8,38,63,60.32,22,28,78.6,9,38,47,30,11,7,3,21
235,GSW,0,48,34,82,41.5,15,40,37.5,19,42,45.24,13,17,76.5,6,31,37,25,16,9,2,19
236,BOS,1,48,52,91,57.1,18,44,40.9,34,47,72.34,15,21,71.4,9,52,61,29,15,4,11,18
237,PHX,1,48,47,93,50.5,15,32,46.9,32,61,52.46,16,19,84.2,13,32,45,35,8,4,9,22
238,MIA,0,48,38,80,47.5,12,30,40,26,50,52,12,14,85.7,8,24,32,22,14,5,4,19
239,ATL,1,48,53,96,55.2,15,30,50,38,66,57.58,22,25,88,15,27,42,33,13,10,8,14
240,LAC,0,48,39,75,52,15,33,45.5,24,42,57.14,17,21,81,2,29,31,29,20,9,6,14
241,UTA,0,48,47,91,51.6,9,28,32.1,38,63,60.32,10,16,62.5,11,34,45,30,17,3,7,14
242,BKN,1,48,44,89,49.4,18,40,45,26,49,53.06,23,25,92,17,28,45,30,8,6,6,18
243,SAC,1,48,44,95,46.3,16,43,37.2,28,52,53.85,17,21,81,14,28,42,30,9,11,1,13
244,MIL,0,48,39,88,44.3,9,36,25,30,52,57.69,19,21,90.5,4,36,40,26,10,7,2,19
245,PHI,0,48,34,78,43.6,13,31,41.9,21,47,44.68,24,27,88.9,8,28,36,21,13,3,7,16
246,NOP,1,48,51,96,53.1,21,34,61.8,30,62,48.39,8,9,88.9,12,33,45,36,16,11,3,21
247,DEN,1,48,47,89,52.8,15,36,41.7,32,53,60.38,20,28,71.4,7,41,48,28,12,4,3,18
248,IND,0,48,52,96,54.2,14,37,37.8,38,59,64.41,12,12,100,10,22,32,33,17,7,7,18
249,CHI,1,48,48,84,57.1,17,28,60.7,31,56,55.36,11,14,78.6,11,36,47,33,17,6,8,19
250,MIL,1,48,55,99,55.6,22,50,44,33,49,67.35,12,16,75,9,41,50,42,13,6,11,20
251,HOU,0,48,47,87,54,7,23,30.4,40,64,62.5,13,21,61.9,10,28,38,25,16,7,3,14
252,PHI,0,48,38,78,48.7,8,29,27.6,30,49,61.22,28,34,82.4,4,34,38,23,10,8,1,20
253,WAS,1,48,51,85,60,15,30,50,36,55,65.45,19,26,73.1,6,37,43,29,10,3,8,16
254,TOR,1,48,41,92,44.6,13,37,35.1,28,55,50.91,23,29,79.3,15,31,46,25,11,12,9,24
255,MEM,1,48,57,93,61.3,25,42,59.5,32,51,62.75,12,14,85.7,5,30,35,36,11,12,7,19
256,LAL,1,48,42,91,46.2,12,34,35.3,30,57,52.63,20,28,71.4,16,37,53,20,11,9,4,14
257,BOS,1,48,44,93,47.3,18,42,42.9,26,51,50.98,14,19,73.7,9,40,49,28,15,11,6,15
258,SAS,0,48,51,101,50.5,13,38,34.2,38,63,60.32,9,15,60,11,30,41,35,5,4,4,21
259,OKC,0,48,40,92,43.5,14,36,38.9,26,56,46.43,17,19,89.5,12,33,45,21,10,6,5,19
260,CHA,1,48,43,89,48.3,11,28,39.3,32,61,52.46,20,27,74.1,6,37,43,32,8,7,4,17
261,IND,0,48,39,84,46.4,4,26,15.4,35,58,60.34,13,22,59.1,6,38,44,24,17,9,4,16
262,SAC,1,48,47,89,52.8,13,39,33.3,34,50,68,28,32,87.5,5,28,33,29,4,6,3,23
263,DAL,0,48,41,84,48.8,9,36,25,32,48,66.67,18,24,75,7,38,45,25,11,3,4,19
264,DET,0,48,34,73,46.6,6,25,24,28,48,58.33,23,30,76.7,8,31,39,23,22,8,4,18
265,GSW,1,48,42,88,47.7,18,50,36,24,38,63.16,18,24,75,10,39,49,27,11,3,0,21
266,PHX,0,48,48,89,53.9,9,29,31,39,60,65,22,29,75.9,12,31,43,33,12,2,7,25
267,POR,0,48,37,86,43,6,31,19.4,31,55,56.36,16,18,88.9,8,23,31,23,14,10,5,14
268,UTA,0,48,40,104,38.5,11,40,27.5,29,64,45.31,25,34,73.5,20,31,51,28,11,6,5,15
269,NYK,0,48,37,88,42,12,40,30,25,48,52.08,20,26,76.9,13,31,44,26,13,8,8,15
270,ORL,1,48,40,87,46,13,32,40.6,27,55,49.09,18,21,85.7,8,35,43,25,16,8,7,19
271,NOP,1,48,45,98,45.9,11,34,32.4,34,64,53.12,14,15,93.3,11,41,52,26,11,11,0,14
272,CLE,1,48,42,89,47.2,12,32,37.5,30,57,52.63,20,26,76.9,13,27,40,24,10,7,7,21
273,BKN,0,48,39,81,48.1,12,34,35.3,27,47,57.45,24,27,88.9,9,33,42,24,16,7,7,21
274,OKC,0,48,41,93,44.1,13,39,33.3,28,54,51.85,10,11,90.9,13,27,40,24,14,6,3,20
275,LAC,1,48,47,84,56,18,37,48.6,29,47,61.7,15,20,75,8,34,42,34,15,9,5,9
276,CHA,0,48,38,83,45.8,9,37,24.3,29,46,63.04,11,16,68.8,4,34,38,24,17,8,4,17
277,ATL,0,48,45,85,52.9,12,26,46.2,33,59,55.93,22,25,88,9,32,41,28,17,6,6,25
278,MIN,1,48,45,92,48.9,11,26,42.3,34,66,51.52,24,29,82.8,11,31,42,27,11,7,3,20
279,TOR,0,48,39,89,43.8,7,34,20.6,32,55,58.18,29,39,74.4,13,27,40,21,10,11,7,22
280,NYK,0,48,42,82,51.2,16,40,40,26,42,61.9,20,25,80,9,33,42,29,17,7,5,25
281,POR,1,48,45,93,48.4,13,41,31.7,32,52,61.54,24,30,80,7,36,43,28,9,9,5,24
282,MIA,1,48,45,79,57,16,28,57.1,29,51,56.86,21,26,80.8,2,27,29,28,10,9,1,18
283,DEN,1,48,42,83,50.6,15,32,46.9,27,51,52.94,19,21,90.5,11,30,41,28,10,7,2,18
284,MEM,1,48,45,87,51.7,12,36,33.3,33,51,64.71,28,33,84.8,12,24,36,27,11,8,4,21
285,DAL,0,48,44,89,49.4,17,40,42.5,27,49,55.1,20,28,71.4,8,23,31,27,10,7,2,17
286,MIL,1,48,51,98,52,15,43,34.9,36,55,65.45,13,24,54.2,10,44,54,24,15,10,4,14
287,CHI,0,48,34,83,41,6,25,24,28,58,48.28,17,22,77.3,15,27,42,18,19,7,4,16
288,SAS,0,48,36,93,38.7,9,39,23.1,27,54,50,13,20,65,8,38,46,26,19,7,6,21
289,WAS,0,48,44,87,50.6,4,26,15.4,40,61,65.57,12,16,75,10,27,37,20,7,4,4,15
290,IND,1,48,43,77,55.8,11,21,52.4,32,56,57.14,21,25,84,8,31,39,27,18,4,5,29
291,PHX,0,48,42,90,46.7,12,31,38.7,30,59,50.85,15,20,75,12,27,39,23,17,7,6,31
292,LAL,1,48,39,70,55.7,8,17,47.1,31,53,58.49,36,46,78.3,5,31,36,27,15,7,2,20
293,GSW,1,48,50,90,55.6,12,39,30.8,38,51,74.51,15,18,83.3,11,33,44,33,13,7,5,20
294,PHI,1,48,39,82,47.6,16,37,43.2,23,45,51.11,22,26,84.6,11,33,44,30,18,9,4,22
295,HOU,0,48,48,93,51.6,12,33,36.4,36,60,60,17,23,73.9,20,28,48,27,16,6,3,25
296,UTA,0,48,39,82,47.6,11,35,31.4,28,47,59.57,26,36,72.2,7,40,47,24,17,4,5,21
297,OKC,1,48,39,93,41.9,10,37,27,29,56,51.79,13,14,92.9,12,35,47,19,12,2,4,21
298,ORL,1,48,43,80,53.8,12,27,44.4,31,53,58.49,24,25,96,7,35,42,27,16,7,5,21
299,CLE,1,48,42,83,50.6,14,29,48.3,28,54,51.85,17,21,81,8,26,34,23,14,6,3,20
300,BKN,0,48,41,92,44.6,9,33,27.3,32,59,54.24,18,23,78.3,19,30,49,25,17,6,5,19
301,WAS,0,48,42,83,50.6,10,32,31.3,32,51,62.75,18,23,78.3,4,29,33,30,14,7,4,23
302,NOP,1,48,45,81,55.6,10,24,41.7,35,57,61.4,19,23,82.6,5,44,49,31,16,8,2,19
303,LAC,0,48,41,86,47.7,6,31,19.4,35,55,63.64,12,21,57.1,12,34,46,21,14,9,2,21
304,SAC,0,48,39,81,48.1,17,44,38.6,22,37,59.46,14,21,66.7,10,32,42,25,14,3,4,19
305,ATL,1,48,44,95,46.3,14,38,36.8,30,57,52.63,27,36,75,21,40,61,26,11,5,6,20
306,BOS,1,48,49,92,53.3,18,44,40.9,31,48,64.58,16,23,69.6,11,32,43,33,6,9,3,15
307,DET,0,48,37,91,40.7,13,40,32.5,24,51,47.06,20,24,83.3,9,26,35,20,10,8,2,26
308,SAS,0,48,30,87,34.5,13,41,31.7,17,46,36.96,11,19,57.9,10,27,37,22,16,8,3,19
309,DAL,0,48,39,84,46.4,11,36,30.6,28,48,58.33,19,20,95,8,29,37,22,12,5,4,19
310,SAC,0,48,41,97,42.3,19,52,36.5,22,45,48.89,19,25,76,8,35,43,28,6,5,3,20
311,UTA,1,48,46,88,52.3,16,36,44.4,30,52,57.69,20,23,87,6,42,48,33,12,3,8,23
312,CHI,1,58,39,94,41.5,7,33,21.2,32,61,52.46,24,29,82.8,4,38,42,20,11,12,7,18
313,MEM,1,48,41,89,46.1,10,35,28.6,31,54,57.41,20,26,76.9,17,33,50,21,11,5,3,18
314,PHI,0,58,38,90,42.2,10,36,27.8,28,54,51.85,19,22,86.4,9,45,54,28,21,8,8,25
315,MIN,1,48,51,83,61.4,14,24,58.3,37,59,62.71,24,32,75,7,27,34,34,15,9,4,24
316,GSW,1,48,44,88,50,17,48,35.4,27,40,67.5,16,19,84.2,16,32,48,31,20,12,6,14
317,IND,0,48,37,82,45.1,9,26,34.6,28,56,50,26,34,76.5,13,35,48,27,22,5,6,26
318,HOU,0,48,39,93,41.9,10,36,27.8,29,57,50.88,20,24,83.3,13,28,41,14,18,14,2,14
319,CHA,1,48,41,90,45.6,10,31,32.3,31,59,52.54,23,32,71.9,10,27,37,26,11,12,6,22
320,NYK,0,48,48,85,56.5,14,28,50,34,57,59.65,24,28,85.7,7,27,34,26,17,7,3,22
321,NOP,1,48,42,85,49.4,13,31,41.9,29,54,53.7,20,24,83.3,10,29,39,28,10,7,4,23
322,BKN,0,48,38,82,46.3,12,35,34.3,26,47,55.32,14,16,87.5,9,24,33,26,12,10,3,16
323,ORL,0,48,41,102,40.2,10,38,26.3,31,64,48.44,13,17,76.5,13,31,44,24,8,8,3,28
324,DEN,1,48,42,80,52.5,12,23,52.2,30,57,52.63,12,13,92.3,6,34,40,31,17,5,3,17
325,POR,0,48,37,82,45.1,6,29,20.7,31,53,58.49,22,24,91.7,11,29,40,24,15,7,9,14
326,MIL,1,48,43,82,52.4,16,45,35.6,27,37,72.97,16,21,76.2,7,38,45,35,12,3,8,13
327,MIA,1,48,38,79,48.1,13,39,33.3,25,40,62.5,23,25,92,8,34,42,33,10,4,4,17
328,ATL,0,48,48,101,47.5,5,22,22.7,43,79,54.43,17,20,85,20,31,51,21,12,4,4,13
329,HOU,0,48,31,76,40.8,9,33,27.3,22,43,51.16,36,38,94.7,8,28,36,15,13,4,2,22
330,SAS,1,48,51,94,54.3,14,28,50,37,66,56.06,10,16,62.5,10,31,41,26,12,9,5,18
331,TOR,0,48,44,99,44.4,14,34,41.2,30,65,46.15,9,12,75,9,32,41,25,7,6,4,15
332,OKC,1,48,42,84,50,11,28,39.3,31,56,55.36,29,36,80.6,6,38,44,20,16,8,3,20
333,PHX,0,48,44,92,47.8,15,36,41.7,29,56,51.79,17,24,70.8,9,31,40,31,14,7,9,31
334,LAL,1,48,36,78,46.2,13,32,40.6,23,46,50,26,32,81.3,9,43,52,25,15,2,9,19
335,DET,0,48,38,82,46.3,10,32,31.3,28,50,56,14,17,82.4,9,30,39,26,13,4,2,20
336,LAC,1,48,43,94,45.7,12,28,42.9,31,66,46.97,19,23,82.6,18,31,49,26,10,11,3,18
337,BOS,0,48,42,88,47.7,22,51,43.1,20,37,54.05,11,16,68.8,5,35,40,30,8,2,2,17
338,UTA,1,48,42,97,43.3,17,41,41.5,25,56,44.64,17,22,77.3,17,39,56,29,7,3,5,14
339,PHI,1,48,54,88,61.4,15,35,42.9,39,53,73.58,18,22,81.8,6,24,30,31,8,11,6,17
340,CHI,1,48,45,80,56.3,17,34,50,28,46,60.87,6,6,100,5,27,32,34,14,8,5,18
341,GSW,0,48,39,91,42.9,13,35,37.1,26,56,46.43,28,34,82.4,15,27,42,27,13,3,8,21
342,MIA,0,48,35,82,42.7,10,37,27,25,45,55.56,19,24,79.2,14,25,39,23,14,4,2,10
343,WAS,0,48,41,91,45.1,13,36,36.1,28,55,50.91,23,27,85.2,12,34,46,27,10,6,5,18
344,MEM,1,48,52,95,54.7,18,38,47.4,34,57,59.65,11,17,64.7,11,28,39,35,7,5,5,24
345,SAC,1,48,48,86,55.8,22,37,59.5,26,49,53.06,14,23,60.9,7,37,44,34,8,7,7,22
346,TOR,1,48,48,90,53.3,9,27,33.3,39,63,61.9,17,21,81,9,36,45,23,15,11,3,25
347,MIN,0,48,39,85,45.9,5,23,21.7,34,62,54.84,24,28,85.7,9,33,42,27,15,5,2,23
348,IND,0,48,45,87,51.7,12,31,38.7,33,56,58.93,19,20,95,12,29,41,28,17,5,5,17
349,DEN,0,48,43,84,51.2,12,33,36.4,31,51,60.78,12,15,80,6,27,33,30,13,3,2,21
350,LAC,0,48,42,90,46.7,6,22,27.3,36,68,52.94,18,24,75,13,30,43,23,15,9,3,24
351,NYK,1,48,41,83,49.4,9,32,28.1,32,51,62.75,25,28,89.3,15,28,43,23,12,9,4,16
352,ORL,1,48,42,84,50,10,31,32.3,32,53,60.38,19,25,76,9,36,45,23,18,14,5,22
353,MIN,0,58,46,100,46,18,42,42.9,28,58,48.28,21,31,67.7,14,36,50,33,16,6,8,24
354,CHA,0,48,29,86,33.7,5,35,14.3,24,51,47.06,19,26,73.1,7,28,35,20,14,10,6,16
355,LAL,0,48,43,84,51.2,5,20,25,38,64,59.38,19,31,61.3,13,29,42,23,12,8,3,18
356,POR,0,48,38,79,48.1,14,38,36.8,24,41,58.54,22,31,71,8,29,37,20,19,12,4,26
357,ATL,1,48,47,100,47,16,41,39,31,59,52.54,17,25,68,13,32,45,27,11,7,8,15
358,WAS,0,48,35,76,46.1,8,23,34.8,27,53,50.94,16,20,80,6,32,38,22,17,5,6,19
359,HOU,1,48,43,88,48.9,11,32,34.4,32,56,57.14,17,24,70.8,15,37,52,20,13,9,3,19
360,MEM,1,53,49,101,48.5,14,38,36.8,35,63,55.56,14,21,66.7,15,37,52,27,17,13,9,24
361,CHI,1,58,51,94,54.3,11,24,45.8,40,70,57.14,26,30,86.7,6,41,47,23,12,9,6,21
362,DAL,1,48,40,79,50.6,16,34,47.1,24,45,53.33,15,19,78.9,7,28,35,27,15,8,4,26
363,PHI,1,48,46,92,50,10,32,31.3,36,60,60,19,25,76,14,48,62,24,15,9,9,19
364,BOS,1,48,41,87,47.1,15,42,35.7,26,45,57.78,29,35,82.9,18,34,52,29,18,12,2,19
365,GSW,0,48,47,98,48,11,40,27.5,36,58,62.07,14,20,70,16,38,54,28,17,6,9,20
366,CLE,1,48,48,87,55.2,4,19,21.1,44,68,64.71,17,22,77.3,9,32,41,31,11,9,7,19
367,SAS,0,53,39,98,39.8,20,52,38.5,19,46,41.3,22,29,75.9,16,38,54,31,20,11,4,19
368,NOP,0,48,39,82,47.6,12,28,42.9,27,54,50,22,25,88,8,27,35,22,9,8,5,17
369,MIL,0,48,47,89,52.8,11,32,34.4,36,57,63.16,18,26,69.2,9,35,44,26,12,5,4,16
370,BKN,0,48,33,80,41.3,14,39,35.9,19,41,46.34,16,23,69.6,3,38,41,20,7,8,4,22
371,OKC,0,48,40,94,42.6,13,31,41.9,27,63,42.86,18,20,90,11,28,39,18,13,5,4,17
372,DET,0,48,39,85,45.9,12,27,44.4,27,58,46.55,10,18,55.6,13,24,37,24,17,8,3,20
373,ORL,0,48,43,86,50,8,28,28.6,35,58,60.34,19,23,82.6,11,36,47,25,19,7,3,20
374,IND,1,48,54,97,55.7,22,46,47.8,32,51,62.75,9,15,60,8,34,42,36,10,5,3,20
375,TOR,1,48,47,97,48.5,14,32,43.8,33,65,50.77,20,28,71.4,19,40,59,29,10,10,6,20
376,DEN,1,48,47,89,52.8,8,24,33.3,39,65,60,17,25,68,13,34,47,29,10,9,7,15
377,SAC,1,48,32,82,39,13,41,31.7,19,41,46.34,24,32,75,13,44,57,22,12,2,5,17
378,PHX,1,48,43,90,47.8,13,35,37.1,30,55,54.55,17,17,100,7,28,35,26,14,7,5,22
379,SAS,0,53,49,107,45.8,15,34,44.1,34,73,46.58,15,26,57.7,16,31,47,26,10,7,4,30
380,BOS,1,48,34,84,40.5,12,40,30,22,44,50,24,30,80,8,36,44,20,11,7,5,22
381,GSW,0,48,49,88,55.7,17,36,47.2,32,52,61.54,11,15,73.3,7,29,36,28,16,5,1,25
382,MIA,1,48,49,82,59.8,13,29,44.8,36,53,67.92,27,33,81.8,8,33,41,33,13,8,5,16
383,MEM,0,48,46,91,50.5,18,46,39.1,28,45,62.22,9,14,64.3,12,27,39,29,16,6,1,20
384,SAC,1,48,38,78,48.7,18,42,42.9,20,36,55.56,23,29,79.3,5,40,45,26,20,6,3,19
385,CLE,0,48,40,85,47.1,14,41,34.1,26,44,59.09,15,22,68.2,12,21,33,20,12,6,2,18
386,MIN,0,48,37,84,44,12,36,33.3,25,48,52.08,16,22,72.7,8,38,46,27,13,3,2,23
387,DAL,1,53,44,86,51.2,17,33,51.5,27,53,50.94,32,37,86.5,10,42,52,23,19,4,4,25
388,HOU,1,48,47,89,52.8,8,29,27.6,39,60,65,12,19,63.2,16,35,51,22,18,5,3,29
389,LAC,1,48,46,96,47.9,16,34,47.1,30,62,48.39,26,32,81.3,16,28,44,30,8,11,1,18
390,LAL,0,48,34,90,37.8,11,44,25,23,46,50,31,37,83.8,11,25,36,21,10,7,3,17
391,PHI,1,48,39,75,52,17,36,47.2,22,39,56.41,23,27,85.2,13,33,46,24,20,8,6,21
392,CHI,0,48,38,97,39.2,16,42,38.1,22,55,40,22,25,88,13,35,48,28,15,13,4,24
393,SAS,1,48,48,85,56.5,22,41,53.7,26,44,59.09,14,18,77.8,7,40,47,39,15,6,7,17
394,BKN,0,48,35,82,42.7,12,41,29.3,23,41,56.1,25,34,73.5,11,35,46,25,17,3,5,20
395,LAL,1,48,40,82,48.8,18,39,46.2,22,43,51.16,25,28,89.3,15,37,52,24,18,8,2,16
396,ORL,0,48,44,97,45.4,10,29,34.5,34,68,50,16,21,76.2,13,29,42,24,9,7,2,16
397,TOR,1,48,49,93,52.7,12,30,40,37,63,58.73,15,17,88.2,14,30,44,25,11,10,2,18
398,NOP,0,48,42,98,42.9,11,43,25.6,31,55,56.36,13,20,65,15,26,41,23,12,9,3,24
399,CLE,1,48,45,88,51.1,14,30,46.7,31,58,53.45,16,19,84.2,8,22,30,29,9,8,6,19
400,NYK,1,48,42,81,51.9,15,35,42.9,27,46,58.7,24,34,70.6,9,43,52,23,13,8,8,13
401,DEN,0,48,42,76,55.3,6,25,24,36,51,70.59,20,25,80,4,28,32,29,14,9,4,17
402,WAS,1,48,44,85,51.8,7,32,21.9,37,53,69.81,22,22,100,10,38,48,24,15,9,9,12
403,PHX,0,48,41,95,43.2,8,23,34.8,33,72,45.83,14,16,87.5,8,33,41,23,11,7,3,26
404,DET,0,48,38,99,38.4,10,34,29.4,28,65,43.08,11,12,91.7,19,25,44,18,11,8,3,19
405,POR,0,48,38,99,38.4,17,45,37.8,21,54,38.89,14,18,77.8,11,27,38,22,12,8,3,19
406,OKC,1,48,45,99,45.5,11,33,33.3,34,66,51.52,20,23,87,14,37,51,22,11,9,0,25
407,CHA,0,48,43,76,56.6,6,23,26.1,37,53,69.81,12,15,80,6,34,40,28,22,3,8,18
408,MIL,1,48,40,85,47.1,12,39,30.8,28,46,60.87,24,37,64.9,13,33,46,24,13,8,6,15
409,UTA,0,48,43,90,47.8,16,38,42.1,27,52,51.92,13,18,72.2,16,32,48,31,18,7,4,25
410,MIN,1,48,54,92,58.7,12,28,42.9,42,64,65.62,16,23,69.6,5,32,37,39,13,12,10,22
411,GSW,1,48,45,83,54.2,19,39,48.7,26,44,59.09,14,24,58.3,9,32,41,28,16,8,6,21
412,DET,1,48,48,100,48,14,36,38.9,34,64,53.12,7,10,70,19,33,52,28,15,10,5,21
413,SAC,0,48,46,104,44.2,21,50,42,25,54,46.3,11,15,73.3,15,30,45,31,9,4,2,21
414,ATL,0,48,44,97,45.4,4,22,18.2,40,75,53.33,23,28,82.1,18,33,51,17,16,6,4,19
415,HOU,1,48,40,90,44.4,11,35,31.4,29,55,52.73,20,27,74.1,15,33,48,27,11,9,2,21
416,MIL,1,48,50,86,58.1,15,33,45.5,35,53,66.04,18,22,81.8,5,38,43,29,13,2,4,18
417,DAL,0,48,35,90,38.9,12,46,26.1,23,44,52.27,6,8,75,8,33,41,23,13,3,3,16
418,PHX,0,48,46,95,48.4,4,21,19,42,74,56.76,16,22,72.7,17,30,47,25,14,8,4,23
419,BOS,0,48,39,87,44.8,12,42,28.6,27,45,60,19,21,90.5,10,28,38,19,14,7,5,22
420,MIA,1,48,37,79,46.8,14,34,41.2,23,45,51.11,31,36,86.1,9,28,37,20,13,12,4,13
421,MEM,1,48,38,83,45.8,12,37,32.4,26,46,56.52,16,19,84.2,7,40,47,23,16,9,3,17
422,IND,0,48,36,86,41.9,10,34,29.4,26,52,50,15,24,62.5,13,29,42,23,16,7,5,15
423,SAS,0,48,33,88,37.5,10,36,27.8,23,52,44.23,14,19,73.7,10,40,50,24,19,3,7,18
424,NYK,1,48,42,88,47.7,11,37,29.7,31,51,60.78,17,21,81,12,34,46,18,11,8,3,18
425,OKC,1,48,36,95,37.9,10,39,25.6,26,56,46.43,20,23,87,12,43,55,26,9,8,3,19
426,NOP,1,48,43,86,50,19,40,47.5,24,46,52.17,22,29,75.9,8,35,43,35,15,11,7,19
427,WAS,0,48,34,84,40.5,6,26,23.1,28,58,48.28,19,23,82.6,6,29,35,19,10,4,5,20
428,DEN,0,48,45,90,50,12,31,38.7,33,59,55.93,18,24,75,15,34,49,27,15,4,8,19
429,LAL,0,48,43,89,48.3,12,36,33.3,31,53,58.49,10,17,58.8,10,27,37,24,11,6,2,17
430,POR,0,48,43,88,48.9,10,33,30.3,33,55,60,14,20,70,10,36,46,26,19,10,2,21
431,PHI,1,48,41,80,51.3,11,29,37.9,30,51,58.82,19,23,82.6,9,33,42,29,9,6,10,19
432,CLE,1,48,41,87,47.1,7,27,25.9,34,60,56.67,25,34,73.5,11,29,40,18,10,8,3,22
433,BKN,1,48,42,84,50,17,44,38.6,25,40,62.5,21,24,87.5,4,24,28,32,10,11,2,21
434,CHA,0,48,41,80,51.3,10,21,47.6,31,59,52.54,16,22,72.7,7,36,43,25,19,8,5,26
435,UTA,1,48,46,103,44.7,9,32,28.1,37,71,52.11,18,20,90,20,40,60,22,11,4,4,17
436,MIL,0,53,43,100,43,21,51,41.2,22,49,44.9,9,11,81.8,7,41,48,28,17,9,7,14
437,IND,1,48,43,93,46.2,9,35,25.7,34,58,58.62,26,34,76.5,18,40,58,24,14,7,6,20
438,CHI,1,48,44,86,51.2,15,32,46.9,29,54,53.7,16,22,72.7,13,31,44,25,14,7,9,17
439,DAL,0,48,39,85,45.9,15,43,34.9,24,42,57.14,15,23,65.2,10,33,43,25,11,4,3,17
440,MIA,0,53,42,94,44.7,11,37,29.7,31,57,54.39,19,20,95,5,30,35,19,17,8,2,17
441,OKC,1,48,37,80,46.3,9,28,32.1,28,52,53.85,27,32,84.4,4,34,38,17,12,11,2,17
442,CHA,0,48,40,98,40.8,17,40,42.5,23,58,39.66,14,15,93.3,11,32,43,24,7,5,14,15
443,MEM,1,48,41,86,47.7,10,38,26.3,31,48,64.58,20,24,83.3,11,34,45,25,11,7,5,16
444,SAC,1,48,41,85,48.2,15,35,42.9,26,50,52,31,37,83.8,8,31,39,19,15,10,2,19
445,ATL,0,48,50,100,50,10,34,29.4,40,66,60.61,15,16,93.8,13,35,48,24,10,4,4,17
446,HOU,0,48,41,85,48.2,16,34,47.1,25,51,49.02,13,17,76.5,6,27,33,28,16,10,3,19
447,ORL,1,53,48,99,48.5,13,37,35.1,35,62,56.45,17,20,85,15,39,54,34,19,10,10,20
448,LAC,1,48,42,87,48.3,10,30,33.3,32,57,56.14,12,16,75,7,32,39,22,10,3,4,20
449,NOP,0,48,34,81,42,12,34,35.3,22,47,46.81,16,19,84.2,8,35,43,23,22,3,4,25
450,NYK,0,48,32,90,35.6,7,31,22.6,25,59,42.37,24,27,88.9,20,34,54,21,10,5,3,17
451,GSW,1,53,46,112,41.1,23,55,41.8,23,57,40.35,10,11,90.9,18,47,65,33,15,12,4,15
452,DET,0,48,43,94,45.7,11,34,32.4,32,60,53.33,18,27,66.7,12,30,42,25,12,7,7,24
453,PHX,0,48,44,89,49.4,13,44,29.5,31,45,68.89,18,22,81.8,7,33,40,30,14,11,3,26
454,BOS,1,48,52,95,54.7,20,42,47.6,32,53,60.38,10,12,83.3,5,35,40,35,9,6,6,21
455,CLE,0,48,40,86,46.5,18,43,41.9,22,43,51.16,17,21,81,8,26,34,25,11,5,6,20
456,LAL,1,48,45,80,56.3,13,30,43.3,32,50,64,19,19,100,5,30,35,28,21,8,8,10
457,SAS,1,48,51,94,54.3,13,33,39.4,38,61,62.3,13,17,76.5,13,37,50,31,19,10,0,20
458,MIA,1,48,42,82,51.2,14,29,48.3,28,53,52.83,21,23,91.3,11,35,46,22,16,7,4,20
459,TOR,0,48,46,92,50,10,28,35.7,36,64,56.25,10,13,76.9,10,27,37,29,13,14,3,16
460,DEN,0,48,44,90,48.9,13,35,37.1,31,55,56.36,19,20,95,8,25,33,32,14,14,4,14
461,WAS,0,48,43,88,48.9,7,27,25.9,36,61,59.02,14,18,77.8,7,36,43,27,15,8,6,17
462,PHI,1,48,43,83,51.8,11,30,36.7,32,53,60.38,23,29,79.3,12,30,42,25,10,7,4,24
463,ATL,1,48,42,95,44.2,15,31,48.4,27,64,42.19,15,19,78.9,13,33,46,25,14,9,4,17
464,BKN,1,53,42,91,46.2,16,34,47.1,26,57,45.61,24,33,72.7,12,36,48,20,15,7,5,26
465,MIN,0,53,48,98,49,9,30,30,39,68,57.35,18,29,62.1,12,35,47,29,14,10,6,21
466,POR,0,48,42,80,52.5,15,36,41.7,27,44,61.36,20,30,66.7,5,31,36,24,9,6,3,17
467,ORL,0,48,44,94,46.8,16,34,47.1,28,60,46.67,20,31,64.5,12,24,36,21,10,9,4,16
468,CHA,1,48,43,86,50,8,24,33.3,35,62,56.45,19,32,59.4,13,31,44,24,13,11,9,18
469,BKN,0,48,41,104,39.4,14,36,38.9,27,68,39.71,17,17,100,15,32,47,20,14,10,4,12
470,DET,0,48,40,89,44.9,7,21,33.3,33,68,48.53,16,20,80,17,31,48,20,19,5,4,22
471,UTA,1,48,49,88,55.7,13,34,38.2,36,54,66.67,20,21,95.2,11,31,42,27,18,7,8,26
472,NYK,0,48,42,101,41.6,13,50,26,29,51,56.86,20,31,64.5,23,35,58,27,14,8,1,25
473,MIL,1,48,44,104,42.3,19,50,38,25,54,46.3,11,14,78.6,20,41,61,33,16,8,12,14
474,MEM,1,48,50,93,53.8,18,40,45,32,53,60.38,13,18,72.2,9,33,42,36,14,6,3,18
475,SAC,1,48,44,84,52.4,10,32,31.3,34,52,65.38,24,32,75,6,36,42,28,12,10,3,21
476,HOU,0,53,49,107,45.8,6,17,35.3,43,90,47.78,21,29,72.4,20,38,58,18,17,6,6,22
477,GSW,0,48,36,82,43.9,15,45,33.3,21,37,56.76,23,24,95.8,8,24,32,25,17,9,3,17
478,IND,1,53,48,100,48,18,45,40,30,55,54.55,20,21,95.2,8,34,42,34,12,12,15,21
479,WAS,0,48,47,83,56.6,12,29,41.4,35,54,64.81,14,17,82.4,6,33,39,34,19,9,1,16
480,OKC,0,48,33,88,37.5,15,43,34.9,18,45,40,20,21,95.2,7,30,37,23,16,9,2,13
481,DAL,0,48,38,88,43.2,16,46,34.8,22,42,52.38,14,19,73.7,5,29,34,24,9,7,0,18
482,POR,0,48,30,82,36.6,11,39,28.2,19,43,44.19,22,27,81.5,6,41,47,18,16,5,2,19
483,MIA,0,48,35,70,50,8,29,27.6,27,41,65.85,22,29,75.9,10,27,37,22,24,7,4,19
484,LAC,1,48,39,71,54.9,6,20,30,33,51,64.71,24,31,77.4,9,35,44,23,17,9,4,18
485,ATL,1,48,45,85,52.9,12,29,41.4,33,56,58.93,20,26,76.9,8,28,36,26,11,11,5,17
486,BOS,1,48,42,88,47.7,18,49,36.7,24,39,61.54,13,20,65,5,40,45,26,11,9,2,20
487,DEN,0,48,37,88,42,15,40,37.5,22,48,45.83,7,15,46.7,11,33,44,26,11,5,2,16
488,TOR,0,48,37,96,38.5,13,32,40.6,24,64,37.5,13,14,92.9,15,26,41,21,12,12,2,23
489,NOP,1,48,42,83,50.6,13,27,48.1,29,56,51.79,16,18,88.9,9,40,49,32,15,4,6,19
490,CHI,1,48,46,89,51.7,8,24,33.3,38,65,58.46,17,18,94.4,9,41,50,26,9,9,2,16
491,PHX,1,48,49,94,52.1,20,43,46.5,29,51,56.86,14,16,87.5,14,40,54,31,15,10,7,17
492,CLE,1,48,39,80,48.8,9,28,32.1,30,52,57.69,17,19,89.5,7,25,32,26,17,13,3,23
493,DET,0,48,43,84,51.2,13,30,43.3,30,54,55.56,18,22,81.8,10,20,30,29,12,6,3,16
494,HOU,0,48,36,83,43.4,7,26,26.9,29,57,50.88,17,24,70.8,15,33,48,14,19,6,1,22
495,MIN,0,48,34,86,39.5,11,36,30.6,23,50,46,15,21,71.4,6,28,34,19,11,9,7,16
496,PHI,1,48,40,81,49.4,15,25,60,25,56,44.64,22,23,95.7,8,46,54,21,16,8,6,17
497,OKC,1,48,50,94,53.2,17,37,45.9,33,57,57.89,20,24,83.3,13,31,44,28,18,10,2,17
498,WAS,1,48,47,81,58,12,25,48,35,56,62.5,13,17,76.5,9,28,37,27,15,9,5,20
499,LAL,1,48,41,90,45.6,7,28,25,34,62,54.84,23,29,79.3,7,50,57,27,15,4,2,18
500,DAL,1,48,42,89,47.2,19,45,42.2,23,44,52.27,17,22,77.3,3,40,43,24,17,10,6,20
501,NYK,0,48,38,89,42.7,11,40,27.5,27,49,55.1,18,24,75,10,29,39,18,8,3,4,18
502,ORL,0,48,50,100,50,9,30,30,41,70,58.57,14,19,73.7,10,28,38,24,13,7,0,22
503,BKN,1,48,40,81,49.4,15,40,37.5,25,41,60.98,23,29,79.3,5,31,36,23,12,12,7,21
504,CHA,1,48,42,85,49.4,12,32,37.5,30,53,56.6,16,21,76.2,10,32,42,27,12,2,5,20
505,MEM,0,48,36,93,38.7,9,37,24.3,27,56,48.21,22,29,75.9,6,39,45,18,7,6,6,25
506,MIL,1,48,46,78,59,10,28,35.7,36,50,72,32,34,94.1,3,35,38,28,17,5,5,18
507,GSW,0,48,47,89,52.8,20,51,39.2,27,38,71.05,14,16,87.5,8,25,33,36,21,8,3,21
508,UTA,0,48,41,92,44.6,15,44,34.1,26,48,54.17,19,25,76,6,41,47,23,16,10,4,23
509,POR,1,48,38,78,48.7,15,33,45.5,23,45,51.11,19,25,76,5,33,38,28,11,7,6,17
510,MIA,1,48,41,77,53.2,16,29,55.2,25,48,52.08,32,37,86.5,8,24,32,27,11,6,4,17
511,NOP,0,48,43,80,53.8,11,29,37.9,32,51,62.75,11,14,78.6,7,33,40,29,16,6,4,19
512,ATL,0,48,51,92,55.4,9,29,31,42,63,66.67,17,23,73.9,12,25,37,28,11,5,0,25
513,SAC,1,48,47,83,56.6,16,38,42.1,31,45,68.89,13,20,65,6,27,33,39,11,7,3,12
514,TOR,0,48,43,86,50,10,27,37,33,59,55.93,17,20,85,11,30,41,29,15,6,4,20
515,IND,0,48,53,90,58.9,15,37,40.5,38,53,71.7,22,31,71,5,25,30,28,9,8,4,24
516,DET,0,48,40,86,46.5,10,32,31.3,30,54,55.56,14,20,70,16,36,52,30,16,9,6,21
517,CLE,1,53,43,96,44.8,12,34,35.3,31,62,50,20,25,80,16,42,58,27,15,4,7,20
518,DEN,1,48,43,86,50,13,33,39.4,30,53,56.6,19,23,82.6,12,29,41,30,14,9,2,12
519,PHI,1,48,48,82,58.5,16,34,47.1,32,48,66.67,35,38,92.1,5,31,36,37,12,6,5,26
520,BOS,0,53,42,101,41.6,16,48,33.3,26,53,49.06,14,21,66.7,15,37,52,25,14,5,5,21
521,OKC,1,48,44,87,50.6,14,37,37.8,30,50,60,27,33,81.8,11,31,42,24,12,9,4,20
522,HOU,1,48,52,85,61.2,13,24,54.2,39,61,63.93,25,29,86.2,6,38,44,29,12,10,3,20
523,MIL,1,48,39,83,47,22,49,44.9,17,34,50,17,22,77.3,7,38,45,30,12,5,6,15
524,PHX,1,48,49,89,55.1,12,34,35.3,37,55,67.27,20,25,80,9,32,41,27,9,5,2,28
525,CHA,0,48,33,88,37.5,8,30,26.7,25,58,43.1,12,15,80,5,44,49,17,10,2,3,19
526,WAS,0,48,46,108,42.6,8,31,25.8,38,77,49.35,11,12,91.7,20,36,56,21,9,8,2,19
527,NYK,1,58,47,95,49.5,15,41,36.6,32,54,59.26,22,32,68.8,11,43,54,18,20,7,4,27
528,LAC,1,48,45,85,52.9,12,29,41.4,33,56,58.93,33,35,94.3,13,40,53,25,17,6,2,17
529,BKN,1,48,36,92,39.1,12,43,27.9,24,49,48.98,18,22,81.8,8,44,52,21,8,5,9,12
530,GSW,0,48,36,91,39.6,18,52,34.6,18,39,46.15,15,18,83.3,7,35,42,27,13,2,6,21
531,DAL,0,48,38,77,49.4,15,38,39.5,23,39,58.97,35,38,92.1,5,26,31,15,10,5,0,22
532,SAS,0,48,43,93,46.2,11,34,32.4,32,59,54.24,13,21,61.9,13,22,35,23,15,5,4,20
533,BOS,0,58,43,109,39.4,21,59,35.6,22,50,44,22,25,88,17,37,54,27,16,8,5,28
534,LAL,1,48,42,95,44.2,11,33,33.3,31,62,50,18,22,81.8,10,36,46,29,9,3,3,17
535,ORL,0,48,42,84,50,11,31,35.5,31,53,58.49,24,31,77.4,6,32,38,29,11,11,2,25
536,CHI,0,48,45,74,60.8,10,22,45.5,35,52,67.31,22,25,88,4,29,33,18,15,6,3,20
537,IND,1,48,48,94,51.1,16,44,36.4,32,50,64,13,16,81.3,13,22,35,27,9,5,6,18
538,POR,1,48,39,83,47,16,47,34,23,36,63.89,28,32,87.5,9,37,46,27,17,9,5,22
539,MEM,0,48,50,92,54.3,18,34,52.9,32,58,55.17,11,15,73.3,2,24,26,32,8,13,3,23
540,UTA,0,48,43,88,48.9,11,37,29.7,32,51,62.75,22,27,81.5,12,27,39,30,16,5,8,25
541,PHI,1,48,42,84,50,18,37,48.6,24,47,51.06,31,37,83.8,9,23,32,24,6,5,1,21
542,ATL,0,48,37,79,46.8,9,30,30,28,49,57.14,26,30,86.7,10,27,37,22,16,12,1,23
543,MIN,1,48,48,80,60,20,39,51.3,28,41,68.29,22,31,71,6,34,40,31,12,4,6,21
544,DET,0,48,33,81,40.7,6,24,25,27,57,47.37,18,25,72,12,37,49,19,24,5,7,15
545,SAS,0,48,38,86,44.2,15,37,40.5,23,49,46.94,19,20,95,13,29,42,24,15,9,3,20
546,WAS,0,53,38,75,50.7,14,24,58.3,24,51,47.06,19,22,86.4,9,34,43,26,24,9,5,16
547,MIL,0,48,44,83,53,17,34,50,27,49,55.1,25,28,89.3,11,32,43,30,13,3,3,23
548,SAC,0,48,49,89,55.1,14,27,51.9,35,62,56.45,22,30,73.3,11,28,39,25,6,5,1,21
549,CLE,1,48,45,91,49.5,14,34,41.2,31,57,54.39,10,18,55.6,8,31,39,29,12,14,8,18
550,HOU,1,48,49,87,56.3,8,23,34.8,41,64,64.06,16,22,72.7,14,31,45,26,16,9,5,24
551,TOR,1,53,47,90,52.2,12,30,40,35,60,58.33,10,14,71.4,10,24,34,30,14,14,4,21
552,MIA,1,48,42,83,50.6,13,35,37.1,29,48,60.42,20,23,87,12,31,43,31,20,5,3,19
553,CHI,0,48,39,83,47,7,23,30.4,32,60,53.33,19,25,76,9,25,34,24,9,7,1,15
554,PHX,1,48,42,84,50,20,47,42.6,22,37,59.46,21,25,84,13,28,41,29,11,6,7,20
555,GSW,1,48,40,78,51.3,10,31,32.3,30,47,63.83,18,20,90,9,34,43,28,18,7,4,22
556,BOS,0,48,41,84,48.8,9,29,31,32,55,58.18,14,20,70,9,39,48,26,19,8,8,19
557,ATL,1,48,52,91,57.1,12,26,46.2,40,65,61.54,13,16,81.3,10,33,43,30,17,10,5,19
558,MIN,1,48,42,89,47.2,14,34,41.2,28,55,50.91,12,16,75,10,36,46,29,14,10,6,21
559,LAL,0,48,36,87,41.4,10,31,32.3,26,56,46.43,20,24,83.3,11,30,41,23,15,8,2,19
560,UTA,0,48,38,78,48.7,9,29,31,29,49,59.18,18,23,78.3,10,38,48,24,26,5,14,18
561,POR,0,48,41,87,47.1,13,39,33.3,28,48,58.33,16,20,80,9,25,34,22,18,11,7,15
562,SAC,1,48,46,87,52.9,10,33,30.3,36,54,66.67,26,26,100,9,36,45,26,11,3,2,22
563,BKN,1,48,40,95,42.1,14,44,31.8,26,51,50.98,21,26,80.8,13,34,47,25,13,9,6,20
564,NOP,0,48,34,77,44.2,10,29,34.5,24,48,50,21,27,77.8,7,22,29,20,13,9,4,22
565,ORL,1,48,46,86,53.5,10,26,38.5,36,60,60,15,19,78.9,13,29,42,21,20,9,4,24
566,LAC,0,48,47,87,54,14,41,34.1,33,46,71.74,19,27,70.4,6,26,32,31,7,7,3,24
567,NYK,1,48,47,81,58,17,41,41.5,30,40,75,11,17,64.7,6,28,34,23,12,8,4,23
568,OKC,1,48,52,104,50,17,43,39.5,35,61,57.38,9,14,64.3,11,29,40,31,7,12,5,22
569,CHA,0,48,38,78,48.7,9,24,37.5,29,54,53.7,21,25,84,8,26,34,25,21,11,4,20
570,MIA,0,48,39,81,48.1,12,25,48,27,56,48.21,30,32,93.8,11,28,39,23,12,7,2,17
571,MEM,0,48,31,84,36.9,11,32,34.4,20,52,38.46,24,31,77.4,10,30,40,24,11,6,6,24
572,DEN,1,48,40,87,46,8,31,25.8,32,56,57.14,25,31,80.6,13,40,53,28,10,6,5,21
573,SAS,1,48,45,98,45.9,10,32,31.3,35,66,53.03,10,13,76.9,13,37,50,31,17,5,6,14
574,GSW,1,48,39,93,41.9,14,46,30.4,25,47,53.19,23,27,85.2,15,45,60,25,12,9,6,20
575,WAS,1,48,43,84,51.2,14,30,46.7,29,54,53.7,19,24,79.2,9,34,43,30,15,5,4,12
576,LAC,0,48,32,89,36,9,43,20.9,23,46,50,18,21,85.7,9,38,47,19,16,5,5,24
577,DAL,1,48,45,82,54.9,25,48,52.1,20,34,58.82,18,27,66.7,5,26,31,26,13,8,1,22
578,TOR,0,48,41,92,44.6,9,33,27.3,32,59,54.24,17,17,100,13,30,43,28,14,8,7,21
579,PHI,0,48,45,78,57.7,12,27,44.4,33,51,64.71,24,29,82.8,5,32,37,28,14,9,1,24
580,IND,0,48,41,90,45.6,8,23,34.8,33,67,49.25,9,11,81.8,6,34,40,23,14,11,8,18
581,DET,0,48,39,78,50,14,35,40,25,43,58.14,23,28,82.1,7,33,40,23,17,8,2,23
582,CLE,0,48,45,92,48.9,10,32,31.3,35,60,58.33,13,21,61.9,10,28,38,21,7,8,3,18
583,LAL,1,48,38,80,47.5,16,35,45.7,22,45,48.89,31,39,79.5,10,31,41,22,13,8,8,19
584,PHX,1,48,42,89,47.2,9,25,36,33,64,51.56,12,15,80,5,43,48,30,13,8,9,22
585,MEM,1,48,40,83,48.2,17,41,41.5,23,42,54.76,16,19,84.2,8,36,44,27,8,6,9,21
586,CHI,1,48,41,85,48.2,12,27,44.4,29,58,50,23,31,74.2,10,30,40,27,15,9,4,22
587,MIL,1,48,49,94,52.1,26,56,46.4,23,38,60.53,15,19,78.9,8,38,46,29,8,4,1,23
588,BKN,0,48,42,90,46.7,15,39,38.5,27,51,52.94,19,20,95,5,26,31,26,14,6,5,21
589,PHI,1,48,41,83,49.4,15,39,38.5,26,44,59.09,22,22,100,9,32,41,25,9,6,5,20
590,NYK,1,48,54,89,60.7,20,35,57.1,34,54,62.96,14,21,66.7,7,39,46,28,16,5,3,21
591,OKC,0,48,44,91,48.4,11,40,27.5,33,51,64.71,18,24,75,12,30,42,29,13,8,4,27
592,MIA,0,48,34,78,43.6,7,29,24.1,27,49,55.1,21,23,91.3,5,28,33,18,13,3,2,17
593,POR,0,48,36,81,44.4,11,38,28.9,25,43,58.14,27,29,93.1,12,29,41,18,14,5,8,18
594,ORL,0,48,43,94,45.7,9,33,27.3,34,61,55.74,22,29,75.9,12,38,50,22,13,3,5,18
595,HOU,0,48,36,90,40,11,34,32.4,25,56,44.64,16,25,64,17,32,49,17,13,4,5,18
596,NOP,1,48,46,89,51.7,9,25,36,37,64,57.81,20,23,87,11,30,41,23,6,9,4,20
597,CHA,0,48,32,88,36.4,9,33,27.3,23,55,41.82,18,28,64.3,12,36,48,20,14,3,7,17
598,BOS,1,48,39,78,50,16,32,50,23,46,50,23,28,82.1,7,36,43,27,13,5,4,18
599,MEM,1,48,51,112,45.5,6,31,19.4,45,81,55.56,13,17,76.5,14,33,47,25,7,13,6,17
600,HOU,0,48,48,97,49.5,9,31,29,39,66,59.09,7,10,70,10,30,40,33,13,5,6,16
601,WAS,1,48,48,97,49.5,6,21,28.6,42,76,55.26,17,20,85,16,32,48,19,9,6,5,15
602,ATL,0,48,43,93,46.2,13,35,37.1,30,58,51.72,17,19,89.5,13,29,42,21,9,4,7,17
603,POR,0,48,37,86,43,12,39,30.8,25,47,53.19,19,22,86.4,9,24,33,26,13,8,4,17
604,SAS,1,48,39,91,42.9,8,26,30.8,31,65,47.69,16,25,64,9,36,45,23,14,9,5,22
605,BKN,0,48,36,83,43.4,12,36,33.3,24,47,51.06,20,25,80,3,35,38,25,18,12,6,19
606,DAL,0,48,46,91,50.5,12,37,32.4,34,54,62.96,18,28,64.3,9,29,38,28,7,5,3,29
607,MIL,1,48,50,102,49,14,37,37.8,36,65,55.38,4,12,33.3,11,44,55,32,17,10,3,21
608,IND,1,48,41,78,52.6,11,28,39.3,30,50,60,31,40,77.5,5,36,41,25,9,3,8,19
609,UTA,0,48,30,85,35.3,10,34,29.4,20,51,39.22,24,36,66.7,14,38,52,15,20,8,9,15
610,DEN,1,48,53,92,57.6,16,37,43.2,37,55,67.27,11,16,68.8,11,32,43,40,11,8,5,10
611,OKC,0,48,43,98,43.9,11,35,31.4,32,63,50.79,20,24,83.3,12,30,42,28,10,9,1,23
612,CHI,0,48,37,71,52.1,10,25,40,27,46,58.7,14,17,82.4,6,29,35,28,20,6,7,18
613,GSW,1,48,49,91,53.8,12,30,40,37,61,60.66,13,16,81.3,12,34,46,34,18,5,2,19
614,TOR,1,48,38,94,40.4,15,42,35.7,23,52,44.23,13,19,68.4,19,28,47,26,12,11,6,17
615,MIN,1,48,43,90,47.8,9,26,34.6,34,64,53.12,13,22,59.1,10,36,46,22,19,14,8,20
616,LAC,0,48,35,83,42.2,11,28,39.3,24,55,43.64,20,23,87,9,35,44,24,25,11,3,17
617,SAC,1,48,43,82,52.4,15,42,35.7,28,40,70,22,30,73.3,8,43,51,34,20,3,4,21
618,LAL,0,48,38,86,44.2,13,34,38.2,25,52,48.08,20,23,87,14,42,56,22,26,5,10,19
619,ORL,1,48,36,79,45.6,9,34,26.5,27,45,60,20,26,76.9,11,32,43,21,17,9,1,20
620,NOP,0,48,34,76,44.7,6,27,22.2,28,49,57.14,19,23,82.6,9,29,38,23,17,9,2,26
621,NYK,1,48,37,78,47.4,12,31,38.7,25,47,53.19,23,34,67.6,7,37,44,20,15,6,3,11
622,PHI,0,48,32,73,43.8,10,27,37,22,46,47.83,25,28,89.3,9,30,39,20,20,7,3,24
623,CHA,1,48,43,83,51.8,13,26,50,30,57,52.63,18,22,81.8,7,39,46,24,17,8,3,22
624,DET,0,48,42,92,45.7,3,26,11.5,39,66,59.09,19,27,70.4,10,29,39,18,9,12,3,18
625,MIA,1,48,35,81,43.2,15,37,40.5,20,44,45.45,16,22,72.7,12,25,37,21,13,10,3,20
626,BOS,0,48,37,84,44,9,42,21.4,28,42,66.67,11,14,78.6,7,28,35,21,12,5,8,22
627,LAL,1,48,42,97,43.3,6,34,17.6,36,63,57.14,21,28,75,17,39,56,25,11,9,4,17
628,HOU,0,48,45,100,45,7,26,26.9,38,74,51.35,17,25,68,18,30,48,24,14,7,2,26
629,SAC,1,48,45,85,52.9,18,43,41.9,27,42,64.29,16,24,66.7,13,35,48,32,20,7,1,21
630,DEN,1,53,49,96,51,13,39,33.3,36,57,63.16,23,31,74.2,11,39,50,35,16,10,3,23
631,MIN,0,48,38,90,42.2,17,45,37.8,21,45,46.67,11,21,52.4,10,33,43,26,16,11,8,18
632,CLE,1,48,44,84,52.4,18,36,50,26,48,54.17,12,14,85.7,8,37,45,31,14,7,5,17
633,GSW,1,48,39,91,42.9,15,42,35.7,24,49,48.98,16,22,72.7,16,40,56,23,18,11,5,19
634,PHX,0,48,40,95,42.1,8,24,33.3,32,71,45.07,13,22,59.1,19,36,55,21,12,4,5,22
635,DAL,0,48,39,93,41.9,20,49,40.8,19,44,43.18,10,14,71.4,11,37,48,21,17,5,5,24
636,OKC,0,48,41,86,47.7,16,40,40,25,46,54.35,17,23,73.9,9,28,37,24,14,10,0,19
637,BKN,0,48,43,87,49.4,14,39,35.9,29,48,60.42,27,29,93.1,6,31,37,20,10,12,6,21
638,TOR,0,48,36,93,38.7,9,25,36,27,68,39.71,12,15,80,13,30,43,19,14,4,4,16
639,POR,1,48,42,77,54.5,20,39,51.3,22,38,57.89,27,35,77.1,6,31,37,20,14,7,7,21
640,LAC,0,53,44,90,48.9,11,34,32.4,33,56,58.93,25,30,83.3,6,32,38,24,13,11,5,25
641,WAS,0,48,32,76,42.1,6,28,21.4,26,48,54.17,12,23,52.2,12,30,42,22,16,5,1,18
642,CHI,1,48,40,79,50.6,8,30,26.7,32,49,65.31,14,17,82.4,8,31,39,21,11,7,3,19
643,ATL,1,48,45,90,50,16,30,53.3,29,60,48.33,23,28,82.1,13,33,46,20,16,7,2,18
644,MIL,1,48,38,87,43.7,13,45,28.9,25,42,59.52,15,21,71.4,11,34,45,15,12,4,7,20
645,ORL,0,48,35,90,38.9,6,29,20.7,29,61,47.54,32,38,84.2,15,40,55,16,14,4,8,19
646,DET,0,48,38,94,40.4,6,24,25,32,70,45.71,9,14,64.3,17,45,62,26,16,4,5,27
647,SAS,0,48,38,97,39.2,9,34,26.5,29,63,46.03,17,21,81,9,32,41,21,10,5,6,21
648,TOR,1,48,33,88,37.5,7,26,26.9,26,62,41.94,22,34,64.7,10,36,46,22,8,9,5,18
649,NYK,1,48,45,88,51.1,19,48,39.6,26,40,65,19,23,82.6,11,43,54,24,19,1,7,22
650,CHA,1,48,38,88,43.2,10,31,32.3,28,57,49.12,22,27,81.5,11,37,48,20,15,10,2,22
651,DEN,0,48,36,89,40.4,11,37,29.7,25,52,48.08,11,14,78.6,11,37,48,22,15,4,4,13
652,MIA,0,48,32,80,40,11,36,30.6,21,44,47.73,28,34,82.4,7,35,42,24,18,7,3,25
653,PHI,0,48,35,78,44.9,9,27,33.3,26,51,50.98,28,35,80,8,34,42,19,10,8,3,13
654,UTA,1,48,43,92,46.7,10,28,35.7,33,64,51.56,22,28,78.6,15,41,56,29,16,5,11,16
655,MEM,1,48,45,95,47.4,15,44,34.1,30,51,58.82,7,8,87.5,11,39,50,25,12,10,3,13
656,NOP,0,48,40,102,39.2,8,38,21.1,32,64,50,18,21,85.7,13,26,39,25,7,11,0,15
657,BOS,1,48,43,86,50,16,36,44.4,27,50,54,8,12,66.7,9,35,44,20,13,6,4,22
658,IND,1,48,48,99,48.5,15,40,37.5,33,59,55.93,10,14,71.4,10,35,45,35,10,9,8,24
659,MIL,1,48,47,98,48,19,46,41.3,28,52,53.85,15,19,78.9,10,47,57,27,12,6,1,18
660,MIN,0,48,46,93,49.5,11,33,33.3,35,60,58.33,10,16,62.5,7,38,45,25,16,6,11,20
661,CHI,1,48,50,88,56.8,12,26,46.2,38,62,61.29,19,28,67.9,12,45,57,25,11,6,4,15
662,WAS,0,48,39,79,49.4,19,44,43.2,20,35,57.14,12,12,100,3,31,34,25,19,6,6,20
663,SAC,1,58,65,111,58.6,18,41,43.9,47,70,67.14,28,35,80,12,31,43,33,15,18,3,28
664,MIA,0,48,36,92,39.1,9,40,22.5,27,52,51.92,18,25,72,9,36,45,21,10,5,5,17
665,BKN,0,48,30,81,37,12,44,27.3,18,37,48.65,15,19,78.9,5,26,31,21,14,6,3,25
666,LAC,0,58,59,98,60.2,26,45,57.8,33,53,62.26,31,36,86.1,7,35,42,39,25,8,3,27
667,CHA,1,48,43,92,46.7,10,28,35.7,33,64,51.56,25,28,89.3,11,41,52,25,11,10,4,17
668,NYK,1,48,45,92,48.9,12,29,41.4,33,63,52.38,13,16,81.3,12,31,43,21,12,9,2,17
669,GSW,1,48,37,78,47.4,26,54,48.1,11,24,45.83,16,18,88.9,7,40,47,27,19,3,3,20
670,PHX,1,48,42,90,46.7,14,38,36.8,28,52,53.85,26,32,81.3,15,39,54,23,11,5,5,22
671,ATL,1,48,50,85,58.8,15,28,53.6,35,57,61.4,21,23,91.3,5,37,42,28,14,7,8,21
672,OKC,0,48,41,95,43.2,15,38,39.5,26,57,45.61,18,24,75,14,33,47,27,9,5,2,21
673,CLE,0,48,40,88,45.5,13,35,37.1,27,53,50.94,26,29,89.7,10,25,35,20,11,9,6,23
674,HOU,0,48,36,92,39.1,11,35,31.4,25,57,43.86,18,22,81.8,13,31,44,23,7,12,3,18
675,MEM,0,48,34,87,39.1,7,32,21.9,27,55,49.09,30,36,83.3,13,36,49,22,11,5,7,27
676,GSW,0,48,40,105,38.1,14,49,28.6,26,56,46.43,17,21,81,17,31,48,24,10,10,3,23
677,CLE,0,48,43,90,47.8,6,26,23.1,37,64,57.81,17,20,85,13,28,41,24,11,10,2,21
678,OKC,0,53,45,112,40.2,8,37,21.6,37,75,49.33,21,27,77.8,20,34,54,23,11,8,3,23
679,LAL,1,48,42,86,48.8,16,30,53.3,26,56,46.43,24,34,70.6,10,48,58,30,16,8,3,20
680,NOP,0,48,39,84,46.4,13,30,43.3,26,54,48.15,19,25,76,6,37,43,23,13,6,2,19
681,POR,0,48,43,93,46.2,16,38,42.1,27,55,49.09,14,17,82.4,9,24,33,26,13,12,3,23
682,UTA,1,53,42,100,42,13,48,27.1,29,52,55.77,23,27,85.2,17,41,58,26,22,8,10,29
683,PHI,1,48,34,84,40.5,13,36,36.1,21,48,43.75,29,36,80.6,7,36,43,25,12,3,10,26
684,DET,0,48,37,81,45.7,17,34,50,20,47,42.55,15,19,78.9,6,39,45,22,21,5,7,25
685,TOR,1,48,43,92,46.7,9,31,29,34,61,55.74,20,25,80,11,37,48,17,12,10,5,20
686,SAC,1,48,47,85,55.3,14,34,41.2,33,51,64.71,25,31,80.6,12,37,49,27,18,9,4,16
687,DAL,1,48,46,82,56.1,22,42,52.4,24,40,60,28,36,77.8,3,33,36,27,7,10,5,18
688,DEN,1,48,39,84,46.4,17,36,47.2,22,48,45.83,20,23,87,18,29,47,30,16,7,4,20
689,SAS,0,48,45,86,52.3,10,25,40,35,61,57.38,16,23,69.6,10,35,45,30,17,4,1,25
690,ORL,1,48,39,95,41.1,12,31,38.7,27,64,42.19,18,23,78.3,12,34,46,27,14,7,6,19
691,BOS,1,53,51,99,51.5,18,39,46.2,33,60,55,22,26,84.6,20,31,51,31,15,7,6,18
692,IND,0,53,49,94,52.1,22,49,44.9,27,45,60,18,22,81.8,10,27,37,33,15,10,5,23
693,MIN,0,48,39,95,41.1,8,29,27.6,31,66,46.97,20,22,90.9,16,37,53,21,18,8,5,16
694,WAS,1,48,43,95,45.3,14,35,40,29,60,48.33,14,17,82.4,13,36,49,25,16,13,6,14
695,CHI,0,48,37,97,38.1,10,32,31.3,27,65,41.54,16,21,76.2,15,36,51,19,6,4,2,17
696,PHX,0,48,42,89,47.2,11,31,35.5,31,58,53.45,12,16,75,7,31,38,30,14,10,2,24
697,MIL,1,48,40,88,45.5,18,47,38.3,22,41,53.66,14,18,77.8,9,43,52,24,9,4,7,16
698,LAC,1,48,40,82,48.8,11,34,32.4,29,48,60.42,25,27,92.6,8,35,43,29,14,8,2,19
699,BKN,1,48,41,77,53.2,17,39,43.6,24,38,63.16,17,20,85,5,31,36,26,11,3,5,27
700,MEM,1,48,43,107,40.2,14,40,35,29,67,43.28,17,25,68,17,29,46,24,4,13,9,21
701,PHI,1,48,39,78,50,13,27,48.1,26,51,50.98,27,29,93.1,8,30,38,24,12,7,4,22
702,ATL,0,48,40,97,41.2,5,26,19.2,35,71,49.3,16,21,76.2,8,32,40,25,5,6,7,18
703,CLE,0,48,41,82,50,10,30,33.3,31,52,59.62,20,25,80,10,25,35,23,8,7,5,17
704,DAL,0,48,39,84,46.4,14,39,35.9,25,45,55.56,17,20,85,6,25,31,25,12,8,3,13
705,HOU,0,48,30,89,33.7,10,37,27,20,52,38.46,26,38,68.4,14,33,47,20,18,5,7,33
706,NOP,0,48,39,89,43.8,7,25,28,32,64,50,17,24,70.8,13,37,50,24,15,5,3,28
707,MIA,0,48,38,83,45.8,8,28,28.6,30,55,54.55,21,29,72.4,12,29,41,19,8,4,3,18
708,LAL,1,48,44,83,53,10,37,27,34,46,73.91,22,36,61.1,6,37,43,32,11,5,8,23
709,SAS,0,48,41,107,38.3,13,38,34.2,28,69,40.58,15,20,75,20,38,58,24,15,7,6,24
710,BOS,1,48,49,92,53.3,21,45,46.7,28,47,59.57,8,10,80,8,35,43,30,11,10,5,18
711,UTA,0,48,42,91,46.2,12,36,33.3,30,55,54.55,15,19,78.9,15,46,61,24,24,2,8,20
712,OKC,1,48,42,87,48.3,9,34,26.5,33,53,62.26,40,47,85.1,10,39,49,21,11,8,4,21
713,CHA,1,48,43,96,44.8,14,35,40,29,61,47.54,20,29,69,15,43,58,26,16,8,12,17
714,DET,0,48,43,84,51.2,11,29,37.9,32,55,58.18,12,16,75,6,29,35,24,14,6,4,16
715,IND,1,48,39,82,47.6,18,43,41.9,21,39,53.85,21,22,95.5,6,35,41,27,19,6,5,19
716,NYK,1,48,45,96,46.9,14,43,32.6,31,53,58.49,18,22,81.8,10,45,55,16,10,2,4,21
717,DEN,1,48,48,84,57.1,11,31,35.5,37,53,69.81,11,15,73.3,6,37,43,34,13,7,5,14
718,CHI,0,48,41,84,48.8,15,35,42.9,26,49,53.06,16,21,76.2,6,32,38,23,14,10,6,21
719,GSW,0,48,45,83,54.2,15,34,44.1,30,49,61.22,19,27,70.4,8,28,36,28,11,2,1,22
720,ORL,0,48,43,84,51.2,13,31,41.9,30,53,56.6,14,18,77.8,9,20,29,26,19,6,2,17
721,LAC,1,48,49,92,53.3,17,36,47.2,32,56,57.14,19,22,86.4,12,24,36,33,8,5,4,22
722,POR,0,48,36,86,41.9,12,42,28.6,24,44,54.55,17,24,70.8,12,25,37,20,12,9,5,19
723,BOS,0,53,46,99,46.5,17,50,34,29,49,59.18,16,20,80,8,36,44,28,13,8,1,26
724,TOR,1,48,50,83,60.2,8,24,33.3,42,59,71.19,15,20,75,13,27,40,31,20,9,11,16
725,SAC,0,48,37,83,44.6,14,38,36.8,23,45,51.11,21,24,87.5,13,27,40,23,17,8,4,21
726,PHX,1,48,50,88,56.8,7,22,31.8,43,66,65.15,13,16,81.3,8,29,37,33,15,12,4,17
727,WAS,1,48,45,79,57,17,33,51.5,28,46,60.87,19,22,86.4,5,39,44,28,16,5,2,17
728,MIL,1,53,43,90,47.8,18,42,42.9,25,48,52.08,27,35,77.1,10,42,52,29,19,6,3,23
729,CLE,1,48,44,78,56.4,9,28,32.1,35,50,70,20,25,80,11,25,36,21,14,8,6,16
730,SAS,0,48,43,85,50.6,8,21,38.1,35,64,54.69,15,20,75,11,24,35,27,18,10,1,21
731,BKN,0,48,35,78,44.9,12,29,41.4,23,49,46.94,24,33,72.7,10,29,39,18,10,3,3,19
732,NYK,1,48,45,82,54.9,15,34,44.1,30,48,62.5,19,26,73.1,6,32,38,18,8,4,3,24
733,LAL,0,48,42,95,44.2,12,37,32.4,30,58,51.72,19,21,90.5,14,42,56,24,13,6,5,16
734,CHI,0,48,35,86,40.7,3,21,14.3,32,65,49.23,18,19,94.7,10,34,44,17,16,8,3,21
735,MIA,0,48,39,89,43.8,12,35,34.3,27,54,50,18,20,90,9,25,34,25,9,9,4,14
736,OKC,0,48,38,90,42.2,9,33,27.3,29,57,50.88,15,18,83.3,14,29,43,20,17,8,3,17
737,IND,0,48,46,91,50.5,11,34,32.4,35,57,61.4,14,20,70,8,24,32,30,11,11,7,21
738,ORL,1,48,38,81,46.9,8,27,29.6,30,54,55.56,16,19,84.2,7,35,42,24,18,8,6,19
739,WAS,0,48,48,80,60,12,28,42.9,36,52,69.23,18,21,85.7,9,24,33,26,17,10,3,15
740,DAL,0,48,43,84,51.2,13,39,33.3,30,45,66.67,22,29,75.9,9,24,33,21,11,5,1,21
741,PHI,1,48,46,82,56.1,15,34,44.1,31,48,64.58,16,17,94.1,7,31,38,26,16,11,7,24
742,DEN,1,48,44,76,57.9,11,28,39.3,33,48,68.75,13,15,86.7,6,33,39,34,13,3,4,18
743,MIN,1,48,48,83,57.8,9,29,31,39,54,72.22,19,26,73.1,10,29,39,28,12,8,2,26
744,NOP,1,48,39,74,52.7,9,30,30,30,44,68.18,16,18,88.9,4,29,33,19,19,13,8,21
745,GSW,1,48,52,89,58.4,20,40,50,32,49,65.31,11,15,73.3,11,23,34,40,16,10,0,19
746,UTA,1,48,43,85,50.6,15,33,45.5,28,52,53.85,22,25,88,11,35,46,24,19,5,3,17
747,ATL,0,48,53,108,49.1,11,28,39.3,42,80,52.5,21,21,100,16,26,42,26,12,9,4,15
748,CHA,1,48,53,84,63.1,20,37,54.1,33,47,70.21,18,23,78.3,3,32,35,36,17,5,5,19
749,POR,1,48,46,97,47.4,23,47,48.9,23,50,46,12,13,92.3,8,34,42,27,7,7,9,15
750,HOU,0,48,35,86,40.7,6,24,25,29,62,46.77,28,31,90.3,15,27,42,17,17,10,2,15
751,DET,0,48,40,79,50.6,13,34,38.2,27,45,60,25,32,78.1,6,26,32,25,18,3,4,26
752,TOR,1,48,42,87,48.3,11,30,36.7,31,57,54.39,24,36,66.7,13,27,40,21,8,5,8,26
753,BOS,1,48,39,88,44.3,21,51,41.2,18,37,48.65,20,26,76.9,15,40,55,28,11,5,3,14
754,MEM,0,48,42,84,50,12,34,35.3,30,50,60,13,21,61.9,3,31,34,24,8,4,5,22
755,SAS,0,48,40,94,42.6,11,37,29.7,29,57,50.88,15,17,88.2,14,35,49,25,20,9,5,17
756,ORL,0,53,37,87,42.5,11,29,37.9,26,58,44.83,18,23,78.3,12,32,44,22,18,12,5,24
757,SAC,1,53,51,100,51,8,32,25,43,68,63.24,23,25,92,11,39,50,22,7,9,0,17
758,LAL,1,48,40,89,44.9,8,25,32,32,64,50,21,26,80.8,10,42,52,19,16,4,4,12
759,NYK,1,48,43,95,45.3,12,36,33.3,31,59,52.54,28,38,73.7,20,32,52,18,6,6,4,24
760,UTA,0,48,45,88,51.1,9,32,28.1,36,56,64.29,21,28,75,11,27,38,23,12,3,7,24
761,MIA,1,53,37,85,43.5,12,39,30.8,25,46,54.35,21,23,91.3,11,35,46,24,20,7,6,22
762,DAL,0,53,47,91,51.6,20,51,39.2,27,40,67.5,14,19,73.7,7,36,43,27,16,4,4,19
763,GSW,0,48,40,96,41.7,12,44,27.3,28,52,53.85,11,12,91.7,7,36,43,31,16,11,6,21
764,WAS,1,48,48,75,64,12,26,46.2,36,49,73.47,19,22,86.4,8,32,40,32,18,5,7,16
765,DEN,1,48,50,99,50.5,5,23,21.7,45,76,59.21,14,17,82.4,14,37,51,35,14,7,5,20
766,PHI,1,48,33,75,44,6,23,26.1,27,52,51.92,29,30,96.7,8,33,41,17,12,4,3,12
767,IND,0,48,43,95,45.3,14,40,35,29,55,52.73,13,17,76.5,17,16,33,27,8,8,3,18
768,CLE,1,48,36,86,41.9,9,35,25.7,27,51,52.94,16,19,84.2,10,29,39,26,13,9,4,15
769,ATL,1,48,50,103,48.5,10,26,38.5,40,77,51.95,15,19,78.9,14,34,48,29,10,9,6,10
770,CHI,0,48,36,74,48.6,5,21,23.8,31,53,58.49,12,15,80,6,38,44,27,23,7,3,22
771,CHA,0,48,40,85,47.1,8,32,25,32,53,60.38,17,29,58.6,5,32,37,25,14,11,8,18
772,BKN,0,48,37,92,40.2,13,40,32.5,24,52,46.15,11,13,84.6,12,30,42,23,9,7,6,20
773,CLE,1,48,48,85,56.5,10,28,35.7,38,57,66.67,12,15,80,12,29,41,28,14,9,5,22
774,SAS,0,58,45,107,42.1,14,42,33.3,31,65,47.69,27,34,79.4,13,38,51,21,19,7,3,32
775,PHI,1,48,44,84,52.4,14,38,36.8,30,46,65.22,17,22,77.3,6,34,40,27,8,8,2,15
776,SAC,0,48,39,72,54.2,9,27,33.3,30,45,66.67,27,32,84.4,5,33,38,21,14,2,4,19
777,MIL,1,48,45,90,50,17,39,43.6,28,51,54.9,12,16,75,9,40,49,28,11,8,4,13
778,MIA,1,48,32,77,41.6,12,38,31.6,20,39,51.28,21,22,95.5,6,34,40,21,17,11,6,23
779,HOU,0,48,35,84,41.7,7,30,23.3,28,54,51.85,18,24,75,10,37,47,23,18,11,4,21
780,MEM,1,48,49,84,58.3,10,25,40,39,59,66.1,20,27,74.1,9,35,44,27,19,12,6,19
781,UTA,1,48,47,87,54,6,24,25,41,63,65.08,22,29,75.9,9,37,46,31,17,6,6,20
782,NYK,0,48,43,81,53.1,11,32,34.4,32,49,65.31,11,16,68.8,4,31,35,23,12,1,5,17
783,BOS,1,48,44,89,49.4,25,55,45.5,19,34,55.88,14,17,82.4,5,38,43,34,15,7,7,22
784,DET,1,58,46,107,43,7,37,18.9,39,70,55.71,39,49,79.6,21,41,62,29,16,6,5,29
785,CHA,0,48,45,93,48.4,8,23,34.8,37,70,52.86,18,26,69.2,11,36,47,26,13,9,6,18
786,OKC,1,48,47,83,56.6,12,24,50,35,59,59.32,32,35,91.4,10,19,29,29,11,9,3,26
787,POR,0,48,42,76,55.3,16,40,40,26,36,72.22,29,31,93.5,9,23,32,29,20,3,5,27
788,DAL,1,48,43,88,48.9,18,43,41.9,25,45,55.56,18,19,94.7,11,28,39,34,12,4,0,19
789,LAC,0,48,42,85,49.4,11,33,33.3,31,52,59.62,11,14,78.6,3,32,35,17,10,5,7,12
790,MIN,0,48,41,88,46.6,15,37,40.5,26,51,50.98,10,12,83.3,7,28,35,25,18,7,4,20
791,IND,0,48,36,85,42.4,11,39,28.2,25,46,54.35,21,28,75,11,27,38,23,15,9,3,16
792,PHX,1,48,43,93,46.2,10,33,30.3,33,60,55,21,24,87.5,19,34,53,25,17,13,2,24
793,TOR,0,48,41,91,45.1,12,34,35.3,29,57,50.88,22,30,73.3,9,31,40,28,13,11,3,30
794,NOP,0,48,39,82,47.6,9,24,37.5,30,58,51.72,20,25,80,11,23,34,25,14,8,3,18
795,ATL,1,48,43,95,45.3,10,29,34.5,33,66,50,20,27,74.1,20,39,59,23,19,6,4,22
796,CHI,0,48,42,91,46.2,5,26,19.2,37,65,56.92,16,21,76.2,8,38,46,15,12,4,2,16
797,ORL,1,48,47,97,48.5,9,27,33.3,38,70,54.29,12,19,63.2,15,32,47,24,10,12,6,16
798,BKN,1,48,39,91,42.9,17,44,38.6,22,47,46.81,21,25,84,11,38,49,26,11,8,1,20
799,LAL,0,48,42,89,47.2,7,18,38.9,35,71,49.3,15,21,71.4,11,32,43,23,12,2,2,19
800,MIL,1,48,45,99,45.5,12,47,25.5,33,52,63.46,13,18,72.2,16,35,51,24,11,5,7,20
801,DEN,0,48,39,84,46.4,10,33,30.3,29,51,56.86,16,24,66.7,7,32,39,24,16,6,5,15
802,PHX,0,48,39,86,45.3,7,30,23.3,32,56,57.14,22,29,75.9,9,26,35,24,11,14,10,19
803,CLE,1,48,43,87,49.4,6,26,23.1,37,61,60.66,21,25,84,13,37,50,30,13,8,4,16
804,UTA,0,48,44,105,41.9,12,34,35.3,32,71,45.07,18,21,85.7,21,29,50,27,8,2,5,12
805,POR,1,48,43,78,55.1,8,27,29.6,35,51,68.63,31,32,96.9,12,35,47,25,21,6,3,16
806,IND,0,48,38,78,48.7,15,33,45.5,23,45,51.11,20,28,71.4,5,26,31,24,11,3,5,25
807,SAS,0,48,35,87,40.2,9,32,28.1,26,55,47.27,19,27,70.4,7,32,39,24,16,11,4,18
808,HOU,0,48,47,86,54.7,10,22,45.5,37,64,57.81,24,28,85.7,15,29,44,25,19,4,7,21
809,GSW,0,48,46,97,47.4,21,49,42.9,25,48,52.08,9,10,90,10,22,32,31,11,11,2,24
810,BOS,1,48,40,76,52.6,19,35,54.3,21,41,51.22,7,10,70,5,39,44,25,15,2,5,19
811,MIA,1,48,37,79,46.8,6,19,31.6,31,60,51.67,36,39,92.3,15,33,48,21,13,7,3,22
812,TOR,1,48,43,88,48.9,10,28,35.7,33,60,55,16,21,76.2,9,42,51,21,17,11,7,19
813,CHA,0,48,39,93,41.9,9,31,29,30,62,48.39,17,21,81,12,28,40,23,7,11,5,17
814,DAL,1,48,41,78,52.6,17,35,48.6,24,43,55.81,11,17,64.7,8,36,44,26,18,7,6,20
815,DET,0,48,30,81,37,8,32,25,22,49,44.9,17,18,94.4,9,23,32,19,14,8,6,21
816,SAC,1,48,46,92,50,10,30,33.3,36,62,58.06,28,30,93.3,10,21,31,29,9,10,4,15
817,WAS,1,48,44,87,50.6,15,37,40.5,29,50,58,15,17,88.2,11,41,52,29,17,4,12,17
818,LAC,0,48,38,86,44.2,12,33,36.4,26,53,49.06,16,21,76.2,9,31,40,21,11,10,4,18
819,MIN,1,48,56,98,57.1,23,43,53.5,33,55,60,8,8,100,8,39,47,35,11,6,6,19
820,PHI,0,48,37,83,44.6,10,31,32.3,27,52,51.92,15,20,75,8,29,37,20,7,9,3,16
821,OKC,1,48,49,94,52.1,17,34,50,32,60,53.33,18,20,90,7,30,37,32,13,12,2,18
822,MEM,1,48,39,81,48.1,11,33,33.3,28,48,58.33,15,21,71.4,5,34,39,22,14,10,7,21
823,NOP,1,48,45,91,49.5,12,32,37.5,33,59,55.93,14,21,66.7,13,34,47,28,10,8,2,19
824,MIN,0,48,40,85,47.1,10,35,28.6,30,50,60,22,26,84.6,8,28,36,24,17,6,7,16
825,ORL,0,48,37,79,46.8,6,25,24,31,54,57.41,18,24,75,9,32,41,23,11,4,4,19
826,CHI,0,48,32,87,36.8,7,35,20,25,52,48.08,18,27,66.7,11,38,49,24,20,9,3,16
827,PHX,1,48,43,92,46.7,9,31,29,34,61,55.74,21,28,75,16,32,48,31,15,10,4,24
828,LAL,0,48,49,85,57.6,14,31,45.2,35,54,64.81,18,26,69.2,6,35,41,27,21,8,3,19
829,NYK,1,48,37,81,45.7,15,43,34.9,22,38,57.89,13,19,68.4,11,32,43,21,11,6,2,22
830,DEN,1,48,58,93,62.4,13,27,48.1,45,66,68.18,17,22,77.3,6,38,44,44,11,12,5,21
831,ATL,0,48,38,85,44.7,12,36,33.3,26,49,53.06,19,25,76,10,31,41,30,12,4,6,21
832,BKN,0,48,38,79,48.1,9,28,32.1,29,51,56.86,27,31,87.1,5,31,36,25,17,11,2,21
833,MIL,1,48,47,87,54,16,42,38.1,31,45,68.89,17,21,81,7,48,55,27,16,4,2,27
834,SAS,0,48,40,90,44.4,8,26,30.8,32,64,50,16,17,94.1,6,32,38,25,18,7,3,23
835,DET,0,48,37,87,42.5,9,33,27.3,28,54,51.85,16,21,76.2,9,33,42,22,9,9,6,20
836,POR,0,48,37,91,40.7,9,36,25,28,55,50.91,25,29,86.2,1,27,28,23,9,5,2,20
837,UTA,0,48,41,87,47.1,6,31,19.4,35,56,62.5,23,26,88.5,10,27,37,21,13,4,4,23
838,DAL,1,48,41,88,46.6,15,39,38.5,26,49,53.06,27,31,87.1,17,32,49,26,14,6,4,25
839,CLE,1,48,44,78,56.4,12,29,41.4,32,49,65.31,14,20,70,7,36,43,26,17,9,6,15
840,LAC,1,48,44,92,47.8,12,30,40,32,62,51.61,24,30,80,11,35,46,20,9,11,5,19
841,BOS,1,48,39,83,47,16,37,43.2,23,46,50,17,21,81,10,41,51,25,12,2,5,22
842,OKC,0,48,44,91,48.4,11,32,34.4,33,59,55.93,15,21,71.4,7,29,36,21,11,8,3,10
843,GSW,1,48,56,97,57.7,26,50,52,30,47,63.83,3,7,42.9,11,34,45,43,16,6,3,17
844,BKN,0,48,41,84,48.8,16,31,51.6,25,53,47.17,18,22,81.8,8,34,42,21,16,4,5,26
845,SAC,1,48,52,89,58.4,21,41,51.2,31,48,64.58,15,18,83.3,7,28,35,38,10,9,5,22
846,WAS,0,48,35,82,42.7,6,28,21.4,29,54,53.7,15,19,78.9,7,30,37,20,14,8,5,18
847,HOU,0,48,44,88,50,13,32,40.6,31,56,55.36,19,24,79.2,11,28,39,27,14,5,4,15
848,CHI,1,48,50,89,56.2,6,22,27.3,44,67,65.67,22,25,88,7,42,49,27,14,10,6,12
849,PHI,0,48,30,74,40.5,7,25,28,23,49,46.94,30,36,83.3,8,36,44,23,12,4,4,23
850,CHA,0,48,45,83,54.2,12,33,36.4,33,50,66,11,23,47.8,8,31,39,28,15,8,6,23
851,IND,0,48,40,92,43.5,8,32,25,32,60,53.33,15,22,68.2,12,30,42,28,13,3,6,20
852,DEN,0,48,34,71,47.9,6,25,24,28,46,60.87,24,31,77.4,3,34,37,19,22,6,5,23
853,SAC,0,48,35,82,42.7,11,42,26.2,24,40,60,23,27,85.2,11,27,38,23,15,5,5,22
854,CLE,1,48,46,88,52.3,15,37,40.5,31,51,60.78,15,16,93.8,8,38,46,33,13,7,5,20
855,NOP,1,48,48,85,56.5,14,26,53.8,34,59,57.63,26,34,76.5,12,36,48,26,11,11,3,23
856,TOR,1,48,44,101,43.6,11,36,30.6,33,65,50.77,7,12,58.3,11,31,42,24,11,11,3,16
857,NYK,1,48,34,79,43,12,36,33.3,22,43,51.16,28,39,71.8,14,35,49,21,12,5,1,28
858,MIN,1,48,48,87,55.2,10,27,37,38,60,63.33,22,30,73.3,5,29,34,33,11,7,3,23
859,ORL,1,48,42,91,46.2,8,23,34.8,34,68,50,27,30,90,18,34,52,25,12,6,2,18
860,MEM,0,48,38,78,48.7,10,27,37,28,51,54.9,17,23,73.9,8,36,44,25,20,10,9,16
861,GSW,1,48,45,82,54.9,14,35,40,31,47,65.96,15,19,78.9,5,33,38,33,14,6,5,24
862,PHX,1,48,42,75,56,11,23,47.8,31,52,59.62,21,31,67.7,10,36,46,34,17,10,2,23
863,LAL,0,48,45,94,47.9,11,32,34.4,34,62,54.84,25,33,75.8,13,31,44,30,9,4,3,20
864,DET,0,48,35,81,43.2,16,42,38.1,19,39,48.72,14,22,63.6,9,21,30,23,16,8,2,27
865,NOP,1,48,52,100,52,9,30,30,43,70,61.43,18,20,90,14,34,48,28,11,6,0,22
866,NYK,0,53,45,94,47.9,18,40,45,27,54,50,20,26,76.9,10,36,46,30,10,6,3,30
867,POR,0,48,44,87,50.6,14,43,32.6,30,44,68.18,19,21,90.5,7,26,33,22,9,3,3,19
868,WAS,0,48,39,81,48.1,13,28,46.4,26,53,49.06,32,41,78,6,33,39,22,16,10,3,21
869,OKC,1,48,56,97,57.7,21,46,45.7,35,51,68.63,20,23,87,9,33,42,39,9,11,6,19
870,BKN,1,48,43,86,50,14,33,42.4,29,53,54.72,25,28,89.3,10,29,39,21,15,4,10,28
871,HOU,0,48,45,89,50.6,10,30,33.3,35,59,59.32,21,27,77.8,9,25,34,29,16,4,8,18
872,ATL,0,48,44,91,48.4,6,20,30,38,71,53.52,14,17,82.4,10,33,43,26,16,7,7,18
873,MIA,0,48,45,101,44.6,8,31,25.8,37,70,52.86,17,21,81,13,31,44,23,7,9,2,23
874,DAL,0,48,39,85,45.9,14,40,35,25,45,55.56,21,27,77.8,10,29,39,22,14,9,1,18
875,DEN,1,48,48,95,50.5,15,38,39.5,33,57,57.89,17,20,85,12,36,48,32,13,14,6,15
876,CHI,1,48,48,80,60,12,26,46.2,36,54,66.67,21,25,84,6,35,41,32,12,6,3,19
877,LAC,1,53,44,92,47.8,16,37,43.2,28,55,50.91,30,35,85.7,9,37,46,24,13,8,4,20
878,MIL,1,48,46,88,52.3,14,40,35,32,48,66.67,17,28,60.7,10,41,51,23,12,6,4,14
879,ATL,1,48,44,95,46.3,10,37,27,34,58,58.62,17,23,73.9,14,38,52,28,9,8,5,18
880,UTA,0,48,41,91,45.1,13,44,29.5,28,47,59.57,13,18,72.2,13,37,50,20,15,4,2,22
881,SAS,0,48,52,89,58.4,7,21,33.3,45,68,66.18,14,15,93.3,9,26,35,32,18,8,0,25
882,PHI,1,48,46,87,52.9,13,27,48.1,33,60,55,32,41,78,14,25,39,28,11,11,3,13
883,MIN,0,48,40,87,46,16,44,36.4,24,43,55.81,24,28,85.7,12,29,41,21,20,7,7,27
884,PHX,1,48,41,95,43.2,12,32,37.5,29,63,46.03,12,14,85.7,10,43,53,28,9,6,6,22
885,IND,1,48,40,89,44.9,17,41,41.5,23,48,47.92,10,14,71.4,9,38,47,28,18,13,5,18
886,ORL,1,48,45,85,52.9,12,23,52.2,33,62,53.23,25,38,65.8,13,29,42,23,17,11,3,24
887,BOS,0,48,29,75,38.7,10,38,26.3,19,37,51.35,26,31,83.9,3,40,43,18,15,5,3,21
888,POR,1,48,43,88,48.9,17,41,41.5,26,47,55.32,21,23,91.3,11,27,38,25,7,5,2,17
889,SAC,0,48,37,86,43,13,38,34.2,24,48,50,17,20,85,11,38,49,24,20,6,5,15
890,DET,1,48,44,86,51.2,14,32,43.8,30,54,55.56,16,23,69.6,12,39,51,27,23,7,3,22
891,WAS,0,48,42,84,50,12,33,36.4,30,51,58.82,20,22,90.9,9,32,41,27,11,4,3,19
892,TOR,1,48,41,90,45.6,15,39,38.5,26,51,50.98,20,27,74.1,13,30,43,21,9,9,7,25
893,CHA,0,48,40,90,44.4,9,34,26.5,31,56,55.36,23,30,76.7,8,29,37,22,14,16,2,20
894,HOU,0,48,40,80,50,7,21,33.3,33,59,55.93,24,33,72.7,6,34,40,22,13,5,4,26
895,CHA,0,48,39,93,41.9,7,35,20,32,58,55.17,13,14,92.9,16,29,45,19,15,6,4,15
896,LAC,0,48,39,95,41.1,13,36,36.1,26,59,44.07,14,20,70,9,40,49,15,7,8,4,22
897,CLE,1,48,49,91,53.8,14,29,48.3,35,62,56.45,16,22,72.7,9,32,41,33,16,12,7,17
898,GSW,0,48,43,85,50.6,19,38,50,24,47,51.06,12,19,63.2,10,32,42,25,17,4,4,23
899,DAL,1,48,37,85,43.5,14,41,34.1,23,44,52.27,23,29,79.3,6,30,36,16,8,10,3,24
900,DEN,1,48,51,90,56.7,16,35,45.7,35,55,63.64,16,21,76.2,7,31,38,35,13,10,2,19
901,NOP,0,48,42,84,50,5,20,25,37,64,57.81,17,21,81,12,38,50,27,17,6,5,26
902,MIL,1,48,39,90,43.3,9,37,24.3,30,53,56.6,19,27,70.4,8,45,53,16,10,2,0,17
903,NYK,1,48,40,83,48.2,12,36,33.3,28,47,59.57,14,18,77.8,11,33,44,25,18,8,0,17
904,MIA,0,48,39,87,44.8,13,36,36.1,26,51,50.98,13,16,81.3,9,24,33,24,11,8,3,15
905,MEM,0,48,41,87,47.1,10,23,43.5,31,64,48.44,21,22,95.5,11,33,44,22,18,8,5,23
906,CHI,1,48,41,79,51.9,11,28,39.3,30,51,58.82,21,26,80.8,8,32,40,24,14,9,3,18
907,LAL,1,48,42,92,45.7,6,22,27.3,36,70,51.43,22,31,71,13,38,51,29,13,8,5,10
908,IND,0,48,45,93,48.4,16,41,39,29,52,55.77,5,6,83.3,6,40,46,30,16,8,6,21
909,OKC,0,48,38,103,36.9,12,43,27.9,26,60,43.33,18,22,81.8,24,28,52,22,10,11,6,23
910,BOS,1,48,53,92,57.6,26,54,48.1,27,38,71.05,7,10,70,11,46,57,28,12,4,4,13
911,HOU,1,48,41,94,43.6,7,23,30.4,34,71,47.89,23,31,74.2,24,41,65,20,18,6,12,20
912,TOR,0,48,50,110,45.5,10,23,43.5,40,87,45.98,18,26,69.2,25,27,52,27,8,11,2,22
913,SAS,0,48,48,88,54.5,8,24,33.3,40,64,62.5,5,7,71.4,8,32,40,30,18,5,1,17
914,ATL,1,48,52,91,57.1,19,33,57.6,33,58,56.9,9,11,81.8,6,39,45,32,12,6,5,24
915,UTA,1,48,44,83,53,17,47,36.2,27,36,75,26,30,86.7,13,36,49,29,16,3,11,17
916,SAC,1,48,48,90,53.3,8,27,29.6,40,63,63.49,15,19,78.9,6,28,34,25,10,10,3,13
917,POR,1,48,41,87,47.1,14,36,38.9,27,51,52.94,26,27,96.3,9,32,41,24,13,3,5,22
918,GSW,0,53,38,91,41.8,11,35,31.4,27,56,48.21,27,34,79.4,9,49,58,21,17,7,4,24
919,MEM,0,48,41,87,47.1,9,37,24.3,32,50,64,21,28,75,12,32,44,28,13,8,7,22
920,PHX,0,48,35,86,40.7,4,28,14.3,31,58,53.45,26,31,83.9,12,32,44,22,16,8,4,13
921,ORL,0,48,33,87,37.9,6,38,15.8,27,49,55.1,22,29,75.9,12,34,46,12,15,10,4,21
922,PHI,1,48,34,78,43.6,14,35,40,20,43,46.51,23,26,88.5,7,36,43,27,19,7,4,24
923,MIN,1,53,46,106,43.4,14,50,28,32,56,57.14,13,24,54.2,10,43,53,26,11,5,7,23
924,BKN,0,48,36,88,40.9,9,39,23.1,27,49,55.1,15,18,83.3,5,27,32,19,7,8,1,12
925,LAL,1,53,48,93,51.6,11,33,33.3,37,60,61.67,22,31,71,11,33,44,29,14,6,1,23
926,NYK,0,53,44,98,44.9,7,34,20.6,37,64,57.81,28,32,87.5,13,32,45,27,9,6,3,24
927,DEN,1,48,43,87,49.4,16,36,44.4,27,51,52.94,20,24,83.3,10,34,44,33,18,7,3,21
928,CHI,0,48,38,77,49.4,12,24,50,26,53,49.06,15,21,71.4,6,45,51,26,20,6,6,19
929,CLE,0,48,40,83,48.2,11,40,27.5,29,43,67.44,6,12,50,5,34,39,32,13,9,6,20
930,NOP,0,48,42,85,49.4,8,27,29.6,34,58,58.62,21,25,84,8,28,36,28,15,13,2,24
931,MIL,1,48,43,105,41,15,44,34.1,28,61,45.9,23,27,85.2,16,50,66,18,12,7,8,21
932,LAC,1,48,37,93,39.8,12,44,27.3,25,49,51.02,22,26,84.6,11,33,44,24,8,15,6,16
933,MIA,1,48,34,78,43.6,14,31,45.2,20,47,42.55,18,25,72,9,36,45,21,15,7,3,17
934,CHA,0,48,42,111,37.8,11,39,28.2,31,72,43.06,20,26,76.9,18,44,62,27,11,6,6,24
935,ORL,1,48,42,99,42.4,11,29,37.9,31,70,44.29,24,30,80,15,35,50,23,10,11,6,16
936,LAL,0,48,35,89,39.3,11,29,37.9,24,60,40,23,37,62.2,16,37,53,24,14,1,3,16
937,WAS,1,48,48,86,55.8,16,30,53.3,32,56,57.14,15,17,88.2,5,40,45,32,14,7,8,19
938,TOR,0,48,40,89,44.9,9,33,27.3,31,56,55.36,17,19,89.5,16,28,44,19,14,9,4,19
939,DET,0,48,36,79,45.6,14,39,35.9,22,40,55,19,27,70.4,9,31,40,18,14,9,6,31
940,POR,1,48,43,79,54.4,19,40,47.5,24,39,61.54,24,27,88.9,3,29,32,24,8,2,7,21
941,DAL,1,48,39,79,49.4,10,34,29.4,29,45,64.44,23,33,69.7,9,31,40,17,11,6,1,18
942,PHI,0,48,40,85,47.1,11,30,36.7,29,55,52.73,18,23,78.3,8,37,45,28,19,8,3,25
943,MIN,0,53,43,92,46.7,12,39,30.8,31,53,58.49,13,25,52,8,41,49,26,18,7,3,16
944,OKC,0,48,46,93,49.5,11,24,45.8,35,69,50.72,17,20,85,8,35,43,23,17,10,4,18
945,SAC,1,53,47,99,47.5,9,30,30,38,69,55.07,15,22,68.2,10,40,50,20,12,15,3,21
946,BKN,1,48,45,95,47.4,16,41,39,29,54,53.7,15,19,78.9,12,38,50,24,11,8,9,25
947,GSW,1,48,46,90,51.1,20,47,42.6,26,43,60.47,16,20,80,6,38,44,37,15,9,4,18
948,SAS,0,48,42,97,43.3,7,29,24.1,35,68,51.47,15,23,65.2,14,29,43,26,10,6,6,20
949,PHX,1,48,43,87,49.4,11,28,39.3,32,59,54.24,17,21,81,13,29,42,28,12,10,4,16
950,ATL,0,48,44,94,46.8,13,30,43.3,31,64,48.44,24,30,80,17,28,45,26,7,5,0,21
951,MIA,0,48,45,93,48.4,10,31,32.3,35,62,56.45,17,23,73.9,10,26,36,26,11,11,0,17
952,IND,0,48,36,79,45.6,9,32,28.1,27,47,57.45,19,21,90.5,11,27,38,21,18,4,6,22
953,NOP,0,48,41,93,44.1,13,34,38.2,28,59,47.46,15,21,71.4,8,30,38,25,12,7,3,20
954,LAC,0,48,37,89,41.6,2,19,10.5,35,70,50,23,27,85.2,15,30,45,17,15,6,0,19
955,CHA,1,48,45,83,54.2,15,40,37.5,30,43,69.77,17,22,77.3,11,36,47,25,19,6,3,18
956,MIL,1,48,53,96,55.2,17,43,39.5,36,53,67.92,12,20,60,12,45,57,27,12,7,4,18
957,MEM,1,48,43,89,48.3,9,37,24.3,34,52,65.38,17,22,77.3,15,26,41,29,9,10,8,21
958,CLE,1,48,44,78,56.4,20,33,60.6,24,45,53.33,14,19,73.7,4,31,35,35,13,9,7,23
959,NOP,0,48,39,92,42.4,8,29,27.6,31,63,49.21,17,19,89.5,8,34,42,21,10,9,8,26
960,BOS,1,53,39,84,46.4,13,40,32.5,26,44,59.09,34,39,87.2,7,39,46,18,12,8,9,22
961,SAC,0,48,37,82,45.1,9,33,27.3,28,49,57.14,27,36,75,10,26,36,23,9,5,0,21
962,NYK,0,48,45,88,51.1,10,28,35.7,35,60,58.33,15,19,78.9,14,31,45,19,11,4,4,14
963,ATL,0,48,45,95,47.4,7,27,25.9,38,68,55.88,16,20,80,15,32,47,24,9,12,2,18
964,ORL,0,48,41,83,49.4,10,28,35.7,31,55,56.36,17,24,70.8,6,30,36,29,13,5,0,18
965,BKN,1,48,46,87,52.9,22,40,55,24,47,51.06,8,14,57.1,9,26,35,31,9,5,3,17
966,PHX,1,53,50,103,48.5,8,24,33.3,42,79,53.16,20,26,76.9,17,35,52,31,9,7,6,19
967,MIN,1,48,42,80,52.5,17,37,45.9,25,43,58.14,16,21,76.2,9,35,44,25,20,5,2,26
968,SAS,0,53,48,109,44,10,29,34.5,38,80,47.5,12,17,70.6,17,36,53,32,13,6,4,20
969,DEN,0,48,44,81,54.3,14,34,41.2,30,47,63.83,17,20,85,6,30,36,28,14,6,6,14
970,PHI,1,48,46,89,51.7,18,35,51.4,28,54,51.85,16,24,66.7,12,27,39,31,11,10,2,15
971,CHI,1,48,48,81,59.3,16,35,45.7,32,46,69.57,16,19,84.2,4,34,38,30,12,5,6,22
972,UTA,1,48,39,82,47.6,13,36,36.1,26,46,56.52,17,24,70.8,13,36,49,26,17,9,6,23
973,WAS,1,48,40,88,45.5,11,36,30.6,29,52,55.77,22,29,75.9,13,40,53,18,18,5,8,17
974,DAL,0,48,35,80,43.8,18,46,39.1,17,34,50,12,17,70.6,7,24,31,26,14,7,3,18
975,HOU,1,48,44,92,47.8,8,27,29.6,36,65,55.38,21,27,77.8,16,32,48,20,17,8,4,20
976,TOR,1,48,48,92,52.2,10,30,33.3,38,62,61.29,17,18,94.4,15,30,45,24,8,6,3,18
977,DET,0,48,38,83,45.8,14,38,36.8,24,45,53.33,24,31,77.4,8,27,35,23,16,10,5,25
978,LAL,0,53,47,105,44.8,12,42,28.6,35,63,55.56,15,20,75,11,36,47,30,12,4,0,23
979,POR,0,48,40,76,52.6,7,24,29.2,33,52,63.46,18,23,78.3,3,24,27,18,12,3,6,16
980,LAC,1,48,42,80,52.5,19,39,48.7,23,41,56.1,17,19,89.5,6,31,37,25,14,5,5,15
981,ORL,0,48,33,69,47.8,12,34,35.3,21,35,60,27,32,84.4,2,38,40,21,20,5,3,23
982,MIN,1,48,44,86,51.2,13,35,37.1,31,51,60.78,10,15,66.7,9,36,45,31,20,12,6,19
983,IND,0,48,49,89,55.1,13,33,39.4,36,56,64.29,20,28,71.4,5,33,38,22,13,10,4,24
984,OKC,1,48,40,76,52.6,10,18,55.6,30,58,51.72,22,25,88,10,36,46,19,15,5,2,17
985,TOR,0,48,46,101,45.5,12,33,36.4,34,68,50,13,21,61.9,14,32,46,24,10,5,4,17
986,CLE,0,48,39,88,44.3,8,29,27.6,31,59,52.54,14,18,77.8,11,26,37,27,10,9,5,21
987,MIA,1,48,39,85,45.9,10,33,30.3,29,52,55.77,22,26,84.6,5,32,37,28,11,9,3,19
988,MIL,1,48,52,98,53.1,18,43,41.9,34,55,61.82,19,31,61.3,14,36,50,32,16,11,3,20
989,MEM,0,48,38,93,40.9,8,33,24.2,30,60,50,16,19,84.2,15,32,47,22,21,14,2,12
990,GSW,1,48,50,90,55.6,18,43,41.9,32,47,68.09,11,15,73.3,5,38,43,40,14,5,1,18
991,HOU,0,48,39,76,51.3,5,21,23.8,34,55,61.82,12,20,60,10,36,46,24,22,5,6,20
992,NYK,1,53,44,96,45.8,13,38,34.2,31,58,53.45,19,23,82.6,10,40,50,17,10,5,5,20
993,CHA,1,48,39,84,46.4,7,32,21.9,32,52,61.54,26,31,83.9,6,46,52,24,16,8,5,19
994,DET,1,48,48,95,50.5,11,27,40.7,37,68,54.41,23,26,88.5,15,33,48,27,11,12,5,22
995,BOS,0,53,41,100,41,16,46,34.8,25,54,46.3,19,23,82.6,15,39,54,22,13,4,4,19
996,BKN,0,48,43,94,45.7,13,38,34.2,30,56,53.57,23,27,85.2,15,25,40,24,16,5,6,23
997,SAS,0,48,37,82,45.1,8,24,33.3,29,58,50,18,28,64.3,11,31,42,24,14,2,1,18
998,CHI,0,48,37,91,40.7,4,25,16,33,66,50,18,22,81.8,7,36,43,16,13,8,2,20
999,DAL,1,48,33,77,42.9,13,34,38.2,20,43,46.51,20,28,71.4,7,36,43,20,9,3,3,10
1000,CLE,1,48,40,87,46,15,36,41.7,25,51,49.02,18,22,81.8,11,25,36,29,10,12,4,16
1001,LAC,1,48,52,89,58.4,18,38,47.4,34,51,66.67,16,21,76.2,6,31,37,26,5,9,9,21
1002,PHX,0,48,35,86,40.7,13,32,40.6,22,54,40.74,12,16,75,13,37,50,24,9,4,6,21
1003,OKC,0,48,53,102,52,15,34,44.1,38,68,55.88,11,16,68.8,12,25,37,31,12,12,2,23
1004,MEM,0,48,42,88,47.7,10,31,32.3,32,57,56.14,26,37,70.3,11,25,36,26,14,10,3,26
1005,WAS,1,48,39,98,39.8,12,38,31.6,27,60,45,18,23,78.3,15,33,48,27,8,13,7,16
1006,GSW,1,48,43,85,50.6,14,32,43.8,29,53,54.72,22,28,78.6,14,30,44,33,22,7,5,27
1007,PHI,1,48,42,82,51.2,18,38,47.4,24,44,54.55,35,36,97.2,11,25,36,26,11,10,4,19
1008,MIL,1,48,37,78,47.4,13,30,43.3,24,48,50,20,28,71.4,7,42,49,16,23,11,7,15
1009,SAC,0,48,35,73,47.9,13,32,40.6,22,41,53.66,12,13,92.3,4,30,34,29,19,6,2,12
1010,ORL,1,48,46,82,56.1,15,28,53.6,31,54,57.41,19,25,76,9,25,34,34,18,8,7,22
1011,NOP,0,48,37,85,43.5,12,38,31.6,25,47,53.19,16,21,76.2,8,34,42,25,15,4,7,21
1012,SAS,0,48,40,106,37.7,8,34,23.5,32,72,44.44,16,18,88.9,17,31,48,22,14,11,2,19
1013,DEN,0,48,38,97,39.2,11,34,32.4,27,63,42.86,12,16,75,15,36,51,21,19,9,5,21
1014,LAL,1,48,40,90,44.4,10,33,30.3,30,57,52.63,23,30,76.7,11,45,56,25,20,12,9,13
1015,MIN,1,48,40,82,48.8,11,29,37.9,29,53,54.72,20,28,71.4,4,32,36,23,9,8,5,18
1016,POR,1,48,51,89,57.3,17,36,47.2,34,53,64.15,15,18,83.3,6,35,41,26,10,9,4,15
1017,BKN,0,48,49,76,64.5,14,26,53.8,35,50,70,21,27,77.8,6,25,31,29,16,3,4,26
1018,TOR,1,48,48,97,49.5,12,40,30,36,57,63.16,5,7,71.4,11,30,41,28,10,12,8,17
1019,UTA,0,48,47,90,52.2,20,41,48.8,27,49,55.1,10,15,66.7,8,27,35,32,13,5,5,18
1020,HOU,0,48,42,97,43.3,5,28,17.9,37,69,53.62,14,20,70,17,40,57,29,14,5,10,15
1021,IND,0,48,41,85,48.2,15,35,42.9,26,50,52,23,29,79.3,10,22,32,25,17,14,5,20
1022,ATL,1,48,50,84,59.5,11,29,37.9,39,55,70.91,26,33,78.8,11,35,46,26,17,5,6,16
1023,MIA,1,48,34,94,36.2,12,33,36.4,22,61,36.07,18,23,78.3,14,37,51,21,8,7,2,18
1024,PHX,1,48,47,94,50,22,39,56.4,25,55,45.45,12,13,92.3,15,40,55,38,18,3,10,21
1025,CLE,0,48,40,87,46,12,33,36.4,28,54,51.85,11,16,68.8,10,31,41,29,12,8,4,19
1026,DEN,1,48,39,80,48.8,11,33,33.3,28,47,59.57,10,13,76.9,7,27,34,27,12,8,5,20
1027,WAS,1,48,42,83,50.6,11,30,36.7,31,53,58.49,32,41,78,6,35,41,28,11,7,3,22
1028,DAL,0,48,47,89,52.8,10,30,33.3,37,59,62.71,22,26,84.6,8,30,38,24,9,6,2,25
1029,IND,1,48,42,99,42.4,10,37,27,32,62,51.61,22,28,78.6,14,31,45,24,8,9,10,21
1030,LAL,0,48,42,95,44.2,16,40,40,26,55,47.27,15,24,62.5,9,23,32,21,7,8,4,13
1031,CHA,0,48,39,96,40.6,6,25,24,33,71,46.48,13,18,72.2,10,30,40,19,14,10,5,21
1032,LAC,1,48,51,84,60.7,19,38,50,32,46,69.57,12,15,80,7,40,47,25,15,4,9,20
1033,NYK,1,48,37,75,49.3,17,33,51.5,20,42,47.62,14,21,66.7,9,33,42,25,17,4,3,18
1034,CHI,0,48,43,88,48.9,5,24,20.8,38,64,59.38,19,25,76,11,34,45,19,16,5,5,23
1035,NOP,0,48,38,85,44.7,5,26,19.2,33,59,55.93,17,20,85,14,29,43,18,16,5,3,14
1036,BOS,0,48,32,74,43.2,10,32,31.3,22,42,52.38,21,27,77.8,5,39,44,21,17,5,6,22
1037,CHI,1,48,44,95,46.3,11,34,32.4,33,61,54.1,12,18,66.7,15,32,47,28,11,13,3,20
1038,HOU,1,48,44,88,50,11,30,36.7,33,58,56.9,20,30,66.7,12,35,47,24,23,11,5,15
1039,MIN,0,48,41,91,45.1,16,42,38.1,25,49,51.02,16,22,72.7,12,29,41,19,19,8,7,22
1040,BOS,0,48,36,83,43.4,18,46,39.1,18,37,48.65,8,11,72.7,8,29,37,24,18,5,4,23
1041,SAC,1,48,49,88,55.7,22,40,55,27,48,56.25,13,14,92.9,10,43,53,37,25,10,5,11
1042,POR,1,48,55,92,59.8,20,33,60.6,35,59,59.32,17,22,77.3,8,28,36,34,10,11,4,16
1043,MEM,0,48,40,98,40.8,12,36,33.3,28,62,45.16,8,10,80,10,21,31,28,15,14,3,21
1044,SAS,0,48,47,90,52.2,13,27,48.1,34,63,53.97,20,26,76.9,14,26,40,30,15,7,4,18
1045,DET,0,48,43,87,49.4,13,32,40.6,30,55,54.55,31,40,77.5,11,30,41,26,20,10,3,21
1046,MIL,1,48,55,98,56.1,23,52,44.2,32,46,69.57,17,24,70.8,13,37,50,38,19,11,6,27
1047,CHA,0,48,38,85,44.7,2,16,12.5,36,69,52.17,24,34,70.6,11,31,42,22,15,8,7,23
1048,UTA,1,48,41,86,47.7,16,40,40,25,46,54.35,22,26,84.6,9,37,46,25,16,8,4,26
1049,ATL,0,48,39,85,45.9,10,33,30.3,29,52,55.77,12,19,63.2,9,34,43,24,19,6,4,14
1050,ORL,1,48,43,84,51.2,11,27,40.7,32,57,56.14,16,24,66.7,8,32,40,22,11,10,3,12
1051,NYK,0,48,40,82,48.8,18,41,43.9,22,41,53.66,18,26,69.2,14,33,47,30,17,4,4,24
1052,PHX,1,48,39,88,44.3,13,35,37.1,26,53,49.06,21,25,84,6,34,40,25,17,10,5,26
1053,GSW,0,48,41,90,45.6,13,32,40.6,28,58,48.28,21,27,77.8,10,32,42,28,12,10,2,24
1054,TOR,1,48,41,90,45.6,15,34,44.1,26,56,46.43,28,35,80,17,28,45,21,8,12,4,20
1055,OKC,1,48,40,89,44.9,7,26,26.9,33,63,52.38,14,16,87.5,14,36,50,21,8,4,5,24
1056,MEM,0,48,40,92,43.5,11,32,34.4,29,60,48.33,19,27,70.4,15,37,52,28,20,8,4,22
1057,DAL,0,48,35,80,43.8,13,35,37.1,22,45,48.89,15,26,57.7,12,26,38,15,10,3,3,21
1058,BKN,1,48,43,79,54.4,14,27,51.9,29,52,55.77,20,31,64.5,9,33,42,30,16,4,7,22
1059,MIA,1,48,35,80,43.8,8,34,23.5,27,46,58.7,22,27,81.5,12,30,42,17,22,16,1,14
1060,DEN,0,48,36,82,43.9,10,28,35.7,26,54,48.15,17,33,51.5,10,32,42,22,9,7,5,16
1061,LAL,1,48,45,86,52.3,10,30,33.3,35,56,62.5,21,27,77.8,10,41,51,23,13,5,5,19
1062,LAC,1,48,35,77,45.5,12,28,42.9,23,49,46.94,30,31,96.8,9,37,46,20,11,6,3,23
1063,POR,0,48,37,86,43,17,46,37,20,40,50,21,25,84,11,27,38,24,12,5,7,24
1064,NOP,0,48,37,78,47.4,8,30,26.7,29,48,60.42,14,18,77.8,8,33,41,24,25,17,4,22
1065,PHI,1,48,49,93,52.7,12,28,42.9,37,65,56.92,19,23,82.6,16,30,46,27,15,4,3,26
1066,ATL,0,48,45,83,54.2,11,25,44,34,58,58.62,17,20,85,6,34,40,24,18,5,4,20
1067,CHA,1,48,45,89,50.6,13,34,38.2,32,55,58.18,19,22,86.4,6,30,36,28,12,11,2,18
1068,BOS,1,48,38,85,44.7,16,35,45.7,22,50,44,14,15,93.3,11,30,41,25,15,9,8,17
1069,MIL,0,48,39,86,45.3,14,39,35.9,25,47,53.19,10,11,90.9,7,29,36,24,16,3,6,17
1070,ORL,0,48,42,90,46.7,14,34,41.2,28,56,50,20,24,83.3,9,32,41,24,11,3,10,19
1071,WAS,1,48,51,95,53.7,18,34,52.9,33,61,54.1,18,25,72,9,37,46,34,8,6,5,18
1072,MIN,1,48,38,83,45.8,17,41,41.5,21,42,50,20,24,83.3,3,27,30,20,12,12,9,26
1073,TOR,0,48,46,86,53.5,7,19,36.8,39,67,58.21,5,7,71.4,6,35,41,24,14,7,9,13
1074,HOU,0,48,38,79,48.1,9,24,37.5,29,55,52.73,19,33,57.6,15,41,56,24,23,4,6,19
1075,IND,0,48,36,96,37.5,13,37,35.1,23,59,38.98,22,26,84.6,11,37,48,22,15,10,4,29
1076,PHX,1,48,38,91,41.8,12,31,38.7,26,60,43.33,24,35,68.6,14,41,55,27,15,9,8,20
1077,SAC,0,48,46,84,54.8,13,33,39.4,33,51,64.71,22,29,75.9,4,25,29,28,9,6,5,20
1078,CLE,1,48,48,86,55.8,7,22,31.8,41,64,64.06,11,17,64.7,9,32,41,33,9,9,3,13
1079,MEM,0,48,43,102,42.2,9,29,31,34,73,46.58,26,40,65,24,39,63,24,14,6,7,31
1080,LAC,1,48,51,81,63,15,28,53.6,36,53,67.92,14,20,70,11,21,32,31,9,4,2,13
1081,IND,0,48,37,84,44,8,32,25,29,52,55.77,29,37,78.4,16,23,39,23,21,7,2,18
1082,UTA,0,48,37,88,42,16,39,41,21,49,42.86,16,23,69.6,13,33,46,24,11,6,1,18
1083,CLE,0,48,42,84,50,14,33,42.4,28,51,54.9,16,19,84.2,10,25,35,24,15,7,8,15
1084,SAS,0,48,51,89,57.3,14,26,53.8,37,63,58.73,10,14,71.4,12,22,34,34,7,3,1,15
1085,GSW,1,48,42,86,48.8,23,43,53.5,19,43,44.19,13,19,68.4,14,31,45,25,18,9,4,19
1086,ORL,1,48,39,75,52,15,30,50,24,45,53.33,30,34,88.2,5,37,42,28,15,2,5,18
1087,NYK,0,48,49,83,59,13,30,43.3,36,53,67.92,13,17,76.5,9,25,34,27,12,5,3,15
1088,LAL,1,48,38,93,40.9,13,41,31.7,25,52,48.08,33,41,80.5,10,37,47,24,10,7,7,26
1089,ATL,1,48,56,100,56,13,34,38.2,43,66,65.15,14,16,87.5,14,25,39,27,7,6,4,16
1090,SAC,1,48,41,87,47.1,12,38,31.6,29,49,59.18,24,28,85.7,13,40,53,25,15,1,2,17
1091,DEN,1,48,51,83,61.4,14,28,50,37,55,67.27,18,26,69.2,12,26,38,38,18,16,4,28
1092,NOP,0,48,41,91,45.1,10,35,28.6,31,56,55.36,18,24,75,11,28,39,29,11,9,5,21
1093,BKN,1,48,43,80,53.8,18,41,43.9,25,39,64.1,13,20,65,6,36,42,26,11,7,6,18
1094,MIA,0,48,33,69,47.8,4,20,20,29,49,59.18,20,27,74.1,5,34,39,15,16,3,1,22
1095,OKC,0,48,45,93,48.4,16,40,40,29,53,54.72,7,11,63.6,8,28,36,21,9,4,1,20
1096,DAL,1,48,37,80,46.3,18,38,47.4,19,42,45.24,23,28,82.1,10,27,37,21,10,7,1,22
1097,MIN,1,48,45,89,50.6,17,40,42.5,28,49,57.14,21,23,91.3,8,29,37,31,15,12,5,20
1098,DET,0,48,39,97,40.2,8,34,23.5,31,63,49.21,22,27,81.5,17,32,49,25,17,7,3,15
1099,CHI,1,48,50,92,54.3,7,23,30.4,43,69,62.32,19,21,90.5,11,37,48,23,14,11,8,17
1100,BOS,1,53,43,108,39.8,13,41,31.7,30,67,44.78,22,30,73.3,18,45,63,21,17,10,5,19
1101,PHX,1,48,39,85,45.9,11,28,39.3,28,57,49.12,28,41,68.3,12,37,49,30,16,4,3,23
1102,GSW,0,53,40,100,40,18,52,34.6,22,48,45.83,20,23,87,8,39,47,28,16,10,7,26
1103,BKN,0,48,43,82,52.4,11,26,42.3,32,56,57.14,15,25,60,2,32,34,27,13,10,6,34
1104,TOR,0,48,46,87,52.9,14,28,50,32,59,54.24,20,27,74.1,8,30,38,26,16,8,6,19
1105,PHI,1,48,41,81,50.6,8,26,30.8,33,55,60,15,19,78.9,5,38,43,24,15,8,8,23
1106,POR,0,48,32,85,37.6,9,37,24.3,23,48,47.92,22,29,75.9,13,31,44,19,16,4,3,15
1107,CLE,0,48,42,82,51.2,16,35,45.7,26,47,55.32,14,21,66.7,11,36,47,29,19,4,7,17
1108,DAL,0,48,44,84,52.4,16,42,38.1,28,42,66.67,18,24,75,10,21,31,26,16,5,3,19
1109,HOU,0,48,46,91,50.5,10,32,31.3,36,59,61.02,15,20,75,12,35,47,21,20,4,5,22
1110,WAS,1,48,42,95,44.2,16,42,38.1,26,53,49.06,16,19,84.2,18,34,52,28,14,5,9,23
1111,MIA,1,48,50,94,53.2,12,35,34.3,38,59,64.41,12,16,75,10,33,43,37,11,11,2,17
1112,MIN,0,48,42,81,51.9,12,32,37.5,30,49,61.22,22,28,78.6,12,24,36,26,19,6,10,27
1113,CHA,1,48,48,96,50,9,36,25,39,60,65,17,25,68,11,26,37,27,10,14,10,20
1114,DEN,1,48,45,85,52.9,8,21,38.1,37,64,57.81,24,32,75,8,26,34,27,16,10,2,19
1115,LAC,0,48,37,92,40.2,15,34,44.1,22,58,37.93,14,21,66.7,16,34,50,23,13,1,6,20
1116,IND,0,48,39,94,41.5,12,33,36.4,27,61,44.26,16,24,66.7,20,28,48,23,24,9,10,19
1117,NOP,0,48,37,80,46.3,13,30,43.3,24,50,48,11,18,61.1,9,29,38,27,18,5,3,17
1118,OKC,1,48,47,93,50.5,16,38,42.1,31,55,56.36,16,21,76.2,13,29,42,41,19,12,7,25
1119,UTA,1,48,45,87,51.7,19,32,59.4,26,55,47.27,17,22,77.3,9,35,44,26,8,4,7,19
1120,SAC,1,48,43,87,49.4,9,30,30,34,57,59.65,21,27,77.8,14,33,47,23,11,3,5,14
1121,ATL,1,48,49,86,57,13,26,50,36,60,60,19,20,95,7,28,35,28,12,7,4,23
1122,MEM,1,48,44,97,45.4,11,34,32.4,33,63,52.38,16,22,72.7,15,27,42,22,8,10,7,19
1123,LAL,0,48,43,89,48.3,11,34,32.4,32,55,58.18,14,18,77.8,6,30,36,26,7,9,3,20
1124,NYK,0,48,40,96,41.7,7,26,26.9,33,70,47.14,18,27,66.7,20,29,49,14,9,9,4,20
1125,DEN,1,48,44,88,50,11,32,34.4,33,56,58.93,23,28,82.1,11,31,42,32,12,8,6,15
1126,PHI,1,48,39,73,53.4,13,31,41.9,26,42,61.9,29,34,85.3,8,25,33,25,15,12,4,17
1127,SAS,1,48,37,97,38.1,7,34,20.6,30,63,47.62,25,28,89.3,13,41,54,23,16,12,4,22
1128,TOR,0,48,46,101,45.5,13,35,37.1,33,66,50,17,27,63,20,30,50,20,9,7,5,14
1129,MIL,1,48,46,86,53.5,19,39,48.7,27,47,57.45,19,21,90.5,6,36,42,24,12,5,5,19
1130,POR,0,48,38,83,45.8,13,40,32.5,25,43,58.14,24,25,96,5,30,35,21,13,3,4,24
1131,LAC,0,48,41,82,50,12,34,35.3,29,48,60.42,16,20,80,8,25,33,20,19,4,5,23
1132,BKN,0,48,37,88,42,3,23,13,34,65,52.31,21,24,87.5,10,39,49,22,21,10,8,26
1133,LAL,1,48,49,91,53.8,12,33,36.4,37,58,63.79,30,35,85.7,9,30,39,23,2,4,5,19
1134,GSW,1,48,45,91,49.5,18,44,40.9,27,47,57.45,19,21,90.5,9,34,43,28,12,8,1,23
1135,MIN,0,48,46,101,45.5,18,41,43.9,28,60,46.67,15,18,83.3,16,25,41,28,6,9,6,20
1136,ATL,1,48,45,76,59.2,13,27,48.1,32,49,65.31,18,22,81.8,2,26,28,27,16,9,5,17
1137,MEM,1,48,52,98,53.1,16,37,43.2,36,61,59.02,16,20,80,13,38,51,29,11,8,6,19
1138,TOR,1,53,38,96,39.6,13,44,29.5,25,52,48.08,34,41,82.9,14,28,42,27,6,8,12,25
1139,UTA,1,48,45,84,53.6,13,34,38.2,32,50,64,23,28,82.1,14,36,50,25,18,0,5,12
1140,NYK,0,53,42,99,42.4,9,31,29,33,68,48.53,28,35,80,20,34,54,17,12,3,5,28
1141,NOP,0,48,38,75,50.7,10,27,37,28,48,58.33,17,22,77.3,3,25,28,26,17,9,1,23
1142,PHX,0,48,39,89,43.8,10,33,30.3,29,56,51.79,18,19,94.7,9,28,37,33,15,4,4,22
1143,BOS,1,48,43,87,49.4,20,43,46.5,23,44,52.27,24,25,96,14,33,47,34,12,1,4,21
1144,CHA,0,48,41,90,45.6,13,31,41.9,28,59,47.46,23,30,76.7,13,25,38,26,5,7,2,18
1145,MIL,1,48,48,91,52.7,23,46,50,25,45,55.56,13,15,86.7,9,32,41,32,14,9,1,14
1146,HOU,0,48,49,100,49,11,30,36.7,38,70,54.29,23,31,74.2,17,31,48,28,8,0,7,25
1147,CLE,1,48,39,80,48.8,9,28,32.1,30,52,57.69,26,33,78.8,13,30,43,22,15,5,4,19
1148,WAS,0,48,42,86,48.8,14,35,40,28,51,54.9,20,23,87,6,30,36,31,14,7,2,21
1149,IND,0,48,43,84,51.2,19,40,47.5,24,44,54.55,14,15,93.3,4,33,37,29,16,6,5,17
1150,MIA,0,48,43,89,48.3,8,31,25.8,35,58,60.34,19,20,95,12,29,41,30,16,10,4,22
1151,CHI,1,48,48,95,50.5,15,39,38.5,33,56,58.93,21,24,87.5,7,31,38,29,10,12,1,18
1152,DET,0,48,37,83,44.6,18,44,40.9,19,39,48.72,12,15,80,9,29,38,23,12,4,4,22
1153,LAL,0,48,48,87,55.2,6,20,30,42,67,62.69,10,13,76.9,4,34,38,28,11,4,6,19
1154,BKN,0,48,39,91,42.9,12,41,29.3,27,50,54,12,19,63.2,14,37,51,24,16,4,7,21
1155,SAC,1,48,49,89,55.1,14,30,46.7,35,59,59.32,20,25,80,7,31,38,24,6,5,2,19
1156,ORL,0,48,41,84,48.8,7,29,24.1,34,55,61.82,27,34,79.4,10,29,39,24,13,7,2,17
1157,DEN,1,48,48,89,53.9,13,39,33.3,35,50,70,10,19,52.6,12,29,41,32,16,10,5,22
1158,DAL,0,48,41,89,46.1,14,42,33.3,27,47,57.45,27,33,81.8,13,26,39,31,9,3,2,29
1159,PHI,1,48,43,85,50.6,12,34,35.3,31,51,60.78,15,19,78.9,5,33,38,29,10,3,7,16
1160,OKC,1,48,40,90,44.4,12,31,38.7,28,59,47.46,20,26,76.9,11,39,50,21,9,5,7,14
1161,POR,1,48,43,85,50.6,17,44,38.6,26,41,63.41,37,42,88.1,8,33,41,28,8,3,6,29
1162,SAS,0,48,48,93,51.6,10,26,38.5,38,67,56.72,13,20,65,11,29,40,27,10,1,3,21
1163,GSW,0,48,41,83,49.4,21,51,41.2,20,32,62.5,15,22,68.2,7,33,40,35,23,6,4,22
1164,NYK,1,48,40,88,45.5,12,30,40,28,58,48.28,25,31,80.6,18,34,52,17,8,3,6,12
1165,LAC,1,48,46,88,52.3,14,32,43.8,32,56,57.14,15,21,71.4,11,33,44,21,17,13,6,16
1166,HOU,0,48,38,84,45.2,7,31,22.6,31,53,58.49,17,23,73.9,10,29,39,22,20,8,6,17
1167,ATL,1,48,43,84,51.2,11,27,40.7,32,57,56.14,17,18,94.4,5,35,40,19,12,6,4,22
1168,CHA,0,48,41,88,46.6,8,27,29.6,33,61,54.1,16,19,84.2,10,36,46,21,11,3,2,11
1169,MIL,0,48,34,84,40.5,19,48,39.6,15,36,41.67,8,12,66.7,7,25,32,26,10,7,2,13
1170,IND,0,48,38,103,36.9,11,47,23.4,27,56,48.21,25,28,89.3,16,33,49,26,20,5,8,20
1171,PHI,1,48,40,89,44.9,17,39,43.6,23,50,46,21,26,80.8,9,28,37,23,8,5,5,17
1172,UTA,0,48,43,90,47.8,12,40,30,31,50,62,19,23,82.6,10,38,48,20,12,5,6,24
1173,TOR,0,48,36,87,41.4,7,29,24.1,29,58,50,24,30,80,11,32,43,19,14,9,3,19
1174,POR,1,48,49,88,55.7,17,41,41.5,32,47,68.09,21,22,95.5,10,37,47,34,12,7,4,20
1175,MIA,1,48,45,87,51.7,11,22,50,34,65,52.31,10,12,83.3,13,38,51,17,11,9,3,14
1176,CLE,0,48,37,76,48.7,8,28,28.6,29,48,60.42,20,23,87,8,32,40,24,18,5,2,17
1177,MEM,1,48,48,87,55.2,12,32,37.5,36,55,65.45,22,28,78.6,7,38,45,32,16,11,8,21
1178,BOS,1,48,47,99,47.5,19,53,35.8,28,46,60.87,9,10,90,14,32,46,35,7,8,4,15
1179,MIN,1,48,45,80,56.3,9,28,32.1,36,52,69.23,11,15,73.3,4,27,31,22,15,10,5,21
1180,DAL,0,48,43,82,52.4,22,46,47.8,21,36,58.33,11,19,57.9,2,23,25,28,11,4,3,18
1181,WAS,0,48,36,93,38.7,13,42,31,23,51,45.1,23,26,88.5,12,38,50,18,8,3,4,23
1182,DEN,1,48,41,82,50,14,33,42.4,27,49,55.1,19,25,76,10,33,43,24,11,7,4,11
1183,SAC,1,48,47,86,54.7,20,40,50,27,46,58.7,25,29,86.2,14,32,46,34,14,10,8,19
1184,NOP,1,48,42,86,48.8,11,31,35.5,31,55,56.36,21,30,70,8,40,48,29,17,7,3,21
1185,OKC,1,48,47,92,51.1,11,33,33.3,36,59,61.02,19,22,86.4,12,34,46,22,11,12,6,19
1186,NYK,1,48,41,92,44.6,8,29,27.6,33,63,52.38,22,31,71,14,40,54,15,7,3,6,23
1187,GSW,1,48,55,101,54.5,18,48,37.5,37,53,69.81,16,20,80,12,43,55,33,13,9,6,26
1188,DET,0,48,43,90,47.8,7,30,23.3,36,60,60,17,24,70.8,7,35,42,20,13,7,3,23
1189,PHX,0,48,41,86,47.7,14,23,60.9,27,63,42.86,20,24,83.3,9,34,43,28,19,10,3,20
1190,HOU,0,48,43,91,47.3,12,37,32.4,31,54,57.41,16,25,64,12,22,34,23,15,10,4,24
1191,CHI,0,48,38,85,44.7,12,38,31.6,26,47,55.32,22,24,91.7,10,32,42,30,16,7,5,17
1192,ORL,0,48,42,96,43.8,14,36,38.9,28,60,46.67,10,16,62.5,11,29,40,23,15,13,3,25
1193,SAS,0,48,40,88,45.5,8,22,36.4,32,66,48.48,25,34,73.5,7,31,38,26,15,6,3,19
1194,IND,0,48,40,101,39.6,7,30,23.3,33,71,46.48,24,29,82.8,19,32,51,24,12,8,9,22
1195,LAC,0,48,41,87,47.1,10,29,34.5,31,58,53.45,11,14,78.6,11,32,43,20,12,6,3,18
1196,UTA,1,48,36,83,43.4,11,35,31.4,25,48,52.08,29,40,72.5,17,42,59,15,24,9,11,18
1197,ATL,1,48,41,94,43.6,16,33,48.5,25,61,40.98,15,21,71.4,14,36,50,26,14,6,9,22
1198,MIN,1,48,47,90,52.2,10,28,35.7,37,62,59.68,17,20,85,4,33,37,24,15,13,3,22
1199,DAL,1,58,48,96,50,14,42,33.3,34,54,62.96,9,17,52.9,3,51,54,25,19,4,9,26
1200,LAL,0,58,44,112,39.3,10,41,24.4,34,71,47.89,17,27,63,14,42,56,24,10,7,4,18
1201,CLE,1,48,44,89,49.4,7,22,31.8,37,67,55.22,24,31,77.4,12,32,44,28,11,6,1,19
1202,CHA,0,48,41,77,53.2,13,33,39.4,28,44,63.64,19,27,70.4,9,33,42,27,22,6,5,30
1203,BOS,1,48,41,86,47.7,12,36,33.3,29,50,58,15,17,88.2,12,36,48,23,14,4,6,15
1204,MIA,1,48,42,95,44.2,9,34,26.5,33,61,54.1,15,16,93.8,18,43,61,22,13,8,1,8
1205,BKN,0,48,38,84,45.2,13,34,38.2,25,50,50,9,11,81.8,4,27,31,26,12,8,9,19
1206,TOR,1,48,43,83,51.8,10,28,35.7,33,55,60,28,36,77.8,8,24,32,30,9,15,4,23
1207,PHI,0,48,39,88,44.3,11,36,30.6,28,52,53.85,25,27,92.6,9,30,39,30,17,4,3,29
1208,MIL,0,48,35,87,40.2,22,57,38.6,13,30,43.33,10,15,66.7,8,31,39,20,11,10,2,12
1209,OKC,1,48,44,86,51.2,14,33,42.4,30,53,56.6,31,33,93.9,5,34,39,28,11,7,6,22
1210,POR,0,48,40,78,51.3,11,33,33.3,29,45,64.44,22,29,75.9,5,31,36,17,17,6,4,27
1211,NYK,1,48,38,84,45.2,15,42,35.7,23,42,54.76,28,33,84.8,12,38,50,21,15,9,4,16
1212,ATL,0,48,39,87,44.8,11,30,36.7,28,57,49.12,16,18,88.9,6,35,41,25,11,5,3,12
1213,IND,0,48,43,90,47.8,12,39,30.8,31,51,60.78,15,21,71.4,8,33,41,27,13,8,5,25
1214,DEN,1,48,48,85,56.5,15,34,44.1,33,51,64.71,15,21,71.4,7,31,38,30,11,9,4,20
1215,CHI,0,48,41,88,46.6,9,29,31,32,59,54.24,6,9,66.7,8,31,39,16,12,7,6,19
1216,SAS,0,48,50,107,46.7,11,34,32.4,39,73,53.42,18,23,78.3,17,31,48,33,12,7,11,18
1217,DET,1,48,48,80,60,17,32,53.1,31,48,64.58,22,28,78.6,7,31,38,30,17,10,7,20
1218,MIL,1,48,45,98,45.9,18,48,37.5,27,50,54,6,11,54.5,14,43,57,28,11,6,4,15
1219,NOP,0,48,45,87,51.7,11,30,36.7,34,57,59.65,13,17,76.5,4,29,33,22,9,5,4,17
1220,HOU,0,48,44,96,45.8,16,41,39,28,55,50.91,11,17,64.7,8,40,48,30,14,7,3,23
1221,PHX,0,48,39,90,43.3,9,32,28.1,30,58,51.72,10,14,71.4,15,29,44,28,20,4,2,17
1222,BOS,1,48,44,91,48.4,15,44,34.1,29,47,61.7,22,25,88,11,39,50,24,9,7,5,16
1223,MIN,0,48,43,88,48.9,16,33,48.5,27,55,49.09,16,21,76.2,13,23,36,22,19,7,2,22
1224,MEM,1,48,52,101,51.5,14,22,63.6,38,79,48.1,17,25,68,17,40,57,19,14,6,8,17
1225,SAC,1,48,45,94,47.9,19,48,39.6,26,46,56.52,26,31,83.9,9,36,45,28,9,4,4,19
1226,WAS,1,48,38,82,46.3,7,23,30.4,31,59,52.54,17,21,81,12,40,52,21,18,5,3,18
1227,POR,0,48,42,87,48.3,6,35,17.1,36,52,69.23,16,19,84.2,13,30,43,22,17,10,7,22
1228,CLE,0,48,42,90,46.7,10,37,27,32,53,60.38,20,24,83.3,7,30,37,18,5,7,7,25
1229,CHA,0,48,47,86,54.7,15,35,42.9,32,51,62.75,11,15,73.3,6,28,34,33,10,6,4,19
1230,DET,0,48,36,89,40.4,14,39,35.9,22,50,44,30,36,83.3,3,23,26,23,11,9,5,22
1231,OKC,0,48,44,91,48.4,9,35,25.7,35,56,62.5,14,21,66.7,14,30,44,27,19,8,3,27
1232,DAL,0,48,30,69,43.5,12,38,31.6,18,31,58.06,29,36,80.6,3,29,32,15,12,5,6,17
1233,GSW,0,48,37,96,38.5,18,48,37.5,19,48,39.58,21,27,77.8,16,29,45,24,17,13,2,26
1234,PHI,1,48,54,89,60.7,11,31,35.5,43,58,74.14,28,30,93.3,10,45,55,36,19,7,8,29
1235,UTA,1,48,38,87,43.7,10,36,27.8,28,51,54.9,30,37,81.1,15,39,54,21,16,3,3,17
1236,LAC,1,48,39,86,45.3,12,31,38.7,27,55,49.09,23,30,76.7,12,34,46,20,10,7,4,23
1237,ORL,1,48,40,78,51.3,9,24,37.5,31,54,57.41,20,25,80,6,29,35,19,16,10,2,20
1238,PHX,1,48,41,90,45.6,14,31,45.2,27,59,45.76,29,31,93.5,19,38,57,26,22,5,7,22
1239,TOR,1,48,45,91,49.5,20,44,45.5,25,47,53.19,22,27,81.5,18,31,49,32,11,4,4,17
1240,MIA,1,48,31,79,39.2,10,33,30.3,21,46,45.65,40,40,100,13,28,41,18,20,10,4,19
1241,MIL,1,48,39,89,43.8,19,49,38.8,20,40,50,14,18,77.8,12,36,48,27,14,3,5,17
1242,ORL,0,48,41,90,45.6,14,44,31.8,27,46,58.7,15,20,75,9,32,41,24,13,7,7,18
1243,WAS,0,48,42,82,51.2,14,34,41.2,28,48,58.33,14,18,77.8,7,30,37,26,20,5,1,25
1244,CHI,0,48,39,86,45.3,12,35,34.3,27,51,52.94,9,14,64.3,6,36,42,19,8,6,1,18
1245,BOS,1,48,38,87,43.7,11,41,26.8,27,46,58.7,20,21,95.2,9,41,50,25,9,2,7,12
1246,SAS,0,48,44,97,45.4,11,32,34.4,33,65,50.77,14,16,87.5,12,30,42,28,14,8,1,24
1247,SAC,1,48,52,97,53.6,23,46,50,29,51,56.86,9,12,75,11,37,48,39,11,4,1,16
1248,MEM,1,48,45,91,49.5,11,26,42.3,34,65,52.31,20,35,57.1,11,39,50,26,14,9,7,15
1249,NOP,1,48,49,93,52.7,10,26,38.5,39,67,58.21,24,31,77.4,12,32,44,24,10,9,5,21
1250,NYK,0,48,38,100,38,11,41,26.8,27,59,45.76,20,22,90.9,18,30,48,16,7,8,1,14
1251,DEN,1,48,46,99,46.5,15,42,35.7,31,57,54.39,15,17,88.2,14,41,55,29,17,7,11,19
1252,LAL,0,48,41,93,44.1,8,28,28.6,33,65,50.77,19,25,76,11,33,44,20,14,12,2,14
1253,PHX,0,48,37,84,44,14,26,53.8,23,58,39.66,10,11,90.9,6,30,36,22,16,7,2,14
1254,MIN,1,48,38,80,47.5,10,28,35.7,28,52,53.85,18,22,81.8,9,35,44,23,19,8,4,18
1255,DAL,0,48,31,73,42.5,14,39,35.9,17,34,50,33,42,78.6,8,31,39,21,13,3,1,19
1256,BKN,1,48,39,76,51.3,12,33,36.4,27,43,62.79,12,15,80,6,34,40,22,19,8,8,21
1257,DET,0,48,44,87,50.6,8,23,34.8,36,64,56.25,15,18,83.3,10,33,43,25,23,9,2,20
1258,PHI,1,48,46,94,48.9,11,37,29.7,35,57,61.4,20,23,87,14,30,44,24,14,12,5,17
1259,HOU,0,48,38,89,42.7,11,36,30.6,27,53,50.94,9,15,60,12,29,41,26,20,8,7,19
1260,TOR,1,48,40,91,44,12,31,38.7,28,60,46.67,25,29,86.2,13,28,41,26,10,12,8,28
1261,POR,0,48,34,76,44.7,9,30,30,25,46,54.35,28,37,75.7,10,32,42,19,24,5,4,24
1262,OKC,1,48,46,95,48.4,12,28,42.9,34,67,50.75,16,20,80,13,35,48,27,8,5,8,26
1263,LAC,0,48,37,95,38.9,10,30,33.3,27,65,41.54,24,31,77.4,21,38,59,25,11,6,5,19
1264,CLE,1,48,45,78,57.7,11,29,37.9,34,49,69.39,11,17,64.7,3,36,39,29,14,8,5,12
1265,IND,1,48,38,87,43.7,13,38,34.2,25,49,51.02,27,33,81.8,8,33,41,27,16,14,7,22
1266,MIA,0,48,38,92,41.3,13,35,37.1,25,57,43.86,12,17,70.6,16,25,41,22,12,8,4,17
1267,MEM,1,48,46,102,45.1,15,38,39.5,31,64,48.44,16,22,72.7,13,26,39,28,10,16,7,19
1268,ATL,1,48,44,89,49.4,8,26,30.8,36,63,57.14,16,20,80,7,36,43,22,9,7,9,18
1269,UTA,0,48,45,88,51.1,10,32,31.3,35,56,62.5,18,22,81.8,8,38,46,29,21,7,9,18
1270,CHA,0,48,38,88,43.2,11,33,33.3,27,55,49.09,24,27,88.9,13,36,49,25,18,8,4,26
1271,LAL,1,48,50,82,61,9,21,42.9,41,61,67.21,27,33,81.8,10,28,38,26,17,4,3,25
1272,DAL,1,48,42,74,56.8,13,29,44.8,29,45,64.44,30,38,78.9,5,34,39,23,17,5,7,24
1273,NOP,0,48,45,94,47.9,5,29,17.2,40,65,61.54,22,35,62.9,15,29,44,26,13,14,4,25
1274,CHI,1,48,44,83,53,13,28,46.4,31,55,56.36,25,32,78.1,7,37,44,22,10,4,4,22
1275,BOS,1,48,47,95,49.5,15,34,44.1,32,61,52.46,12,18,66.7,8,35,43,30,14,6,10,15
1276,SAC,0,48,45,86,52.3,14,32,43.8,31,54,57.41,30,37,81.1,13,21,34,25,14,5,4,26
1277,GSW,0,48,33,88,37.5,18,58,31,15,30,50,17,21,81,11,38,49,26,16,7,1,17
1278,ORL,1,48,44,87,50.6,13,32,40.6,31,55,56.36,14,24,58.3,7,37,44,26,11,12,2,14
1279,SAS,0,48,49,100,49,7,25,28,42,75,56,11,14,78.6,12,39,51,25,13,6,3,20
1280,UTA,0,48,46,93,49.5,12,41,29.3,34,52,65.38,14,18,77.8,7,32,39,36,10,6,2,24
1281,CHI,1,48,48,84,57.1,20,34,58.8,28,50,56,10,17,58.8,8,37,45,33,12,3,4,14
1282,MIA,1,48,33,78,42.3,12,38,31.6,21,40,52.5,26,31,83.9,5,32,37,19,13,10,3,14
1283,ATL,0,48,44,96,45.8,9,31,29,35,65,53.85,17,22,77.3,7,32,39,24,12,8,5,15
1284,POR,0,48,38,94,40.4,9,33,27.3,29,61,47.54,14,17,82.4,12,40,52,30,18,5,1,19
1285,IND,1,48,38,84,45.2,7,25,28,31,59,52.54,25,28,89.3,4,37,41,22,14,11,6,22
1286,WAS,0,48,38,79,48.1,7,24,29.2,31,55,56.36,27,36,75,11,35,46,21,20,6,2,18
1287,PHI,0,48,40,92,43.5,18,41,43.9,22,51,43.14,14,18,77.8,12,26,38,28,7,6,3,15
1288,NOP,0,48,35,88,39.8,12,29,41.4,23,59,38.98,20,25,80,14,37,51,16,16,7,4,20
1289,MIN,1,48,46,81,56.8,13,35,37.1,33,46,71.74,23,29,79.3,10,35,45,28,20,4,7,22
1290,LAC,0,48,44,100,44,9,25,36,35,75,46.67,18,27,66.7,18,22,40,22,10,13,3,19
1291,MIL,0,48,37,84,44,20,48,41.7,17,36,47.22,15,24,62.5,12,33,45,22,17,5,4,18
1292,CLE,0,48,40,88,45.5,10,26,38.5,30,62,48.39,18,32,56.3,18,22,40,30,7,7,5,18
1293,SAS,1,48,45,81,55.6,9,24,37.5,36,57,63.16,22,26,84.6,7,37,44,27,18,8,4,16
1294,CHA,1,48,53,102,52,20,48,41.7,33,54,61.11,12,19,63.2,13,36,49,32,5,11,3,17
1295,NYK,1,48,39,83,47,16,37,43.2,23,46,50,18,26,69.2,13,38,51,19,13,3,4,23
1296,DET,0,48,44,93,47.3,11,31,35.5,33,62,53.23,10,17,58.8,15,22,37,23,16,11,0,22
1297,DEN,1,48,43,81,53.1,17,35,48.6,26,46,56.52,18,23,78.3,13,36,49,28,14,5,4,23
1298,PHX,0,48,34,82,41.5,6,23,26.1,28,59,47.46,22,25,88,8,36,44,22,14,5,2,20
1299,LAL,1,48,51,93,54.8,16,35,45.7,35,58,60.34,12,16,75,7,44,51,33,18,6,5,18
1300,TOR,0,48,35,83,42.2,10,29,34.5,25,54,46.3,28,35,80,12,34,46,22,7,7,3,23
1301,OKC,1,48,50,98,51,17,37,45.9,33,61,54.1,10,14,71.4,11,30,41,30,10,9,6,26
1302,BKN,1,48,37,85,43.5,15,33,45.5,22,52,42.31,19,20,95,10,33,43,26,13,8,12,23
1303,BOS,1,48,41,84,48.8,16,43,37.2,25,41,60.98,26,31,83.9,10,42,52,29,11,6,8,22
1304,ORL,0,48,39,84,46.4,11,36,30.6,28,48,58.33,26,30,86.7,7,32,39,23,11,6,3,22
1305,HOU,0,48,38,92,41.3,15,42,35.7,23,50,46,23,26,88.5,14,35,49,19,15,4,3,21
1306,MEM,1,48,48,92,52.2,12,36,33.3,36,56,64.29,15,23,65.2,9,40,49,24,13,5,3,22
1307,LAC,0,48,34,91,37.4,5,37,13.5,29,54,53.7,18,25,72,8,33,41,24,8,7,3,14
1308,UTA,1,48,46,93,49.5,19,48,39.6,27,45,60,20,21,95.2,9,33,42,33,8,10,5,20
1309,DEN,1,48,45,89,50.6,14,36,38.9,31,53,58.49,18,21,85.7,10,47,57,28,12,6,5,16
1310,DAL,0,48,34,90,37.8,7,32,21.9,27,58,46.55,20,25,80,11,31,42,15,11,4,3,19
1311,NOP,1,48,41,89,46.1,14,38,36.8,27,51,52.94,23,26,88.5,15,36,51,25,15,6,6,19
1312,NYK,1,48,45,94,47.9,10,31,32.3,35,63,55.56,17,26,65.4,14,33,47,16,14,7,6,21
1313,POR,0,48,33,75,44,9,29,31,24,46,52.17,31,42,73.8,12,27,39,18,18,8,7,30
1314,CHI,1,48,43,81,53.1,8,20,40,35,61,57.38,27,29,93.1,6,40,46,21,17,7,7,16
1315,ATL,1,48,45,84,53.6,10,30,33.3,35,54,64.81,20,22,90.9,7,37,44,21,16,9,4,21
1316,ORL,1,48,42,81,51.9,13,33,39.4,29,48,60.42,29,36,80.6,13,36,49,26,17,6,5,22
1317,CHA,0,48,38,94,40.4,11,38,28.9,27,56,48.21,20,24,83.3,10,34,44,25,12,11,8,23
1318,PHI,1,53,48,98,49,14,36,38.9,34,62,54.84,19,22,86.4,14,32,46,24,11,4,7,19
1319,MIN,1,48,39,76,51.3,9,24,37.5,30,52,57.69,26,36,72.2,8,25,33,25,15,8,6,30
1320,IND,0,53,45,95,47.4,13,36,36.1,32,59,54.24,23,26,88.5,13,32,45,31,13,7,8,18
1321,HOU,0,48,39,88,44.3,12,38,31.6,27,50,54,18,27,66.7,12,31,43,25,13,10,4,22
1322,GSW,0,48,45,87,51.7,15,40,37.5,30,47,63.83,14,15,93.3,9,31,40,31,14,3,4,20
1323,SAC,0,48,41,88,46.6,10,25,40,31,63,49.21,25,27,92.6,10,32,42,26,11,9,3,19
1324,MIA,0,48,43,95,45.3,8,29,27.6,35,66,53.03,15,21,71.4,14,29,43,24,13,9,4,20
1325,CLE,1,48,30,77,39,11,36,30.6,19,41,46.34,19,23,82.6,7,39,46,15,15,9,4,17
1326,MIL,1,53,35,88,39.8,13,39,33.3,22,49,44.9,21,30,70,13,60,73,26,28,4,4,24
1327,BKN,0,48,42,91,46.2,12,37,32.4,30,54,55.56,16,21,76.2,5,29,34,24,11,9,7,22
1328,PHX,0,48,32,81,39.5,10,28,35.7,22,53,41.51,14,18,77.8,8,41,49,24,15,8,3,19
1329,TOR,0,53,38,116,32.8,9,46,19.6,29,70,41.43,16,20,80,14,33,47,22,9,10,4,23
1330,DET,1,48,45,92,48.9,16,36,44.4,29,56,51.79,16,23,69.6,11,30,41,29,10,9,1,11
1331,MEM,1,48,47,94,50,9,30,30,38,64,59.38,28,37,75.7,11,48,59,28,14,10,8,16
1332,LAL,1,48,40,81,49.4,8,27,29.6,32,54,59.26,24,30,80,9,33,42,20,17,10,4,18
1333,OKC,0,48,36,89,40.4,15,37,40.5,21,52,40.38,28,31,90.3,9,24,33,23,9,9,3,23
1334,SAS,0,48,41,82,50,11,28,39.3,30,54,55.56,21,26,80.8,9,29,38,25,17,5,3,24
1335,MIL,1,48,48,100,48,11,40,27.5,37,60,61.67,16,17,94.1,15,34,49,27,12,8,6,14
1336,WAS,0,48,42,97,43.3,8,27,29.6,34,70,48.57,21,23,91.3,14,32,46,27,10,9,4,16
1337,UTA,0,48,38,88,43.2,13,44,29.5,25,44,56.82,26,29,89.7,12,32,44,21,16,9,3,19
1338,OKC,1,48,58,98,59.2,20,40,50,38,58,65.52,14,22,63.6,9,35,44,31,13,14,3,23
1339,SAC,1,48,46,86,53.5,9,32,28.1,37,54,68.52,16,18,88.9,7,33,40,23,18,7,4,26
1340,BOS,0,48,40,88,45.5,12,40,30,28,48,58.33,25,31,80.6,11,27,38,29,17,4,7,15
1341,MIA,1,48,39,85,45.9,12,36,33.3,27,49,55.1,20,24,83.3,12,36,48,22,11,7,2,23
1342,CLE,1,53,48,92,52.2,16,46,34.8,32,46,69.57,33,45,73.3,13,34,47,27,10,1,3,27
1343,LAC,0,48,29,67,43.3,12,29,41.4,17,38,44.74,30,34,88.2,3,31,34,19,15,7,1,18
1344,LAL,1,48,45,93,48.4,10,30,33.3,35,63,55.56,21,30,70,9,44,53,26,15,6,5,21
1345,CHI,0,53,47,95,49.5,10,33,30.3,37,62,59.68,30,34,88.2,6,36,42,22,7,8,2,33
1346,CHA,0,48,42,93,45.2,11,32,34.4,31,61,50.82,20,29,69,8,39,47,24,14,8,7,22
1347,SAS,0,48,42,97,43.3,8,31,25.8,34,66,51.52,11,18,61.1,15,28,43,26,18,5,4,13
1348,POR,1,48,48,84,57.1,14,31,45.2,34,53,64.15,25,35,71.4,6,38,44,29,18,16,6,27
1349,GSW,1,58,54,121,44.6,19,59,32.2,35,62,56.45,16,24,66.7,23,46,69,34,19,9,6,23
1350,NYK,1,48,36,74,48.6,13,33,39.4,23,41,56.1,17,25,68,5,40,45,26,8,1,2,13
1351,DAL,1,48,34,81,42,13,43,30.2,21,38,55.26,30,34,88.2,8,33,41,19,8,8,6,19
1352,TOR,0,48,41,91,45.1,14,42,33.3,27,49,55.1,18,23,78.3,12,24,36,26,11,5,11,27
1353,BKN,1,48,58,93,62.4,11,20,55,47,73,64.38,12,15,80,7,38,45,31,13,13,7,16
1354,ATL,0,58,53,109,48.6,11,35,31.4,42,74,56.76,24,29,82.8,10,43,53,30,13,9,10,17
1355,PHX,0,48,34,87,39.1,10,37,27,24,50,48,5,7,71.4,5,31,36,22,8,4,0,17
1356,MIN,1,48,45,87,51.7,13,36,36.1,32,51,62.75,21,27,77.8,11,30,41,29,12,7,4,22
1357,DET,0,48,34,82,41.5,6,18,33.3,28,64,43.75,32,41,78,9,36,45,16,21,8,4,27
1358,NOP,0,48,42,84,50,11,29,37.9,31,55,56.36,16,20,80,10,39,49,26,17,3,6,22
1359,PHI,1,48,41,86,47.7,15,35,42.9,26,51,50.98,23,28,82.1,7,28,35,26,10,9,6,22
1360,IND,1,48,45,93,48.4,10,27,37,35,66,53.03,22,26,84.6,15,35,50,24,13,4,2,19
1361,HOU,0,48,38,82,46.3,9,29,31,29,53,54.72,21,29,72.4,8,38,46,21,10,4,4,28
1362,DEN,0,48,42,91,46.2,11,29,37.9,31,62,50,16,20,80,18,27,45,27,15,8,1,21
1363,BOS,0,48,40,87,46,9,33,27.3,31,54,57.41,22,27,81.5,10,31,41,30,13,8,3,15
1364,DEN,1,48,45,79,57,17,30,56.7,28,49,57.14,16,18,88.9,1,34,35,31,17,5,4,17
1365,SAC,0,48,39,96,40.6,15,43,34.9,24,53,45.28,15,15,100,14,33,47,24,16,7,4,18
1366,MEM,1,48,46,100,46,10,32,31.3,36,68,52.94,16,24,66.7,21,36,57,25,12,11,8,18
1367,MIL,0,48,34,96,35.4,13,49,26.5,21,47,44.68,14,15,93.3,14,30,44,22,16,11,3,15
1368,WAS,1,48,50,94,53.2,7,27,25.9,43,67,64.18,11,16,68.8,12,42,54,29,18,9,6,10
1369,UTA,0,48,35,81,43.2,17,40,42.5,18,41,43.9,36,44,81.8,16,33,49,23,16,6,3,23
1370,MIA,1,48,45,89,50.6,13,39,33.3,32,50,64,23,30,76.7,10,27,37,32,12,10,1,32
1371,HOU,0,48,29,77,37.7,14,46,30.4,15,31,48.39,16,23,69.6,12,40,52,20,25,4,6,24
1372,MEM,1,48,47,92,51.1,5,29,17.2,42,63,66.67,17,22,77.3,13,39,52,26,19,14,11,27
1373,CLE,1,48,39,85,45.9,13,38,34.2,26,47,55.32,12,19,63.2,15,35,50,20,21,9,5,18
1374,DAL,1,48,50,86,58.1,14,34,41.2,36,52,69.23,12,21,57.1,6,20,26,21,5,5,3,24
1375,BKN,1,48,48,80,60,13,34,38.2,35,46,76.09,14,19,73.7,2,40,42,26,14,7,6,16
1376,NOP,0,48,32,91,35.2,8,30,26.7,24,61,39.34,29,36,80.6,15,31,46,16,20,6,4,21
1377,OKC,0,48,35,92,38,12,36,33.3,23,56,41.07,14,22,63.6,15,35,50,16,16,7,6,21
1378,IND,1,48,46,88,52.3,14,38,36.8,32,50,64,25,29,86.2,8,28,36,28,12,10,4,20
1379,LAC,0,48,43,80,53.8,16,34,47.1,27,46,58.7,28,29,96.6,8,31,39,23,16,7,6,23
1380,CHA,0,48,38,96,39.6,11,41,26.8,27,55,49.09,19,21,90.5,14,31,45,28,12,7,2,17
1381,PHI,1,48,46,99,46.5,11,34,32.4,35,65,53.85,12,17,70.6,14,42,56,29,13,7,9,24
1382,DET,1,48,43,89,48.3,10,27,37,33,62,53.23,20,28,71.4,15,37,52,21,14,6,6,22
1383,CHI,0,48,39,81,48.1,7,21,33.3,32,60,53.33,17,24,70.8,9,31,40,14,15,15,6,15
1384,MIN,0,48,36,83,43.4,10,34,29.4,26,49,53.06,22,26,84.6,9,30,39,17,15,6,5,22
1385,NYK,1,48,35,90,38.9,15,51,29.4,20,39,51.28,23,32,71.9,16,30,46,20,10,10,5,20
1386,SAS,0,48,47,85,55.3,8,19,42.1,39,66,59.09,23,32,71.9,15,33,48,28,13,1,0,21
1387,LAL,1,48,52,96,54.2,10,32,31.3,42,64,65.62,16,18,88.9,12,43,55,34,16,7,6,17
1388,WAS,1,48,42,75,56,15,35,42.9,27,40,67.5,20,25,80,4,49,53,33,26,4,10,18
1389,TOR,1,48,40,81,49.4,11,33,33.3,29,48,60.42,22,26,84.6,8,23,31,20,12,15,3,22
1390,DET,0,48,41,86,47.7,17,39,43.6,24,47,51.06,19,24,79.2,13,22,35,28,16,8,1,16
1391,POR,0,48,42,91,46.2,12,39,30.8,30,52,57.69,16,23,69.6,17,32,49,22,16,2,4,20
1392,MIL,1,48,43,93,46.2,14,39,35.9,29,54,53.7,23,33,69.7,20,48,68,25,21,5,8,25
1393,UTA,0,48,46,84,54.8,8,32,25,38,52,73.08,25,30,83.3,7,30,37,30,13,7,2,20
1394,MIN,0,48,40,92,43.5,8,30,26.7,32,62,51.61,26,34,76.5,7,29,36,18,8,10,5,28
1395,ATL,0,48,48,101,47.5,11,38,28.9,37,63,58.73,14,20,70,12,29,41,22,10,6,5,19
1396,CHI,1,48,53,92,57.6,12,27,44.4,41,65,63.08,14,15,93.3,12,26,38,21,14,10,4,20
1397,SAC,1,48,50,90,55.6,12,30,40,38,60,63.33,14,19,73.7,10,28,38,32,15,5,3,21
1398,PHX,0,48,35,71,49.3,14,30,46.7,21,41,51.22,20,23,87,9,33,42,26,27,7,1,17
1399,ORL,0,48,42,100,42,5,27,18.5,37,73,50.68,11,16,68.8,8,27,35,24,11,8,2,18
1400,NOP,1,48,43,80,53.8,15,31,48.4,28,49,57.14,26,36,72.2,7,29,36,19,14,14,3,20
1401,DEN,1,48,45,76,59.2,17,28,60.7,28,48,58.33,17,22,77.3,5,31,36,34,20,6,1,19
1402,PHI,0,48,42,75,56,14,34,41.2,28,41,68.29,18,22,81.8,3,26,29,28,19,5,7,22
1403,MIA,0,48,39,87,44.8,14,35,40,25,52,48.08,27,30,90,11,25,36,21,15,13,4,19
1404,GSW,1,48,42,91,46.2,17,43,39.5,25,48,52.08,17,21,81,17,29,46,29,13,9,2,22
1405,BOS,1,48,44,91,48.4,11,39,28.2,33,52,63.46,17,22,77.3,11,38,49,22,12,3,7,17
1406,NYK,0,48,38,90,42.2,15,41,36.6,23,49,46.94,24,31,77.4,13,25,38,20,13,7,2,21
1407,SAS,1,48,45,88,51.1,11,28,39.3,34,60,56.67,21,29,72.4,14,34,48,25,13,5,7,23
1408,OKC,0,48,42,99,42.4,11,36,30.6,31,63,49.21,18,21,85.7,11,30,41,15,12,9,1,27
1409,LAC,0,48,43,89,48.3,15,39,38.5,28,50,56,9,14,64.3,8,33,41,26,13,4,4,20
1410,TOR,0,48,39,96,40.6,10,28,35.7,29,68,42.65,18,24,75,17,30,47,21,8,11,7,20
1411,DAL,1,48,47,91,51.6,18,45,40,29,46,63.04,17,25,68,6,38,44,30,9,7,8,26
1412,MEM,1,48,48,95,50.5,13,29,44.8,35,66,53.03,10,14,71.4,17,36,53,37,16,4,4,20
1413,CLE,0,48,50,96,52.1,12,28,42.9,38,68,55.88,14,20,70,17,27,44,29,11,7,4,17
1414,CHA,1,48,46,84,54.8,10,32,31.3,36,52,69.23,19,29,65.5,12,40,52,33,18,8,11,17
1415,HOU,0,48,38,86,44.2,12,34,35.3,26,52,50,26,37,70.3,12,36,48,21,13,5,0,23
1416,IND,1,48,48,85,56.5,19,31,61.3,29,54,53.7,20,21,95.2,4,28,32,28,9,6,8,18
1417,DEN,0,48,49,85,57.6,12,27,44.4,37,58,63.79,16,18,88.9,7,27,34,31,16,6,8,24
1418,MIL,0,53,41,110,37.3,9,44,20.5,32,66,48.48,22,32,68.8,22,39,61,18,14,7,6,21
1419,ATL,0,48,42,97,43.3,8,22,36.4,34,75,45.33,15,22,68.2,11,36,47,22,4,5,6,14
1420,LAL,0,48,37,77,48.1,13,36,36.1,24,41,58.54,11,15,73.3,8,36,44,25,26,2,4,16
1421,CHI,1,53,42,92,45.7,9,23,39.1,33,69,47.83,26,30,86.7,7,45,52,21,14,5,10,23
1422,DET,1,48,36,80,45,18,42,42.9,18,38,47.37,31,40,77.5,11,38,49,25,13,7,4,25
1423,ORL,0,48,35,85,41.2,5,22,22.7,30,63,47.62,26,34,76.5,15,32,47,24,13,5,5,26
1424,NOP,1,48,39,81,48.1,11,23,47.8,28,58,48.28,30,43,69.8,9,34,43,22,15,6,4,24
1425,PHX,0,48,39,87,44.8,13,31,41.9,26,56,46.43,11,16,68.8,11,19,30,25,11,7,4,21
1426,WAS,1,48,47,82,57.3,8,26,30.8,39,56,69.64,25,28,89.3,12,34,46,27,13,7,6,15
1427,MIA,1,48,44,92,47.8,11,35,31.4,33,57,57.89,13,16,81.3,10,27,37,20,6,14,4,15
1428,UTA,0,48,37,91,40.7,15,46,32.6,22,45,48.89,18,26,69.2,10,40,50,26,12,3,6,22
1429,BKN,1,48,42,83,50.6,10,26,38.5,32,57,56.14,14,17,82.4,5,42,47,22,12,0,13,18
1430,GSW,1,48,37,87,42.5,16,45,35.6,21,42,50,22,27,81.5,10,41,51,22,13,6,3,26
1431,SAC,1,48,47,89,52.8,14,31,45.2,33,58,56.9,19,25,76,11,23,34,32,12,10,6,17
1432,MIN,0,48,42,83,50.6,10,29,34.5,32,54,59.26,24,32,75,5,30,35,18,11,6,8,28
1433,CHA,0,48,38,92,41.3,10,38,26.3,28,54,51.85,19,25,76,9,38,47,22,14,6,7,20
1434,HOU,0,48,38,95,40,14,45,31.1,24,50,48,12,14,85.7,13,36,49,24,15,5,2,16
1435,GSW,1,48,41,95,43.2,8,37,21.6,33,58,56.9,20,24,83.3,9,40,49,31,14,3,2,22
1436,WAS,1,48,39,85,45.9,11,33,33.3,28,52,53.85,27,31,87.1,14,25,39,18,18,7,8,23
1437,BOS,1,48,43,91,47.3,20,56,35.7,23,35,65.71,20,23,87,9,40,49,32,11,8,5,14
1438,NYK,0,53,45,103,43.7,16,50,32,29,53,54.72,15,24,62.5,17,38,55,27,10,5,0,23
1439,PHI,0,48,39,84,46.4,6,31,19.4,33,53,62.26,27,31,87.1,10,29,39,21,16,8,10,24
1440,DAL,1,53,44,90,48.9,13,46,28.3,31,44,70.45,25,33,75.8,7,40,47,20,9,4,5,25
1441,TOR,0,48,43,84,51.2,6,23,26.1,37,61,60.66,21,26,80.8,10,29,39,24,12,6,4,16
1442,SAC,0,48,40,82,48.8,10,35,28.6,30,47,63.83,16,19,84.2,8,31,39,20,16,8,2,18
1443,LAL,1,48,49,90,54.4,17,43,39.5,32,47,68.09,14,17,82.4,9,37,46,32,14,4,2,16
1444,DEN,1,48,41,86,47.7,13,37,35.1,28,49,57.14,18,21,85.7,10,30,40,34,13,12,3,18
1445,ATL,0,48,40,89,44.9,12,30,40,28,59,47.46,22,29,75.9,9,33,42,26,9,4,3,19
1446,LAC,1,48,45,93,48.4,15,38,39.5,30,55,54.55,19,23,82.6,15,32,47,27,11,8,3,17
1447,ORL,0,48,42,84,50,10,28,35.7,32,56,57.14,16,25,64,8,29,37,25,11,8,5,17
1448,PHX,1,48,43,87,49.4,17,31,54.8,26,56,46.43,22,25,88,15,32,47,26,22,7,9,23
1449,OKC,1,48,46,86,53.5,13,24,54.2,33,62,53.23,25,31,80.6,13,32,45,25,14,10,10,18
1450,IND,1,48,47,92,51.1,13,35,37.1,34,57,59.65,22,27,81.5,7,42,49,28,13,3,2,16
1451,SAS,0,48,46,99,46.5,10,29,34.5,36,70,51.43,12,14,85.7,16,25,41,20,15,9,4,21
1452,MEM,0,48,36,91,39.6,8,30,26.7,28,61,45.9,28,34,82.4,15,25,40,18,15,9,6,23
1453,CLE,0,48,39,82,47.6,13,36,36.1,26,46,56.52,26,30,86.7,10,23,33,21,12,8,3,14
1454,LAC,1,53,49,91,53.8,19,44,43.2,30,47,63.83,25,29,86.2,10,38,48,25,19,13,3,24
1455,DET,0,53,44,100,44,16,34,47.1,28,66,42.42,27,34,79.4,16,29,45,32,18,10,4,23
1456,POR,1,48,43,86,50,14,38,36.8,29,48,60.42,24,28,85.7,10,40,50,28,15,8,9,20
1457,MIA,1,48,47,102,46.1,13,49,26.5,34,53,64.15,6,8,75,13,27,40,27,10,9,3,17
1458,SAS,1,48,48,87,55.2,6,18,33.3,42,69,60.87,24,34,70.6,6,35,41,27,14,11,8,25
1459,CHI,0,48,45,92,48.9,13,35,37.1,32,57,56.14,15,21,71.4,8,27,35,27,8,6,2,19
1460,MIN,0,48,43,79,54.4,15,34,44.1,28,45,62.22,9,14,64.3,8,36,44,31,22,4,3,14
1461,CHA,0,48,41,103,39.8,12,36,33.3,29,67,43.28,19,25,76,18,27,45,25,13,8,3,21
1462,HOU,1,48,50,90,55.6,17,44,38.6,33,46,71.74,16,22,72.7,8,37,45,28,13,7,5,15
1463,BKN,1,48,47,82,57.3,18,30,60,29,52,55.77,13,17,76.5,7,31,38,27,17,7,4,25
1464,UTA,0,48,39,97,40.2,13,43,30.2,26,54,48.15,31,37,83.8,16,29,45,20,12,10,3,22
1465,IND,0,48,35,83,42.2,9,35,25.7,26,48,54.17,14,20,70,6,30,36,23,13,9,5,18
1466,NOP,1,48,41,90,45.6,12,40,30,29,50,58,19,24,79.2,16,38,54,30,16,10,6,19
1467,GSW,1,48,43,91,47.3,18,44,40.9,25,47,53.19,19,26,73.1,9,42,51,31,12,6,5,18
1468,DAL,1,48,44,84,52.4,18,44,40.9,26,40,65,18,25,72,11,27,38,31,11,6,3,26
1469,MEM,0,48,39,94,41.5,9,39,23.1,30,55,54.55,22,30,73.3,9,35,44,19,13,5,6,23
1470,LAL,0,48,39,80,48.8,9,28,32.1,30,52,57.69,28,32,87.5,6,29,35,18,10,5,2,23
1471,BOS,1,48,50,85,58.8,19,39,48.7,31,46,67.39,20,25,80,5,30,35,29,12,9,1,18
1472,PHI,1,48,39,77,50.6,18,39,46.2,21,38,55.26,23,29,79.3,5,27,32,22,8,5,2,19
1473,NYK,0,48,43,90,47.8,12,32,37.5,31,58,53.45,14,17,82.4,12,34,46,30,8,4,6,19
1474,MIL,0,48,42,84,50,13,36,36.1,29,48,60.42,21,27,77.8,8,31,39,22,15,8,1,16
1475,DEN,1,53,45,94,47.9,13,36,36.1,32,58,55.17,25,34,73.5,12,36,48,29,13,8,4,23
1476,PHX,0,53,45,94,47.9,17,35,48.6,28,59,47.46,18,26,69.2,12,34,46,32,14,7,9,30
1477,MEM,1,48,45,91,49.5,7,23,30.4,38,68,55.88,28,38,73.7,19,34,53,30,12,11,5,22
1478,LAC,0,48,41,81,50.6,14,38,36.8,27,43,62.79,18,23,78.3,6,27,33,25,11,5,9,16
1479,CHI,1,48,45,93,48.4,14,31,45.2,31,62,50,14,18,77.8,11,30,41,24,4,6,4,22
1480,BKN,1,48,46,93,49.5,14,32,43.8,32,61,52.46,12,13,92.3,12,33,45,30,12,11,2,18
1481,WAS,1,48,49,88,55.7,10,32,31.3,39,56,69.64,17,24,70.8,5,35,40,30,10,9,4,23
1482,ATL,1,48,49,92,53.3,12,34,35.3,37,58,63.79,20,24,83.3,8,40,48,30,8,10,8,20
1483,SAC,0,48,37,84,44,10,32,31.3,27,52,51.92,27,35,77.1,13,34,47,19,13,5,2,20
1484,IND,1,48,40,83,48.2,21,47,44.7,19,36,52.78,10,14,71.4,9,34,43,26,16,5,6,23
1485,PHI,1,48,47,88,53.4,12,29,41.4,35,59,59.32,13,14,92.9,6,33,39,31,9,7,3,20
1486,DET,0,48,37,90,41.1,9,33,27.3,28,57,49.12,22,29,75.9,9,34,43,17,14,7,3,19
1487,PHX,0,48,38,87,43.7,9,35,25.7,29,52,55.77,15,26,57.7,11,24,35,23,15,6,5,26
1488,OKC,0,53,47,102,46.1,13,35,37.1,34,67,50.75,18,25,72,10,37,47,27,18,9,5,26
1489,SAS,0,48,44,97,45.4,12,38,31.6,32,59,54.24,13,18,72.2,13,25,38,28,13,10,6,18
1490,DEN,1,48,47,81,58,10,21,47.6,37,60,61.67,16,26,61.5,4,34,38,31,11,9,2,19
1491,CLE,0,48,39,76,51.3,11,33,33.3,28,43,65.12,18,30,60,6,29,35,27,15,9,4,17
1492,NYK,0,48,43,86,50,16,35,45.7,27,51,52.94,15,26,57.7,12,35,47,23,10,2,4,17
1493,MIN,0,48,44,91,48.4,10,32,31.3,34,59,57.63,11,15,73.3,11,34,45,25,17,3,8,18
1494,DAL,1,48,36,80,45,16,44,36.4,20,36,55.56,24,27,88.9,7,27,34,20,14,10,7,21
1495,HOU,0,48,37,81,45.7,8,26,30.8,29,55,52.73,24,28,85.7,12,33,45,26,15,9,3,21
1496,BOS,1,48,44,100,44,13,46,28.3,31,54,57.41,20,26,76.9,20,33,53,28,12,9,6,16
1497,TOR,1,48,42,84,50,19,37,51.4,23,47,48.94,15,18,83.3,11,34,45,25,19,10,2,20
1498,CHA,1,48,52,94,55.3,16,41,39,36,53,67.92,14,18,77.8,11,30,41,30,16,11,5,21
1499,LAL,0,48,48,92,52.2,19,44,43.2,29,48,60.42,15,22,68.2,12,30,42,27,17,5,1,19
1500,MIA,0,48,41,95,43.2,13,33,39.4,28,62,45.16,13,14,92.9,13,25,38,23,10,7,3,13
1501,MIL,0,48,37,84,44,9,37,24.3,28,47,59.57,17,22,77.3,13,32,45,17,18,7,1,13
1502,POR,0,48,39,87,44.8,9,35,25.7,30,52,57.69,20,26,76.9,13,30,43,24,14,5,3,21
1503,ORL,1,48,50,87,57.5,17,32,53.1,33,55,60,16,20,80,7,37,44,30,19,8,2,15
1504,NOP,1,53,41,94,43.6,13,37,35.1,28,57,49.12,33,40,82.5,13,42,55,30,21,10,4,21
1505,WAS,0,48,46,82,56.1,7,21,33.3,39,61,63.93,13,17,76.5,3,34,37,20,11,5,2,15
1506,UTA,1,48,42,86,48.8,16,35,45.7,26,51,50.98,20,21,95.2,8,32,40,16,11,5,3,16
1507,SAS,0,48,43,90,47.8,9,28,32.1,34,62,54.84,22,27,81.5,14,30,44,23,17,8,2,24
1508,NOP,1,48,44,91,48.4,13,34,38.2,31,57,54.39,25,27,92.6,16,30,46,25,17,10,6,24
1509,LAC,1,48,41,81,50.6,23,49,46.9,18,32,56.25,21,23,91.3,5,43,48,29,27,6,7,22
1510,ATL,0,48,39,91,42.9,14,37,37.8,25,54,46.3,16,16,100,9,38,47,22,15,6,7,15
1511,LAL,0,48,42,84,50,11,24,45.8,31,60,51.67,25,30,83.3,5,34,39,25,15,6,5,24
1512,DAL,1,48,34,75,45.3,13,39,33.3,21,36,58.33,23,27,85.2,7,32,39,17,13,6,3,12
1513,IND,1,48,46,98,46.9,18,39,46.2,28,59,47.46,7,9,77.8,12,35,47,27,14,10,3,22
1514,CLE,1,48,41,85,48.2,10,32,31.3,31,53,58.49,22,28,78.6,9,28,37,22,10,8,3,21
1515,TOR,1,48,42,94,44.7,9,34,26.5,33,60,55,20,22,90.9,16,22,38,17,5,7,4,16
1516,CHA,0,48,37,92,40.2,9,31,29,28,61,45.9,22,29,75.9,11,29,40,25,15,15,2,18
1517,PHI,1,48,41,93,44.1,11,37,29.7,30,56,53.57,20,22,90.9,13,36,49,27,12,8,7,23
1518,OKC,1,48,36,77,46.8,8,24,33.3,28,53,52.83,21,25,84,9,28,37,19,18,9,3,16
1519,MIL,0,48,39,83,47,13,30,43.3,26,53,49.06,15,22,68.2,13,33,46,20,21,7,5,23
1520,SAC,1,48,48,95,50.5,17,47,36.2,31,48,64.58,21,28,75,10,36,46,29,12,6,2,23
1521,NYK,0,48,42,76,55.3,11,26,42.3,31,50,62,11,18,61.1,9,29,38,25,17,2,3,19
1522,BKN,1,48,54,84,64.3,21,33,63.6,33,51,64.71,14,16,87.5,3,29,32,42,15,10,4,23
1523,MIN,0,48,42,85,49.4,8,30,26.7,34,55,61.82,7,10,70,8,31,39,23,13,7,4,24
1524,GSW,0,48,41,83,49.4,12,33,36.4,29,50,58,19,25,76,9,27,36,32,21,6,1,14
1525,BOS,0,48,39,101,38.6,13,41,31.7,26,60,43.33,21,25,84,25,37,62,26,17,11,5,9
1526,HOU,0,48,41,88,46.6,17,43,39.5,24,45,53.33,11,17,64.7,9,40,49,22,17,6,4,23
1527,POR,0,48,39,79,49.4,14,36,38.9,25,43,58.14,6,9,66.7,9,27,36,29,20,9,5,22
1528,CHI,1,48,43,86,50,7,24,29.2,36,62,58.06,17,22,77.3,8,39,47,20,11,9,4,15
1529,ORL,1,48,41,91,45.1,11,37,29.7,30,54,55.56,23,33,69.7,11,34,45,19,11,11,6,18
1530,DET,0,48,31,79,39.2,6,23,26.1,25,56,44.64,25,34,73.5,11,35,46,15,22,6,1,15
1531,CHI,1,48,40,73,54.8,13,31,41.9,27,42,64.29,20,24,83.3,5,34,39,24,17,7,0,16
1532,GSW,0,48,35,74,47.3,12,35,34.3,23,39,58.97,12,13,92.3,4,25,29,23,20,3,2,22
1533,UTA,1,48,47,93,50.5,20,46,43.5,27,47,57.45,12,19,63.2,12,31,43,27,12,7,5,22
1534,PHX,0,48,41,89,46.1,13,32,40.6,28,57,49.12,15,19,78.9,15,29,44,26,14,2,1,23
1535,MIA,0,48,38,81,46.9,15,44,34.1,23,37,62.16,12,17,70.6,9,26,35,26,13,9,0,16
1536,MEM,0,48,36,81,44.4,5,26,19.2,31,55,56.36,14,21,66.7,7,35,42,25,16,11,7,21
1537,DEN,1,48,40,89,44.9,10,27,37,30,62,48.39,15,25,60,13,35,48,28,17,9,5,19
1538,NYK,1,48,45,87,51.7,17,40,42.5,28,47,59.57,25,32,78.1,14,33,47,27,12,8,1,15
1539,WAS,1,48,38,80,47.5,11,27,40.7,27,53,50.94,26,37,70.3,9,32,41,22,10,9,4,14
1540,DET,0,48,41,81,50.6,9,25,36,32,56,57.14,20,27,74.1,9,34,43,22,14,6,1,19
1541,SAC,0,48,45,95,47.4,12,33,36.4,33,62,53.23,17,31,54.8,10,32,42,23,8,8,2,23
1542,LAL,0,48,39,87,44.8,12,28,42.9,27,59,45.76,14,17,82.4,10,28,38,13,15,5,5,16
1543,DAL,0,48,31,76,40.8,19,45,42.2,12,31,38.71,25,31,80.6,8,34,42,23,16,5,5,23
1544,NOP,0,48,42,99,42.4,18,45,40,24,54,44.44,17,24,70.8,17,27,44,30,15,9,0,20
1545,CHA,1,48,49,95,51.6,10,31,32.3,39,64,60.94,17,23,73.9,11,45,56,26,14,4,7,25
1546,CLE,1,48,43,70,61.4,15,26,57.7,28,44,63.64,21,26,80.8,4,41,45,24,23,5,4,20
1547,OKC,1,48,40,88,45.5,11,31,35.5,29,57,50.88,32,37,86.5,11,28,39,20,12,7,5,21
1548,MIL,1,48,45,81,55.6,13,40,32.5,32,41,78.05,25,31,80.6,8,36,44,26,18,8,6,21
1549,MIN,1,48,42,89,47.2,12,31,38.7,30,58,51.72,20,24,83.3,9,35,44,19,11,5,4,24
1550,PHX,1,48,46,93,49.5,20,39,51.3,26,54,48.15,18,24,75,15,36,51,21,9,10,5,16
1551,SAS,1,48,46,83,55.4,17,34,50,29,49,59.18,15,19,78.9,9,37,46,30,19,6,6,23
1552,PHI,1,53,32,80,40,15,42,35.7,17,38,44.74,25,27,92.6,4,37,41,22,16,8,1,21
1553,ORL,0,48,45,95,47.4,12,34,35.3,33,61,54.1,23,25,92,10,35,45,29,8,8,8,17
1554,HOU,0,48,40,94,42.6,5,24,20.8,35,70,50,20,31,64.5,16,25,41,23,11,13,3,16
1555,POR,0,48,44,88,50,16,37,43.2,28,51,54.9,17,21,81,14,31,45,26,16,5,2,28
1556,TOR,0,53,37,88,42,11,40,27.5,26,48,54.17,16,20,80,9,41,50,24,16,6,3,20
1557,UTA,0,48,36,93,38.7,10,34,29.4,26,59,44.07,17,23,73.9,15,20,35,19,14,9,2,22
1558,ATL,1,48,48,94,51.1,12,32,37.5,36,62,58.06,18,20,90,6,35,41,29,10,7,3,18
1559,BOS,0,48,31,89,34.8,12,47,25.5,19,42,45.24,18,21,85.7,11,43,54,22,17,7,7,17
1560,DEN,1,48,43,94,45.7,11,33,33.3,32,61,52.46,22,34,64.7,15,40,55,33,14,6,3,17
1561,GSW,1,48,43,81,53.1,18,39,46.2,25,42,59.52,22,26,84.6,12,29,41,31,17,6,2,21
1562,WAS,0,48,44,95,46.3,10,39,25.6,34,56,60.71,19,24,79.2,10,38,48,24,10,5,6,20
1563,DET,0,48,42,88,47.7,8,30,26.7,34,58,58.62,29,34,85.3,11,30,41,20,9,9,2,19
1564,CHI,0,48,46,88,52.3,16,38,42.1,30,50,60,18,24,75,6,24,30,31,11,6,1,16
1565,MIN,1,48,57,87,65.5,23,43,53.5,34,44,77.27,13,16,81.3,4,35,39,38,13,5,5,21
1566,CHA,0,48,41,96,42.7,12,38,31.6,29,58,50,21,23,91.3,12,36,48,26,11,7,7,26
1567,ORL,1,48,33,86,38.4,12,29,41.4,21,57,36.84,17,19,89.5,6,40,46,20,13,9,3,18
1568,TOR,0,48,40,95,42.1,13,33,39.4,27,62,43.55,17,22,77.3,18,25,43,21,14,6,2,22
1569,BKN,1,48,44,80,55,15,29,51.7,29,51,56.86,21,23,91.3,4,31,35,26,13,5,8,24
1570,LAL,1,48,46,92,50,11,27,40.7,35,65,53.85,16,22,72.7,6,37,43,29,9,4,5,18
1571,IND,0,48,39,90,43.3,13,38,34.2,26,52,50,15,23,65.2,12,32,44,20,15,5,3,28
1572,NYK,1,48,39,83,47,8,26,30.8,31,57,54.39,23,30,76.7,14,35,49,13,16,7,9,21
1573,POR,1,48,40,85,47.1,13,36,36.1,27,49,55.1,14,19,73.7,10,26,36,20,14,8,4,20
1574,MEM,0,48,34,90,37.8,12,45,26.7,22,45,48.89,29,37,78.4,10,43,53,15,10,5,5,20
1575,CLE,1,53,40,94,42.6,7,36,19.4,33,58,56.9,13,22,59.1,9,42,51,23,13,6,5,24
1576,OKC,1,48,38,92,41.3,19,45,42.2,19,47,40.43,20,31,64.5,9,45,54,29,11,7,0,25
1577,DAL,0,53,36,88,40.9,15,49,30.6,21,39,53.85,12,19,63.2,5,40,45,19,12,5,6,20
1578,NOP,0,48,45,77,58.4,14,30,46.7,31,47,65.96,10,13,76.9,4,32,36,27,17,2,5,27
1579,MIA,1,48,42,82,51.2,11,30,36.7,31,52,59.62,16,23,69.6,8,32,40,25,14,14,3,27
1580,SAS,0,48,33,77,42.9,10,27,37,23,50,46,25,33,75.8,7,31,38,29,17,8,3,19
1581,LAC,1,48,37,86,43,12,29,41.4,25,57,43.86,16,26,61.5,12,37,49,19,14,6,5,16
1582,HOU,0,48,36,90,40,3,29,10.3,33,61,54.1,20,29,69,18,33,51,19,17,7,6,18
1583,MIL,1,48,48,90,53.3,18,38,47.4,30,52,57.69,9,11,81.8,15,39,54,30,15,5,3,13
1584,WAS,0,48,36,84,42.9,9,25,36,27,59,45.76,12,13,92.3,7,35,42,20,16,10,2,21
1585,UTA,0,48,39,86,45.3,16,47,34,23,39,58.97,3,6,50,7,22,29,24,14,5,2,13
1586,PHX,1,48,39,83,47,15,41,36.6,24,42,57.14,25,35,71.4,10,25,35,23,8,6,3,13
1587,DEN,0,48,39,81,48.1,9,27,33.3,30,54,55.56,21,28,75,9,30,39,25,19,7,4,17
1588,LAL,1,48,48,91,52.7,12,33,36.4,36,58,62.07,18,24,75,11,34,45,29,15,11,4,21
1589,CLE,1,48,38,76,50,14,31,45.2,24,45,53.33,28,32,87.5,6,28,34,23,10,6,2,15
1590,TOR,0,48,41,84,48.8,9,24,37.5,32,60,53.33,25,29,86.2,7,25,32,17,9,5,1,19
1591,BOS,0,48,35,84,41.7,11,46,23.9,24,38,63.16,28,34,82.4,10,28,38,17,14,9,12,21
1592,SAC,1,48,43,82,52.4,12,31,38.7,31,51,60.78,24,29,82.8,4,29,33,30,14,8,1,25
1593,ORL,1,48,42,91,46.2,9,33,27.3,33,58,56.9,24,28,85.7,15,38,53,19,18,7,1,26
1594,ATL,1,48,41,75,54.7,15,29,51.7,26,46,56.52,28,34,82.4,4,37,41,25,14,3,5,22
1595,IND,0,48,42,80,52.5,11,36,30.6,31,44,70.45,17,19,89.5,5,28,33,34,10,6,4,22
1596,POR,0,48,39,89,43.8,13,37,35.1,26,52,50,19,25,76,10,32,42,21,12,4,2,22
1597,NYK,1,48,37,92,40.2,17,44,38.6,20,48,41.67,23,32,71.9,15,35,50,19,12,13,2,13
1598,BKN,1,48,46,76,60.5,9,26,34.6,37,50,74,18,23,78.3,4,33,37,22,15,5,6,25
1599,DET,0,48,39,85,45.9,10,29,34.5,29,56,51.79,25,31,80.6,14,32,46,22,17,7,1,26
1600,CHA,0,48,39,98,39.8,15,43,34.9,24,55,43.64,13,19,68.4,15,28,43,26,13,8,5,25
1601,OKC,0,48,41,88,46.6,11,37,29.7,30,51,58.82,17,21,81,9,36,45,29,22,7,4,21
1602,PHI,1,48,39,85,45.9,15,38,39.5,24,47,51.06,25,31,80.6,11,38,49,23,15,11,5,13
1603,DAL,1,48,45,81,55.6,18,43,41.9,27,38,71.05,22,26,84.6,3,37,40,25,13,4,5,19
1604,MIN,1,48,43,87,49.4,12,25,48,31,62,50,14,25,56,11,32,43,23,16,16,6,18
1605,CHI,0,48,36,77,46.8,12,30,40,24,47,51.06,7,8,87.5,2,37,39,26,20,3,2,25
1606,GSW,0,48,39,94,41.5,17,43,39.5,22,51,43.14,11,13,84.6,13,35,48,31,17,8,6,21
1607,HOU,0,48,44,94,46.8,9,33,27.3,35,61,57.38,11,17,64.7,18,33,51,22,15,10,4,19
1608,UTA,1,53,42,92,45.7,18,47,38.3,24,45,53.33,30,37,81.1,11,33,44,24,16,8,6,25
1609,MEM,1,48,56,102,54.9,12,32,37.5,44,70,62.86,18,23,78.3,14,42,56,30,8,5,7,19
1610,NOP,0,53,47,99,47.5,12,30,40,35,69,50.72,23,28,82.1,19,30,49,24,18,8,6,30
1611,LAC,0,48,34,90,37.8,12,33,36.4,22,57,38.6,15,21,71.4,21,31,52,21,18,4,3,18
1612,PHX,1,48,44,95,46.3,9,32,28.1,35,63,55.56,14,18,77.8,15,38,53,27,9,8,8,18
1613,MIA,1,48,39,88,44.3,16,47,34,23,41,56.1,17,23,73.9,14,26,40,21,14,10,6,19
1614,MIL,0,48,35,94,37.2,13,50,26,22,44,50,18,27,66.7,11,28,39,22,9,5,1,18
1615,POR,1,48,49,81,60.5,18,40,45,31,41,75.61,12,17,70.6,5,35,40,26,17,5,3,20
1616,ATL,0,48,44,88,50,12,35,34.3,32,53,60.38,24,27,88.9,11,28,39,30,13,2,6,21
1617,IND,1,48,44,87,50.6,16,39,41,28,48,58.33,21,25,84,5,29,34,30,18,10,8,25
1618,DET,1,53,48,93,51.6,18,40,45,30,53,56.6,27,36,75,12,40,52,25,16,0,8,29
1619,GSW,0,48,40,86,46.5,14,33,42.4,26,53,49.06,25,29,86.2,12,34,46,27,24,5,4,20
1620,CHA,0,53,47,114,41.2,17,51,33.3,30,63,47.62,23,29,79.3,17,35,52,21,5,7,6,29
1621,LAC,1,48,34,89,38.2,14,46,30.4,20,43,46.51,17,21,81,14,38,52,21,15,8,2,21
1622,SAS,0,48,45,97,46.4,11,29,37.9,34,68,50,11,19,57.9,14,26,40,23,11,9,3,16
1623,CHI,0,53,46,84,54.8,9,28,32.1,37,56,66.07,19,22,86.4,3,28,31,25,12,6,7,18
1624,MIA,1,48,37,86,43,24,56,42.9,13,30,43.33,12,15,80,7,32,39,25,14,9,1,21
1625,MIN,0,48,31,74,41.9,4,22,18.2,27,52,51.92,22,30,73.3,7,36,43,15,17,9,4,20
1626,DAL,0,48,29,74,39.2,13,38,34.2,16,36,44.44,19,26,73.1,6,27,33,17,13,2,3,15
1627,OKC,0,48,41,82,50,9,24,37.5,32,58,55.17,17,23,73.9,7,37,44,26,14,7,4,16
1628,ORL,1,48,47,93,50.5,16,36,44.4,31,57,54.39,25,30,83.3,14,32,46,28,14,10,6,22
1629,CLE,1,48,41,78,52.6,8,24,33.3,33,54,61.11,15,19,78.9,5,38,43,26,9,5,2,20
1630,TOR,0,48,47,94,50,6,21,28.6,41,73,56.16,23,27,85.2,11,28,39,25,7,8,7,18
1631,NYK,1,53,45,91,49.5,18,34,52.9,27,57,47.37,20,25,80,15,33,48,25,18,7,5,25
1632,SAC,1,48,45,93,48.4,17,46,37,28,47,59.57,17,20,85,13,37,50,29,15,3,3,16
1633,DEN,1,48,54,83,65.1,4,16,25,50,67,74.63,29,35,82.9,7,38,45,31,19,8,7,17
1634,WAS,0,48,48,91,52.7,19,39,48.7,29,52,55.77,13,23,56.5,4,20,24,40,14,10,5,28
1635,LAL,0,53,44,93,47.3,8,29,27.6,36,64,56.25,22,30,73.3,7,42,49,23,12,7,9,17
1636,GSW,0,48,38,95,40,20,50,40,18,45,40,15,19,78.9,12,25,37,25,18,7,2,22
1637,BOS,1,53,46,104,44.2,19,48,39.6,27,56,48.21,11,16,68.8,13,38,51,27,14,6,2,22
1638,HOU,1,48,34,81,42,12,35,34.3,22,46,47.83,31,34,91.2,17,50,67,16,23,6,9,21
1639,MIL,1,48,45,82,54.9,12,29,41.4,33,53,62.26,26,32,81.3,12,43,55,22,23,8,5,18
1640,SAC,0,48,38,92,41.3,10,42,23.8,28,50,56,17,20,85,13,35,48,21,17,5,4,22
1641,PHX,0,48,33,103,32,13,51,25.5,20,52,38.46,18,19,94.7,18,26,44,22,10,13,7,24
1642,NOP,0,48,37,93,39.8,4,27,14.8,33,66,50,22,33,66.7,15,28,43,25,17,12,3,17
1643,UTA,1,48,49,103,47.6,15,47,31.9,34,56,60.71,8,12,66.7,19,40,59,31,22,4,10,23
1644,PHI,1,48,43,84,51.2,16,35,45.7,27,49,55.1,21,27,77.8,4,38,42,34,12,10,4,21
1645,BOS,0,48,33,76,43.4,9,39,23.1,24,37,64.86,18,26,69.2,5,31,36,27,15,5,6,17
1646,CLE,0,48,45,92,48.9,5,23,21.7,40,69,57.97,16,17,94.1,15,29,44,21,15,7,7,13
1647,DAL,1,48,39,93,41.9,22,54,40.7,17,39,43.59,21,25,84,16,34,50,24,14,4,3,19
1648,MEM,1,48,50,83,60.2,13,32,40.6,37,51,72.55,15,18,83.3,5,44,49,36,23,8,12,17
1649,IND,0,48,28,79,35.4,11,39,28.2,17,40,42.5,15,20,75,8,37,45,16,18,7,11,18
1650,SAS,1,48,46,97,47.4,9,27,33.3,37,70,52.86,11,16,68.8,19,27,46,25,13,6,2,19
1651,ATL,0,48,37,104,35.6,12,37,32.4,25,67,37.31,17,22,77.3,20,19,39,20,16,13,1,17
1652,MIN,0,48,46,93,49.5,10,27,37,36,66,54.55,10,19,52.6,7,30,37,25,10,12,2,19
1653,MIA,1,48,32,83,38.6,9,34,26.5,23,49,46.94,14,18,77.8,9,39,48,23,14,7,2,17
1654,BKN,1,48,44,89,49.4,8,27,29.6,36,62,58.06,16,18,88.9,7,34,41,25,13,8,7,20
1655,OKC,0,48,42,88,47.7,10,31,32.3,32,57,56.14,20,21,95.2,10,32,42,21,13,4,1,22
1656,POR,1,48,48,89,53.9,21,46,45.7,27,43,62.79,16,21,76.2,11,43,54,32,19,4,4,21
1657,WAS,0,48,37,79,46.8,11,31,35.5,26,48,54.17,15,22,68.2,6,38,44,21,20,6,2,16
1658,LAC,1,48,44,90,48.9,10,25,40,34,65,52.31,15,21,71.4,11,35,46,18,10,10,2,26
1659,SAC,0,48,33,83,39.8,10,39,25.6,23,44,52.27,23,35,65.7,11,30,41,20,17,7,0,21
1660,LAL,1,48,46,84,54.8,11,26,42.3,35,58,60.34,21,27,77.8,6,36,42,31,11,8,4,14
1661,NYK,1,48,40,89,44.9,8,35,22.9,32,54,59.26,24,27,88.9,15,40,55,19,17,8,4,22
1662,ORL,1,48,36,77,46.8,14,31,45.2,22,46,47.83,25,31,80.6,11,31,42,25,18,3,7,28
1663,TOR,0,48,30,75,40,6,25,24,24,50,48,33,38,86.8,7,21,28,18,9,9,7,25
1664,CHA,0,48,38,93,40.9,11,30,36.7,27,63,42.86,26,30,86.7,15,30,45,21,16,12,3,24
1665,DET,0,48,43,93,46.2,17,45,37.8,26,48,54.17,14,17,82.4,10,30,40,28,12,9,3,19
1666,MIL,0,48,33,90,36.7,12,43,27.9,21,47,44.68,14,18,77.8,13,39,52,18,16,5,6,12
1667,HOU,1,48,40,91,44,6,27,22.2,34,64,53.12,11,12,91.7,10,39,49,23,12,11,8,17
1668,CHI,0,53,48,100,48,7,27,25.9,41,73,56.16,19,23,82.6,13,40,53,28,19,11,6,21
1669,PHX,0,53,49,105,46.7,13,38,34.2,36,67,53.73,13,17,76.5,19,23,42,34,15,7,5,24
1670,ATL,1,53,47,98,48,13,39,33.3,34,59,57.63,16,21,76.2,8,37,45,28,15,3,6,22
1671,NOP,1,53,50,86,58.1,8,25,32,42,61,68.85,21,28,75,7,36,43,31,17,10,3,26
1672,PHI,1,48,46,83,55.4,13,27,48.1,33,56,58.93,26,32,81.3,9,32,41,31,16,6,6,24
1673,MIN,0,48,45,83,54.2,10,23,43.5,35,60,58.33,18,24,75,4,24,28,22,13,11,4,21
1674,MIA,0,48,39,81,48.1,13,34,38.2,26,47,55.32,20,28,71.4,5,27,32,26,10,5,3,22
1675,CHI,1,48,54,85,63.5,19,34,55.9,35,51,68.63,17,24,70.8,4,40,44,33,10,8,5,17
1676,DAL,0,48,41,90,45.6,11,44,25,30,46,65.22,22,26,84.6,8,29,37,24,8,5,4,17
1677,BKN,1,48,52,100,52,9,28,32.1,43,72,59.72,23,32,71.9,29,30,59,19,18,7,3,24
1678,OKC,0,48,38,83,45.8,10,29,34.5,28,54,51.85,16,20,80,7,33,40,25,11,8,6,26
1679,BOS,0,48,38,87,43.7,12,40,30,26,47,55.32,19,26,73.1,6,33,39,17,10,8,6,14
1680,IND,0,48,47,85,55.3,21,44,47.7,26,41,63.41,18,24,75,7,23,30,30,19,10,3,27
1681,LAC,1,48,40,94,42.6,19,48,39.6,21,46,45.65,15,16,93.8,9,33,42,22,10,9,7,16
1682,POR,1,48,43,83,51.8,13,34,38.2,30,49,61.22,25,28,89.3,11,34,45,20,16,5,4,24
1683,GSW,1,48,47,92,51.1,13,39,33.3,34,53,64.15,16,20,80,11,42,53,26,15,3,6,20
1684,SAS,1,48,42,78,53.8,7,21,33.3,35,57,61.4,24,31,77.4,9,37,46,24,18,8,4,21
1685,CLE,1,48,40,85,47.1,12,32,37.5,28,53,52.83,18,26,69.2,12,36,48,25,13,6,4,14
1686,WAS,0,48,37,85,43.5,16,34,47.1,21,51,41.18,17,19,89.5,8,42,50,24,15,8,3,15
1687,UTA,0,48,39,85,45.9,15,41,36.6,24,44,54.55,17,21,81,10,32,42,20,14,5,6,20
1688,DEN,1,48,47,86,54.7,8,26,30.8,39,60,65,13,16,81.3,6,33,39,28,9,5,8,17
1689,MEM,1,48,44,91,48.4,9,32,28.1,35,59,59.32,17,32,53.1,12,36,48,30,14,11,8,19
1690,NOP,1,48,46,90,51.1,8,27,29.6,38,63,60.32,28,35,80,13,31,44,27,11,10,1,15
1691,UTA,0,48,39,90,43.3,13,44,29.5,26,46,56.52,17,24,70.8,12,28,40,22,11,9,0,20
1692,PHI,1,53,48,90,53.3,18,40,45,30,50,60,19,22,86.4,7,35,42,30,23,14,2,30
1693,TOR,0,48,36,85,42.4,10,35,28.6,26,50,52,27,33,81.8,7,26,33,23,7,10,5,17
1694,PHX,0,48,43,86,50,22,44,50,21,42,50,9,13,69.2,8,29,37,30,17,6,3,25
1695,MIN,1,48,42,79,53.2,14,35,40,28,44,63.64,20,26,76.9,6,38,44,30,17,7,3,21
1696,BKN,1,48,45,83,54.2,13,30,43.3,32,53,60.38,17,21,81,9,29,38,30,21,10,5,18
1697,WAS,0,48,41,77,53.2,10,29,34.5,31,48,64.58,19,25,76,12,26,38,25,14,6,3,19
1698,DAL,0,48,41,88,46.6,13,40,32.5,28,48,58.33,10,24,41.7,12,31,43,21,11,8,6,21
1699,ATL,0,48,46,93,49.5,10,29,34.5,36,64,56.25,14,16,87.5,12,26,38,21,18,12,4,18
1700,SAC,1,48,35,66,53,16,33,48.5,19,33,57.58,20,32,62.5,5,33,38,21,19,11,5,22
1701,CLE,0,48,34,79,43,10,30,33.3,24,49,48.98,17,22,77.3,8,28,36,20,20,7,4,23
1702,NYK,1,48,41,93,44.1,13,34,38.2,28,59,47.46,26,30,86.7,16,32,48,25,14,6,7,21
1703,IND,1,48,43,85,50.6,18,41,43.9,25,44,56.82,17,20,85,13,27,40,23,12,7,2,21
1704,LAL,0,53,44,88,50,11,31,35.5,33,57,57.89,23,30,76.7,7,30,37,29,21,12,4,23
1705,CHA,0,48,37,84,44,6,26,23.1,31,58,53.45,22,28,78.6,12,33,45,16,13,8,6,26
1706,DET,0,48,36,90,40,11,35,31.4,25,55,45.45,20,27,74.1,13,34,47,23,19,6,7,29
1707,MIL,1,48,38,87,43.7,11,32,34.4,27,55,49.09,19,23,82.6,13,38,51,27,17,5,4,21
1708,ORL,1,48,42,71,59.2,10,26,38.5,32,45,71.11,19,21,90.5,3,40,43,24,20,3,4,27
1709,HOU,0,48,44,98,44.9,10,29,34.5,34,69,49.28,11,15,73.3,16,26,42,23,14,3,4,19
1710,MIA,1,48,46,90,51.1,12,32,37.5,34,58,58.62,11,14,78.6,7,36,43,24,8,11,1,20
1711,DEN,1,48,47,91,51.6,12,30,40,35,61,57.38,15,22,68.2,16,32,48,28,16,6,5,16
1712,LAC,0,48,37,80,46.3,17,36,47.2,20,44,45.45,19,21,90.5,7,36,43,24,16,3,3,16
1713,POR,0,48,44,91,48.4,16,40,40,28,51,54.9,16,16,100,13,25,38,30,13,10,3,20
1714,SAS,1,48,46,83,55.4,13,36,36.1,33,47,70.21,13,15,86.7,7,31,38,25,17,5,7,19
1715,GSW,0,48,45,98,45.9,14,42,33.3,31,56,55.36,19,25,76,14,28,42,26,14,8,5,18
1716,WAS,0,48,41,84,48.8,9,31,29,32,53,60.38,20,29,69,6,32,38,22,18,12,6,16
1717,MEM,1,48,48,94,51.1,14,38,36.8,34,56,60.71,13,16,81.3,10,40,50,32,17,13,9,19
1718,ATL,0,48,32,85,37.6,6,36,16.7,26,49,53.06,19,24,79.2,11,28,39,16,11,4,6,17
1719,BOS,1,48,49,101,48.5,16,45,35.6,33,56,58.93,11,13,84.6,11,42,53,29,13,14,3,20
1720,LAC,0,53,39,95,41.1,15,41,36.6,24,54,44.44,18,26,69.2,17,36,53,26,17,3,9,19
1721,NOP,1,48,39,85,45.9,8,27,29.6,31,58,53.45,18,23,78.3,10,40,50,21,19,8,9,21
1722,SAC,0,48,43,91,47.3,12,38,31.6,31,53,58.49,15,16,93.8,8,32,40,19,8,2,4,17
1723,LAL,0,48,37,87,42.5,7,33,21.2,30,54,55.56,32,35,91.4,10,36,46,16,15,6,3,17
1724,ORL,1,53,40,95,42.1,8,28,28.6,32,67,47.76,28,31,90.3,16,37,53,20,13,8,5,21
1725,PHX,0,48,37,93,39.8,8,32,25,29,61,47.54,16,19,84.2,13,36,49,19,18,5,4,17
1726,OKC,0,48,34,92,37,14,38,36.8,20,54,37.04,20,23,87,14,34,48,25,19,9,3,16
1727,NYK,1,48,37,83,44.6,17,36,47.2,20,47,42.55,22,24,91.7,13,42,55,26,14,6,2,23
1728,UTA,1,48,46,86,53.5,15,35,42.9,31,51,60.78,17,21,81,9,31,40,26,17,6,7,17
1729,DET,0,48,35,90,38.9,15,42,35.7,20,48,41.67,13,16,81.3,8,34,42,17,13,5,1,23
1730,IND,0,48,39,81,48.1,19,42,45.2,20,39,51.28,18,24,75,4,27,31,22,19,10,4,17
1731,MIL,1,48,46,96,47.9,14,33,42.4,32,63,50.79,20,24,83.3,17,33,50,34,7,3,2,15
1732,MIN,1,48,44,93,47.3,8,23,34.8,36,70,51.43,25,27,92.6,16,35,51,25,23,15,2,21
1733,CHA,0,48,47,88,53.4,10,24,41.7,37,64,57.81,12,23,52.2,10,30,40,25,11,4,3,18
1734,TOR,1,48,47,106,44.3,12,43,27.9,35,63,55.56,20,24,83.3,17,37,54,25,11,10,5,22
1735,BKN,1,48,49,86,57,12,31,38.7,37,55,67.27,12,16,75,5,34,39,33,11,3,8,20
1736,CHI,1,48,45,90,50,10,23,43.5,35,67,52.24,15,17,88.2,6,35,41,29,19,11,4,20
1737,DAL,1,48,36,72,50,17,36,47.2,19,36,52.78,27,31,87.1,4,31,35,27,17,10,4,32
1738,CLE,1,48,48,93,51.6,7,27,25.9,41,66,62.12,13,17,76.5,9,35,44,25,8,11,3,20
1739,MIA,0,48,33,77,42.9,10,32,31.3,23,45,51.11,20,26,76.9,7,33,40,21,15,7,2,20
1740,DET,1,48,43,87,49.4,19,41,46.3,24,46,52.17,11,15,73.3,9,31,40,27,13,8,1,19
1741,DEN,0,48,40,78,51.3,13,32,40.6,27,46,58.7,22,28,78.6,8,28,36,30,17,8,4,28
1742,LAL,0,48,38,89,42.7,6,36,16.7,32,53,60.38,20,24,83.3,14,29,43,16,16,4,6,13
1743,GSW,0,48,38,94,40.4,13,44,29.5,25,50,50,15,19,78.9,12,35,47,26,12,6,6,19
1744,ORL,0,48,34,93,36.6,8,32,25,26,61,42.62,26,29,89.7,15,37,52,21,14,8,2,19
1745,MIL,1,48,38,85,44.7,13,40,32.5,25,45,55.56,20,26,76.9,7,38,45,31,17,9,4,20
1746,MEM,1,48,42,90,46.7,8,32,25,34,58,58.62,9,9,100,4,37,41,23,12,10,5,14
1747,PHI,0,58,39,87,44.8,17,36,47.2,22,51,43.14,28,36,77.8,11,28,39,23,20,10,6,34
1748,TOR,0,48,39,85,45.9,10,28,35.7,29,57,50.88,22,30,73.3,12,34,46,19,13,6,5,20
1749,OKC,1,48,43,95,45.3,12,34,35.3,31,61,50.82,23,24,95.8,14,35,49,25,16,8,4,19
1750,LAC,1,48,45,93,48.4,15,36,41.7,30,57,52.63,14,21,66.7,13,34,47,30,12,4,5,17
1751,HOU,1,58,42,94,44.7,14,39,35.9,28,55,50.91,34,44,77.3,16,35,51,19,21,9,3,27
1752,IND,1,48,43,90,47.8,15,39,38.5,28,51,54.9,11,18,61.1,7,40,47,26,17,3,8,18
1753,CHA,0,48,47,98,48,12,34,35.3,35,64,54.69,11,17,64.7,14,35,49,29,10,8,4,16
1754,ATL,0,48,44,102,43.1,13,38,34.2,31,64,48.44,13,17,76.5,17,37,54,24,18,7,4,24
1755,PHX,0,48,40,91,44,13,37,35.1,27,54,50,18,26,69.2,13,28,41,28,13,5,5,16
1756,BOS,1,48,44,90,48.9,13,36,36.1,31,54,57.41,15,21,71.4,13,36,49,27,11,6,3,22
1757,MIA,0,48,31,79,39.2,14,40,35,17,39,43.59,17,22,77.3,9,36,45,23,17,7,3,11
1758,DAL,1,48,44,84,52.4,20,41,48.8,24,43,55.81,22,26,84.6,10,31,41,23,13,7,6,23
1759,DET,0,48,37,84,44,13,35,37.1,24,49,48.98,25,30,83.3,8,31,39,26,15,7,7,24
1760,PHX,1,48,49,94,52.1,19,37,51.4,30,57,52.63,16,20,80,14,31,45,38,11,5,0,18
1761,BOS,1,48,35,81,43.2,15,38,39.5,20,43,46.51,18,20,90,8,40,48,18,17,11,9,19
1762,SAS,0,48,38,87,43.7,6,31,19.4,32,56,57.14,13,18,72.2,12,28,40,19,19,5,3,24
1763,DEN,0,48,41,81,50.6,8,31,25.8,33,50,66,16,24,66.7,9,34,43,24,19,5,5,22
1764,WAS,0,48,49,105,46.7,10,39,25.6,39,66,59.09,11,15,73.3,11,33,44,24,10,10,8,23
1765,BKN,0,48,34,84,40.5,9,26,34.6,25,58,43.1,15,22,68.2,11,34,45,17,15,6,7,18
1766,CLE,0,48,29,83,34.9,8,35,22.9,21,48,43.75,15,20,75,8,31,39,17,19,7,6,15
1767,SAC,1,48,40,86,46.5,13,43,30.2,27,43,62.79,17,19,89.5,5,41,46,30,19,10,2,17
1768,IND,0,48,40,91,44,10,33,30.3,30,58,51.72,10,12,83.3,12,32,44,22,15,10,5,22
1769,NYK,1,48,35,86,40.7,5,29,17.2,30,57,52.63,17,21,81,14,40,54,17,21,6,3,16
1770,NOP,1,48,41,81,50.6,11,26,42.3,30,55,54.55,28,36,77.8,6,30,36,29,11,10,5,22
1771,CHI,0,48,38,86,44.2,9,25,36,29,61,47.54,16,19,84.2,7,32,39,17,16,9,5,16
1772,LAL,1,48,52,96,54.2,10,26,38.5,42,70,60,16,22,72.7,9,42,51,34,15,5,5,14
1773,POR,1,48,42,86,48.8,17,40,42.5,25,46,54.35,15,22,68.2,11,34,45,32,15,10,3,17
1774,MEM,1,48,43,92,46.7,15,35,42.9,28,57,49.12,21,29,72.4,12,34,46,28,14,9,5,21
1775,OKC,1,48,48,93,51.6,11,26,42.3,37,67,55.22,28,35,80,13,29,42,26,21,11,5,18
1776,SAC,1,48,46,89,51.7,11,32,34.4,35,57,61.4,20,30,66.7,8,38,46,31,9,7,6,22
1777,LAC,0,48,33,93,35.5,9,33,27.3,24,60,40,21,26,80.8,17,33,50,15,18,4,3,23
1778,UTA,0,48,38,84,45.2,13,36,36.1,25,48,52.08,22,28,78.6,10,34,44,20,13,8,4,22
1779,TOR,1,48,47,84,56,9,29,31,38,55,69.09,18,25,72,12,31,43,31,17,12,4,24
1780,MIL,1,48,39,83,47,12,32,37.5,27,51,52.94,15,19,78.9,8,39,47,24,22,5,8,17
1781,POR,1,48,41,85,48.2,10,25,40,31,60,51.67,24,31,77.4,12,37,49,19,13,5,6,20
1782,CHA,0,48,34,87,39.1,5,24,20.8,29,63,46.03,23,26,88.5,9,35,44,15,14,9,4,19
1783,GSW,1,48,45,85,52.9,25,52,48.1,20,33,60.61,5,10,50,6,29,35,34,14,8,5,24
1784,DAL,1,48,43,100,43,24,61,39.3,19,39,48.72,11,14,78.6,14,36,50,27,11,7,5,20
1785,ORL,0,48,38,78,48.7,11,28,39.3,27,50,54,21,26,80.8,5,24,29,23,16,9,2,20
1786,HOU,0,48,40,91,44,3,28,10.7,37,63,58.73,18,20,90,14,31,45,17,15,6,4,14
1787,MIN,0,48,47,89,52.8,10,30,33.3,37,59,62.71,24,30,80,12,32,44,25,23,13,10,23
1788,NYK,0,48,35,77,45.5,10,31,32.3,25,46,54.35,20,28,71.4,7,38,45,18,20,7,1,17
1789,MIL,0,48,50,94,53.2,17,43,39.5,33,51,64.71,12,15,80,10,32,42,29,10,2,5,18
1790,MIA,1,53,48,101,47.5,11,35,31.4,37,66,56.06,13,18,72.2,12,38,50,19,17,11,3,24
1791,LAL,1,48,52,96,54.2,11,26,42.3,41,70,58.57,18,24,75,12,32,44,32,4,6,4,16
1792,BKN,1,48,44,82,53.7,11,32,34.4,33,50,66,15,22,68.2,7,34,41,27,18,7,5,27
1793,BOS,0,53,40,87,46,15,45,33.3,25,42,59.52,21,28,75,7,41,48,26,20,6,2,18
1794,GSW,1,48,42,87,48.3,20,50,40,22,37,59.46,15,23,65.2,7,43,50,32,20,2,5,19
1795,PHX,0,48,45,85,52.9,17,37,45.9,28,48,58.33,14,19,73.7,9,28,37,30,18,9,5,28
1796,TOR,0,48,38,87,43.7,7,24,29.2,31,63,49.21,22,30,73.3,11,32,43,16,14,7,2,19
1797,PHI,0,48,40,91,44,14,33,42.4,26,58,44.83,15,17,88.2,10,32,42,23,13,7,5,21
1798,SAS,0,48,38,98,38.8,11,39,28.2,27,59,45.76,12,16,75,10,39,49,26,12,4,4,23
1799,HOU,1,48,40,81,49.4,8,24,33.3,32,57,56.14,34,43,79.1,13,28,41,19,17,12,2,22
1800,CHI,0,48,43,93,46.2,9,27,33.3,34,66,51.52,16,24,66.7,6,38,44,28,12,7,1,28
1801,ORL,0,48,40,81,49.4,8,23,34.8,32,58,55.17,8,12,66.7,11,29,40,19,18,6,4,13
1802,IND,0,48,40,92,43.5,12,34,35.3,28,58,48.28,27,33,81.8,9,26,35,25,19,12,5,35
1803,WAS,0,48,39,86,45.3,12,33,36.4,27,53,50.94,26,35,74.3,18,38,56,23,14,3,9,23
1804,DEN,0,48,45,85,52.9,12,32,37.5,33,53,62.26,7,13,53.8,9,24,33,31,16,8,0,12
1805,UTA,1,48,46,83,55.4,15,34,44.1,31,49,63.27,32,37,86.5,8,39,47,29,26,7,2,28
1806,CLE,1,48,41,84,48.8,16,42,38.1,25,42,59.52,9,9,100,5,28,33,22,13,7,5,14
1807,ATL,1,48,49,88,55.7,10,28,35.7,39,60,65,9,14,64.3,12,31,43,24,12,7,3,14
1808,NOP,1,48,40,92,43.5,12,42,28.6,28,50,56,25,26,96.2,10,43,53,25,9,9,5,18
1809,CHA,1,48,40,95,42.1,12,29,41.4,28,66,42.42,25,31,80.6,19,26,45,25,4,6,3,24
1810,MEM,1,48,42,97,43.3,11,30,36.7,31,67,46.27,22,28,78.6,19,38,57,22,12,8,11,18
1811,DET,1,53,51,94,54.3,15,35,42.9,36,59,61.02,14,24,58.3,13,39,52,29,13,9,0,26
1812,DAL,0,53,46,86,53.5,19,46,41.3,27,40,67.5,14,29,48.3,4,26,30,25,13,8,7,24
1813,CLE,1,48,45,74,60.8,15,29,51.7,30,45,66.67,8,10,80,6,34,40,28,19,10,3,13
1814,HOU,0,48,37,88,42,12,41,29.3,25,47,53.19,14,18,77.8,10,29,39,18,14,5,6,20
1815,TOR,0,48,42,88,47.7,11,38,28.9,31,50,62,13,19,68.4,3,27,30,29,16,12,7,21
1816,PHX,1,48,49,93,52.7,15,33,45.5,34,60,56.67,19,21,90.5,10,36,46,22,14,3,5,28
1817,BOS,1,48,46,83,55.4,22,45,48.9,24,38,63.16,20,23,87,11,30,41,32,18,7,0,18
1818,MIL,1,48,39,90,43.3,10,35,28.6,29,55,52.73,21,26,80.8,14,38,52,23,6,3,6,15
1819,UTA,1,48,45,81,55.6,14,32,43.8,31,49,63.27,21,28,75,13,33,46,24,18,4,7,24
1820,BKN,1,48,39,84,46.4,11,26,42.3,28,58,48.28,24,26,92.3,4,31,35,22,9,8,7,25
1821,NOP,1,48,45,86,52.3,14,33,42.4,31,53,58.49,22,26,84.6,12,40,52,28,20,10,4,16
1822,POR,0,48,42,90,46.7,8,24,33.3,34,66,51.52,17,21,81,12,33,45,21,12,4,5,25
1823,CHI,0,48,41,82,50,4,25,16,37,57,64.91,27,33,81.8,5,30,35,21,12,5,6,19
1824,ORL,0,48,39,79,49.4,8,27,29.6,31,52,59.62,22,25,88,6,27,33,26,18,5,3,21
1825,ATL,1,48,51,94,54.3,8,32,25,43,62,69.35,15,19,78.9,14,35,49,25,12,8,3,17
1826,LAL,1,48,48,97,49.5,14,37,37.8,34,60,56.67,18,26,69.2,13,35,48,28,8,5,6,18
1827,PHI,0,48,32,77,41.6,6,26,23.1,26,51,50.98,15,18,83.3,7,23,30,19,16,7,1,11
1828,MIA,0,48,47,90,52.2,18,40,45,29,50,58,9,9,100,9,23,32,25,15,8,3,21
1829,NYK,0,48,42,100,42,6,30,20,36,70,51.43,13,20,65,19,36,55,18,8,2,3,20
1830,DEN,1,48,44,83,53,17,32,53.1,27,51,52.94,15,20,75,8,34,42,30,12,6,8,21
1831,WAS,0,48,39,89,43.8,6,24,25,33,65,50.77,23,34,67.6,14,37,51,19,14,6,5,21
1832,OKC,1,48,48,94,51.1,9,27,33.3,39,67,58.21,14,21,66.7,15,37,52,17,12,4,4,20
1833,IND,0,48,40,100,40,12,37,32.4,28,63,44.44,22,30,73.3,12,35,47,28,15,8,5,21
1834,MIN,1,48,41,89,46.1,12,39,30.8,29,50,58,15,19,78.9,5,24,29,26,13,13,11,25
1835,SAS,0,48,41,92,44.6,10,37,27,31,55,56.36,19,25,76,13,31,44,27,11,5,2,20
1836,SAC,1,48,48,95,50.5,16,43,37.2,32,52,61.54,25,29,86.2,11,47,58,28,18,8,5,25
1837,MEM,0,48,37,87,42.5,9,26,34.6,28,61,45.9,18,30,60,20,39,59,17,27,7,4,20
1838,LAC,0,48,37,93,39.8,10,30,33.3,27,63,42.86,28,36,77.8,17,22,39,16,11,9,5,23
1839,DAL,1,48,42,91,46.2,15,44,34.1,27,47,57.45,17,27,63,8,31,39,21,14,7,4,21
1840,GSW,0,48,42,88,47.7,11,43,25.6,31,45,68.89,18,23,78.3,10,40,50,27,18,6,3,23
1841,DET,0,48,42,83,50.6,13,39,33.3,29,44,65.91,13,20,65,7,23,30,28,16,7,4,17
1842,LAC,1,48,41,89,46.1,13,31,41.9,28,58,48.28,23,28,82.1,14,34,48,26,13,6,7,18
1843,POR,0,48,42,90,46.7,17,35,48.6,25,55,45.45,11,15,73.3,9,34,43,24,11,6,7,23
1844,NYK,1,48,54,96,56.3,16,35,45.7,38,61,62.3,16,21,76.2,17,34,51,31,14,9,1,19
1845,IND,1,48,43,105,41,17,49,34.7,26,56,46.43,13,16,81.3,12,37,49,29,10,6,10,24
1846,PHI,1,48,39,86,45.3,10,28,35.7,29,58,50,16,18,88.9,10,27,37,23,12,10,3,19
1847,TOR,1,48,37,84,44,12,28,42.9,25,56,44.64,14,17,82.4,7,38,45,23,12,4,5,17
1848,CHA,0,48,42,86,48.8,11,29,37.9,31,57,54.39,10,15,66.7,13,24,37,28,20,7,2,14
1849,DEN,1,48,50,88,56.8,12,30,40,38,58,65.52,17,20,85,13,30,43,31,14,8,4,22
1850,CLE,0,48,34,90,37.8,7,38,18.4,27,52,51.92,13,16,81.3,13,34,47,21,10,7,3,18
1851,MIN,0,48,42,84,50,7,27,25.9,35,57,61.4,36,42,85.7,15,30,45,20,18,4,3,23
1852,HOU,0,48,39,85,45.9,16,44,36.4,23,41,56.1,19,25,76,12,25,37,25,17,4,2,20
1853,WAS,1,48,52,91,57.1,15,31,48.4,37,60,61.67,23,27,85.2,7,27,34,31,7,12,5,25
1854,ATL,0,48,37,74,50,12,27,44.4,25,47,53.19,15,22,68.2,8,34,42,26,20,7,6,21
1855,LAL,0,48,40,93,43,11,31,35.5,29,62,46.77,24,31,77.4,18,39,57,23,14,3,7,16
1856,OKC,0,48,34,92,37,12,38,31.6,22,54,40.74,21,23,91.3,18,29,47,16,19,11,4,22
1857,SAC,0,48,46,88,52.3,9,25,36,37,63,58.73,16,18,88.9,8,29,37,32,16,9,7,15
1858,CHI,1,48,43,93,46.2,6,22,27.3,37,71,52.11,22,25,88,13,37,50,21,8,6,3,17
1859,ORL,0,48,38,80,47.5,13,31,41.9,25,49,51.02,13,22,59.1,9,26,35,18,18,9,5,18
1860,UTA,0,48,41,85,48.2,19,49,38.8,22,36,61.11,6,15,40,9,36,45,30,14,5,4,17
1861,PHX,1,48,50,94,53.2,10,32,31.3,40,62,64.52,12,14,85.7,11,34,45,26,17,9,7,20
1862,NOP,1,48,39,87,44.8,9,32,28.1,30,55,54.55,18,20,90,14,35,49,21,22,12,8,18
1863,BOS,1,48,55,93,59.1,24,52,46.2,31,41,75.61,6,7,85.7,9,30,39,40,16,10,5,18
1864,BKN,1,48,44,81,54.3,9,28,32.1,35,53,66.04,12,14,85.7,8,34,42,20,18,7,8,19
1865,MEM,1,48,46,95,48.4,12,32,37.5,34,63,53.97,23,31,74.2,16,34,50,32,11,4,2,23
1866,GSW,1,48,50,87,57.5,20,47,42.6,30,40,75,17,20,85,8,39,47,36,16,7,6,26
1867,MIA,1,48,40,82,48.8,9,33,27.3,31,49,63.27,17,19,89.5,6,40,46,28,14,8,5,16
1868,CLE,1,48,33,77,42.9,8,28,28.6,25,49,51.02,28,33,84.8,10,31,41,14,14,3,4,20
1869,ATL,0,48,35,88,39.8,10,36,27.8,25,52,48.08,18,19,94.7,8,34,42,24,12,6,3,12
1870,IND,0,48,36,94,38.3,9,42,21.4,27,52,51.92,19,23,82.6,9,30,39,23,13,14,4,28
1871,ORL,0,48,36,79,45.6,12,40,30,24,39,61.54,19,25,76,7,19,26,21,16,9,4,20
1872,DET,0,48,36,79,45.6,8,28,28.6,28,51,54.9,14,26,53.8,7,29,36,14,16,9,6,26
1873,MIN,0,48,39,88,44.3,14,35,40,25,53,47.17,22,29,75.9,6,25,31,22,14,7,2,19
1874,POR,0,48,35,79,44.3,12,33,36.4,23,46,50,15,22,68.2,11,31,42,27,13,4,2,16
1875,WAS,0,48,44,82,53.7,7,28,25,37,54,68.52,26,33,78.8,6,23,29,23,4,8,1,21
1876,NYK,0,48,44,87,50.6,10,30,33.3,34,57,59.65,25,30,83.3,12,30,42,30,8,3,7,27
1877,DAL,0,48,41,80,51.3,17,41,41.5,24,39,61.54,16,25,64,6,26,32,23,13,6,2,17
1878,PHI,1,48,50,77,64.9,11,27,40.7,39,50,78,22,27,81.5,6,37,43,32,16,10,8,19
1879,BOS,1,48,44,80,55,16,34,47.1,28,46,60.87,26,26,100,10,28,38,25,14,2,5,23
1880,LAC,1,48,42,94,44.7,6,32,18.8,36,62,58.06,24,32,75,18,44,62,33,18,7,4,18
1881,BKN,1,48,41,78,52.6,15,35,42.9,26,43,60.47,14,18,77.8,4,34,38,27,8,6,2,24
1882,MIL,1,48,48,86,55.8,17,37,45.9,31,49,63.27,11,15,73.3,8,32,40,28,14,8,5,24
1883,TOR,1,48,38,88,43.2,8,26,30.8,30,62,48.39,21,26,80.8,17,31,48,20,13,10,2,21
1884,UTA,0,48,40,79,50.6,13,32,40.6,27,47,57.45,19,25,76,8,32,40,20,12,5,2,19
1885,DAL,0,48,35,73,47.9,11,39,28.2,24,34,70.59,19,24,79.2,4,30,34,28,16,7,5,26
1886,SAS,0,48,53,105,50.5,18,37,48.6,35,68,51.47,14,20,70,17,30,47,33,10,8,5,32
1887,LAL,1,48,47,81,58,17,33,51.5,30,48,62.5,32,37,86.5,3,36,39,25,17,4,7,20
1888,HOU,1,48,45,86,52.3,18,36,50,27,50,54,10,14,71.4,11,42,53,25,25,9,3,19
1889,PHX,1,48,42,92,45.7,6,22,27.3,36,70,51.43,23,30,76.7,18,30,48,23,6,8,6,20
1890,OKC,0,48,38,97,39.2,10,44,22.7,28,53,52.83,19,23,82.6,16,25,41,19,15,12,3,15
1891,GSW,1,48,52,101,51.5,20,45,44.4,32,56,57.14,5,6,83.3,16,33,49,33,21,8,3,15
1892,IND,1,48,43,86,50,12,34,35.3,31,52,59.62,30,38,78.9,5,36,41,28,10,13,4,11
1893,DET,0,48,39,92,42.4,9,26,34.6,30,66,45.45,15,16,93.8,19,30,49,21,19,6,3,22
1894,MIL,1,48,42,83,50.6,15,32,46.9,27,51,52.94,18,25,72,8,35,43,27,13,4,9,22
1895,MIA,1,48,42,89,47.2,7,26,26.9,35,63,55.56,19,23,82.6,10,37,47,24,13,5,5,19
1896,DEN,1,48,44,89,49.4,10,30,33.3,34,59,57.63,16,23,69.6,10,27,37,27,6,9,5,24
1897,UTA,0,48,46,97,47.4,11,45,24.4,35,52,67.31,15,17,88.2,15,27,42,28,13,12,6,15
1898,PHX,1,48,42,87,48.3,7,29,24.1,35,58,60.34,17,26,65.4,11,32,43,25,13,7,7,18
1899,OKC,1,53,44,95,46.3,7,29,24.1,37,66,56.06,28,32,87.5,10,40,50,24,13,7,5,21
1900,CHI,0,53,44,101,43.6,12,33,36.4,32,68,47.06,19,23,82.6,14,33,47,25,15,5,4,24
1901,CLE,0,48,34,87,39.1,12,33,36.4,22,54,40.74,22,26,84.6,10,31,41,12,9,9,2,17
1902,CHA,1,48,40,89,44.9,8,25,32,32,64,50,22,32,68.8,15,40,55,24,18,6,4,18
1903,MEM,1,48,47,91,51.6,18,38,47.4,29,53,54.72,20,27,74.1,13,33,46,26,14,4,4,20
1904,BKN,0,48,47,88,53.4,15,41,36.6,32,47,68.09,8,10,80,5,33,38,27,19,2,8,28
1905,HOU,1,48,41,87,47.1,12,35,34.3,29,52,55.77,34,41,82.9,22,37,59,25,22,9,4,29
1906,WAS,0,48,40,93,43,11,39,28.2,29,54,53.7,16,20,80,13,32,45,27,12,7,9,18
1907,POR,1,53,42,85,49.4,10,32,31.3,32,53,60.38,38,51,74.5,13,35,48,24,13,3,3,24
1908,ORL,0,48,34,80,42.5,9,35,25.7,25,45,55.56,22,27,81.5,9,26,35,20,14,7,6,15
1909,NYK,0,53,46,105,43.8,13,41,31.7,33,64,51.56,24,28,85.7,12,32,44,27,10,7,5,35
1910,LAC,0,48,37,68,54.4,11,22,50,26,46,56.52,19,34,55.9,4,29,33,22,14,1,5,20
1911,BOS,1,48,41,83,49.4,16,37,43.2,25,46,54.35,24,27,88.9,4,34,38,27,10,9,6,24
1912,ATL,0,48,39,82,47.6,15,39,38.5,24,43,55.81,29,36,80.6,6,22,28,14,14,9,6,26
1913,MIN,0,48,41,96,42.7,9,41,22,32,55,58.18,17,18,94.4,11,34,45,24,16,7,9,27
1914,SAS,0,48,38,100,38,6,33,18.2,32,67,47.76,12,16,75,20,30,50,21,16,11,3,18
1915,PHI,1,48,39,82,47.6,14,36,38.9,25,46,54.35,15,18,83.3,13,34,47,25,16,7,1,19
1916,NOP,0,48,37,86,43,10,31,32.3,27,55,49.09,27,31,87.1,11,30,41,26,13,9,4,22
1917,SAC,0,48,36,87,41.4,9,36,25,27,51,52.94,23,26,88.5,11,34,45,20,18,3,4,22
1918,LAL,1,48,40,83,48.2,8,27,29.6,32,56,57.14,17,20,85,10,39,49,28,22,12,5,16
1919,ATL,1,48,41,92,44.6,11,30,36.7,30,62,48.39,22,23,95.7,10,37,47,23,13,9,6,20
1920,IND,0,48,37,96,38.5,16,44,36.4,21,52,40.38,11,16,68.8,13,17,30,25,13,16,5,16
1921,OKC,0,53,42,97,43.3,18,40,45,24,57,42.11,24,28,85.7,12,27,39,26,10,6,7,27
1922,GSW,1,48,48,97,49.5,19,51,37.3,29,46,63.04,9,13,69.2,12,33,45,36,13,11,6,25
1923,BKN,1,48,45,82,54.9,17,38,44.7,28,44,63.64,5,7,71.4,7,32,39,32,21,10,11,24
1924,MIN,1,48,47,77,61,8,22,36.4,39,55,70.91,13,17,76.5,8,42,50,31,23,9,10,18
1925,PHI,0,48,38,86,44.2,9,38,23.7,29,48,60.42,16,18,88.9,8,37,45,20,19,9,3,23
1926,BOS,1,48,45,84,53.6,17,34,50,28,50,56,18,21,85.7,6,32,38,29,12,4,4,22
1927,MIL,0,48,41,90,45.6,12,38,31.6,29,52,55.77,19,25,76,11,37,48,24,20,5,3,17
1928,POR,0,48,35,78,44.9,13,31,41.9,22,47,46.81,13,13,100,11,21,32,28,17,9,4,24
1929,CHI,1,48,43,87,49.4,18,42,42.9,25,45,55.56,14,18,77.8,5,30,35,30,13,9,12,20
1930,NOP,1,48,47,82,57.3,14,33,42.4,33,49,67.35,21,30,70,8,34,42,33,21,8,5,22
1931,SAC,0,48,41,89,46.1,9,31,29,32,58,55.17,15,21,71.4,10,38,48,27,19,6,2,23
1932,TOR,0,48,36,101,35.6,7,29,24.1,29,72,40.28,19,25,76,23,29,52,16,14,12,2,13
1933,LAC,0,48,39,87,44.8,11,28,39.3,28,59,47.46,18,27,66.7,10,33,43,22,17,5,2,13
1934,WAS,0,48,42,89,47.2,10,38,26.3,32,51,62.75,11,19,57.9,7,36,43,27,14,7,5,20
1935,DET,1,48,44,89,49.4,12,24,50,32,65,49.23,25,27,92.6,8,30,38,24,7,9,2,20
1936,SAS,0,48,41,85,48.2,10,34,29.4,31,51,60.78,18,28,64.3,8,29,37,31,20,11,1,23
1937,UTA,0,48,41,83,49.4,18,41,43.9,23,42,54.76,16,19,84.2,7,31,38,31,16,4,7,21
1938,CLE,1,48,41,74,55.4,12,27,44.4,29,47,61.7,20,23,87,11,28,39,22,17,4,4,14
1939,DEN,1,53,42,88,47.7,14,38,36.8,28,50,56,33,41,80.5,17,38,55,31,19,4,8,24
1940,CHA,1,48,44,92,47.8,6,23,26.1,38,69,55.07,13,21,61.9,11,33,44,25,16,8,1,15
1941,MIA,1,48,39,93,41.9,16,41,39,23,52,44.23,19,22,86.4,14,39,53,20,13,7,5,18
1942,DAL,0,48,44,82,53.7,11,31,35.5,33,51,64.71,13,21,61.9,5,30,35,20,14,4,3,23
1943,BKN,0,48,44,80,55,9,28,32.1,35,52,67.31,9,13,69.2,4,31,35,31,15,5,13,15
1944,MEM,0,48,41,91,45.1,8,30,26.7,33,61,54.1,19,30,63.3,13,36,49,26,18,12,10,23
1945,PHX,1,48,48,102,47.1,16,34,47.1,32,68,47.06,3,5,60,8,41,49,23,15,8,7,22
1946,DEN,0,48,43,86,50,5,19,26.3,38,67,56.72,17,26,65.4,15,27,42,28,18,7,8,21
1947,LAL,0,48,36,85,42.4,4,22,18.2,32,63,50.79,29,35,82.9,7,38,45,19,17,8,7,12
1948,DET,1,48,45,88,51.1,8,28,28.6,37,60,61.67,12,14,85.7,12,28,40,27,16,7,5,24
1949,PHI,1,48,43,99,43.4,16,32,50,27,67,40.3,13,16,81.3,20,29,49,19,10,9,4,12
1950,SAC,1,48,39,90,43.3,15,45,33.3,24,45,53.33,20,27,74.1,9,36,45,27,20,11,2,25
1951,MIN,1,48,37,85,43.5,14,47,29.8,23,38,60.53,17,20,85,6,34,40,30,18,9,6,25
1952,MIL,1,48,47,86,54.7,9,28,32.1,38,58,65.52,16,25,64,10,32,42,31,14,12,8,17
1953,UTA,0,48,40,89,44.9,12,38,31.6,28,51,54.9,22,24,91.7,16,29,45,22,17,8,5,18
1954,LAC,1,48,47,91,51.6,9,24,37.5,38,67,56.72,18,19,94.7,12,29,41,26,16,6,6,20
1955,MIA,0,48,35,90,38.9,11,38,28.9,24,52,46.15,20,30,66.7,12,34,46,26,15,9,5,20
1956,POR,0,48,44,93,47.3,8,29,27.6,36,64,56.25,15,19,78.9,12,28,40,19,16,5,3,17
1957,CHI,1,48,46,89,51.7,14,29,48.3,32,60,53.33,15,20,75,8,43,51,26,15,10,1,19
1958,NYK,1,48,51,97,52.6,11,34,32.4,40,63,63.49,16,20,80,14,34,48,21,15,10,2,28
1959,BOS,0,48,38,87,43.7,19,50,38,19,37,51.35,12,17,70.6,5,33,38,28,15,3,4,18
1960,ORL,0,48,36,85,42.4,11,35,31.4,25,50,50,19,25,76,12,26,38,20,17,10,2,25
1961,NOP,1,48,49,91,53.8,15,42,35.7,34,49,69.39,15,21,71.4,11,39,50,30,14,15,5,16
1962,OKC,0,48,43,88,48.9,8,24,33.3,35,64,54.69,25,32,78.1,11,27,38,25,14,5,5,18
1963,ATL,0,48,38,87,43.7,11,34,32.4,27,53,50.94,15,17,88.2,10,25,35,24,17,11,3,21
1964,CLE,1,48,42,70,60,10,19,52.6,32,51,62.75,20,23,87,3,34,37,24,20,8,3,17
1965,IND,1,48,43,86,50,13,46,28.3,30,40,75,24,27,88.9,12,36,48,32,21,9,5,23
1966,GSW,0,48,28,74,37.8,10,43,23.3,18,31,58.06,17,19,89.5,4,30,34,17,27,9,5,20
1967,CHA,0,48,39,100,39,8,32,25,31,68,45.59,16,23,69.6,15,36,51,19,13,5,5,18
1968,PHX,1,48,43,101,42.6,17,39,43.6,26,62,41.94,13,18,72.2,22,38,60,35,13,3,8,22
1969,NYK,0,48,34,85,40,7,25,28,27,60,45,20,25,80,10,29,39,20,11,4,7,15
1970,SAC,1,48,47,85,55.3,12,35,34.3,35,50,70,31,35,88.6,8,33,41,29,11,4,0,18
1971,DAL,0,48,35,78,44.9,15,42,35.7,20,36,55.56,12,21,57.1,6,30,36,24,13,5,3,18
1972,LAL,1,48,45,85,52.9,12,34,35.3,33,51,64.71,21,24,87.5,5,49,54,29,15,5,2,10
1973,MIA,0,48,31,80,38.8,6,31,19.4,25,49,51.02,19,22,86.4,11,19,30,17,16,6,3,16
1974,DET,0,48,47,89,52.8,15,29,51.7,32,60,53.33,20,23,87,10,25,35,20,12,4,3,24
1975,MEM,0,48,43,99,43.4,12,37,32.4,31,62,50,17,31,54.8,13,31,44,28,10,13,0,12
1976,BKN,1,48,50,83,60.2,16,34,47.1,34,49,69.39,11,15,73.3,5,40,45,33,19,5,5,25
1977,WAS,1,48,40,93,43,13,34,38.2,27,59,45.76,13,18,72.2,14,35,49,19,17,6,13,19
1978,HOU,0,48,41,90,45.6,15,45,33.3,26,45,57.78,23,27,85.2,12,33,45,24,14,13,1,12
1979,CLE,1,48,44,83,53,13,37,35.1,31,46,67.39,12,16,75,13,36,49,31,20,7,1,23
1980,DEN,1,48,37,78,47.4,9,27,33.3,28,51,54.9,15,19,78.9,4,40,44,22,16,10,5,20
1981,SAS,0,48,41,105,39,7,34,20.6,34,71,47.89,3,10,30,13,31,44,26,10,7,2,17
1982,GSW,1,48,46,86,53.5,24,47,51.1,22,39,56.41,11,15,73.3,8,32,40,38,17,8,5,22
1983,ATL,1,53,46,92,50,7,25,28,39,67,58.21,25,32,78.1,11,39,50,23,15,5,5,20
1984,UTA,1,48,42,91,46.2,14,39,35.9,28,52,53.85,20,23,87,11,31,42,23,13,6,4,20
1985,POR,0,48,39,83,47,13,42,31,26,41,63.41,22,27,81.5,10,33,43,27,18,11,8,22
1986,IND,1,48,41,90,45.6,18,46,39.1,23,44,52.27,14,19,73.7,12,30,42,27,15,5,6,18
1987,MIN,1,48,40,85,47.1,12,36,33.3,28,49,57.14,20,24,83.3,8,35,43,28,20,9,2,25
1988,SAS,0,48,36,87,41.4,7,26,26.9,29,61,47.54,18,21,85.7,15,28,43,22,15,4,2,13
1989,ORL,0,48,39,91,42.9,16,42,38.1,23,49,46.94,19,26,73.1,11,30,41,16,11,8,6,17
1990,LAC,1,48,44,81,54.3,21,40,52.5,23,41,56.1,10,19,52.6,7,28,35,32,13,9,1,20
1991,TOR,0,53,48,108,44.4,8,37,21.6,40,71,56.34,18,22,81.8,17,34,51,27,14,11,6,25
1992,PHI,0,48,34,71,47.9,14,32,43.8,20,39,51.28,27,32,84.4,4,35,39,21,22,10,1,24
1993,LAL,1,48,43,78,55.1,7,20,35,36,58,62.07,35,40,87.5,7,37,44,29,16,2,7,24
1994,CHI,0,48,41,89,46.1,5,21,23.8,36,68,52.94,20,25,80,13,33,46,27,11,6,6,19
1995,CLE,1,58,49,92,53.3,8,28,28.6,41,64,64.06,26,32,81.3,7,43,50,25,20,8,8,25
1996,MIA,0,53,35,98,35.7,11,43,25.6,24,55,43.64,25,32,78.1,10,43,53,23,10,6,4,15
1997,WAS,1,53,41,96,42.7,15,46,32.6,26,50,52,10,14,71.4,8,46,54,33,16,6,4,25
1998,GSW,1,48,41,91,45.1,18,50,36,23,41,56.1,11,20,55,12,39,51,32,18,8,3,26
1999,PHX,0,48,49,94,52.1,9,30,30,40,64,62.5,26,28,92.9,12,30,42,29,14,7,6,25
2000,CHA,0,58,44,110,40,14,44,31.8,30,66,45.45,20,24,83.3,17,36,53,24,16,11,6,33
2001,ORL,1,48,38,77,49.4,12,28,42.9,26,49,53.06,20,22,90.9,6,35,41,25,16,4,7,25
2002,NOP,0,48,43,87,49.4,13,35,37.1,30,52,57.69,10,13,76.9,7,30,37,24,13,13,3,18
2003,DAL,1,48,46,77,59.7,13,32,40.6,33,45,73.33,22,28,78.6,6,38,44,29,10,5,3,19
2004,IND,1,48,33,82,40.2,12,41,29.3,21,41,51.22,21,27,77.8,12,33,45,25,15,8,10,26
2005,OKC,0,48,45,96,46.9,11,34,32.4,34,62,54.84,9,11,81.8,8,35,43,34,11,5,9,28
2006,PHI,1,48,40,78,51.3,13,28,46.4,27,50,54,17,26,65.4,6,35,41,28,18,5,5,18
2007,UTA,1,48,51,91,56,16,31,51.6,35,60,58.33,16,24,66.7,11,25,36,32,17,6,3,28
2008,HOU,0,48,29,86,33.7,6,28,21.4,23,58,39.66,27,32,84.4,14,35,49,15,17,8,4,24
2009,DET,0,48,43,92,46.7,11,34,32.4,32,58,55.17,24,32,75,10,27,37,27,11,9,4,30
2010,NYK,0,48,30,87,34.5,9,34,26.5,21,53,39.62,32,34,94.1,13,32,45,16,16,8,7,16
2011,DEN,0,48,38,90,42.2,10,30,33.3,28,60,46.67,13,18,72.2,13,23,36,24,13,4,1,20
2012,MIL,0,48,41,90,45.6,12,36,33.3,29,54,53.7,8,21,38.1,8,34,42,22,13,8,7,18
2013,MEM,1,48,39,93,41.9,14,39,35.9,25,54,46.3,29,40,72.5,17,40,57,26,11,4,7,13
2014,BOS,1,48,41,85,48.2,20,46,43.5,21,39,53.85,15,17,88.2,11,35,46,28,17,6,3,13
2015,SAS,0,48,46,84,54.8,11,26,42.3,35,58,60.34,9,12,75,7,25,32,29,19,8,6,22
2016,LAC,1,48,33,81,40.7,11,30,36.7,22,51,43.14,19,24,79.2,10,41,51,17,18,1,1,21
2017,BKN,1,48,40,79,50.6,11,29,37.9,29,50,58,18,23,78.3,5,42,47,32,17,4,5,24
2018,POR,0,48,36,93,38.7,13,36,36.1,23,57,40.35,22,27,81.5,8,31,39,22,10,9,5,22
2019,DET,0,48,33,88,37.5,6,31,19.4,27,57,47.37,19,24,79.2,10,33,43,15,13,9,7,26
2020,SAC,1,48,48,83,57.8,12,30,40,36,53,67.92,22,24,91.7,6,31,37,28,12,7,1,15
2021,DAL,0,48,31,102,30.4,12,55,21.8,19,47,40.43,18,19,94.7,13,25,38,21,6,9,2,19
2022,IND,1,48,44,82,53.7,11,28,39.3,33,54,61.11,26,31,83.9,7,27,34,27,14,11,9,18
2023,DEN,0,48,36,82,43.9,14,38,36.8,22,44,50,17,20,85,8,34,42,18,15,3,5,25
2024,NOP,1,48,43,85,50.6,17,33,51.5,26,52,50,21,24,87.5,12,34,46,30,15,4,6,18
2025,HOU,1,48,35,75,46.7,10,22,45.5,25,53,47.17,21,24,87.5,9,47,56,21,23,1,19,19
2026,CLE,0,48,36,84,42.9,12,28,42.9,24,56,42.86,14,17,82.4,6,28,34,22,8,7,7,18
2027,NYK,1,48,37,84,44,8,34,23.5,29,50,58,24,31,77.4,6,34,40,24,8,12,5,18
2028,MIN,1,48,46,88,52.3,12,36,33.3,34,52,65.38,22,28,78.6,8,32,40,28,11,15,6,15
2029,GSW,0,48,42,92,45.7,18,42,42.9,24,50,48,17,17,100,6,34,40,30,17,5,3,23
2030,WAS,0,48,44,86,51.2,17,34,50,27,52,51.92,15,17,88.2,11,30,41,32,19,8,5,20
2031,TOR,1,48,44,86,51.2,7,26,26.9,37,60,61.67,17,22,77.3,16,26,42,23,14,5,3,23
2032,OKC,1,48,44,81,54.3,16,31,51.6,28,50,56,17,26,65.4,9,28,37,24,15,4,7,22
2033,CHI,0,48,44,89,49.4,11,32,34.4,33,57,57.89,11,17,64.7,7,30,37,25,12,2,1,18
2034,PHX,1,48,44,86,51.2,21,40,52.5,23,46,50,21,25,84,8,39,47,33,16,5,8,22
2035,MIL,1,48,41,86,47.7,16,39,41,25,47,53.19,15,27,55.6,13,39,52,26,14,5,6,16
2036,MIA,0,48,36,66,54.5,13,35,37.1,23,31,74.19,19,22,86.4,4,19,23,19,23,5,4,20
2037,ATL,0,48,42,101,41.6,7,32,21.9,35,69,50.72,10,13,76.9,14,31,45,21,9,5,5,11
2038,ORL,0,48,42,93,45.2,9,35,25.7,33,58,56.9,15,17,88.2,12,35,47,21,16,6,5,26
2039,CHA,0,48,43,94,45.7,12,33,36.4,31,61,50.82,15,18,83.3,14,30,44,29,18,8,4,23
2040,BOS,1,48,48,88,54.5,21,46,45.7,27,42,64.29,9,10,90,6,43,49,29,15,4,8,20
2041,NOP,1,48,43,91,47.3,18,38,47.4,25,53,47.17,9,12,75,7,36,43,31,10,2,8,20
2042,BKN,0,48,40,81,49.4,11,28,39.3,29,53,54.72,30,33,90.9,3,26,29,25,17,5,3,18
2043,MEM,0,48,38,92,41.3,9,35,25.7,29,57,50.88,17,25,68,14,37,51,16,11,6,8,17
2044,SAC,1,48,56,94,59.6,20,41,48.8,36,53,67.92,21,25,84,9,34,43,39,17,9,4,24
2045,POR,1,48,41,79,51.9,15,32,46.9,26,47,55.32,20,26,76.9,9,30,39,22,17,6,3,17
2046,UTA,0,48,36,83,43.4,14,43,32.6,22,40,55,25,30,83.3,15,34,49,29,21,7,5,22
2047,DAL,1,48,35,80,43.8,17,43,39.5,18,37,48.65,16,24,66.7,8,26,34,20,12,12,1,20
2048,LAC,0,48,34,64,53.1,12,28,42.9,22,36,61.11,21,26,80.8,3,37,40,23,21,8,2,27
2049,SAS,0,48,44,85,51.8,9,29,31,35,56,62.5,13,17,76.5,11,27,38,34,19,7,5,25
2050,NYK,1,48,44,93,47.3,11,32,34.4,33,61,54.1,19,25,76,13,30,43,26,14,10,3,25
2051,GSW,1,48,47,88,53.4,23,45,51.1,24,43,55.81,15,16,93.8,5,35,40,35,13,9,3,17
2052,ATL,1,48,44,92,47.8,7,20,35,37,72,51.39,26,30,86.7,13,32,45,23,9,4,4,23
2053,PHX,0,48,48,99,48.5,14,36,38.9,34,63,53.97,2,4,50,20,25,45,22,14,9,4,22
2054,ORL,0,48,36,88,40.9,14,36,38.9,22,52,42.31,19,23,82.6,22,26,48,23,22,3,7,18
2055,DET,0,48,35,77,45.5,10,31,32.3,25,46,54.35,31,43,72.1,11,28,39,23,19,8,2,23
2056,CHA,1,48,42,88,47.7,7,35,20,35,53,66.04,21,24,87.5,14,23,37,22,13,15,7,23
2057,HOU,0,48,39,86,45.3,9,30,30,30,56,53.57,19,31,61.3,10,30,40,20,14,11,3,22
2058,BOS,1,48,46,96,47.9,10,37,27,36,59,61.02,24,29,82.8,10,36,46,25,14,15,7,20
2059,SAS,0,48,36,100,36,10,40,25,26,60,43.33,13,19,68.4,22,31,53,18,19,6,6,17
2060,MIA,1,48,38,83,45.8,15,33,45.5,23,50,46,22,25,88,17,25,42,23,15,6,4,10
2061,TOR,1,48,40,82,48.8,8,27,29.6,32,55,58.18,27,28,96.4,12,30,42,27,17,7,8,27
2062,MIL,0,48,34,82,41.5,6,29,20.7,28,53,52.83,32,41,78,11,35,46,21,17,4,3,26
2063,OKC,0,48,47,98,48,11,30,36.7,36,68,52.94,17,21,81,10,41,51,21,20,4,6,21
2064,LAC,1,48,41,81,50.6,14,38,36.8,27,43,62.79,26,33,78.8,9,35,44,25,17,6,4,23
2065,OKC,1,48,55,88,62.5,17,31,54.8,38,57,66.67,18,20,90,4,34,38,31,19,9,5,27
2066,WAS,1,48,36,86,41.9,19,40,47.5,17,46,36.96,11,21,52.4,9,38,47,26,15,9,6,15
2067,SAC,1,48,47,91,51.6,16,37,43.2,31,54,57.41,12,19,63.2,9,36,45,31,16,8,2,17
2068,UTA,0,48,37,94,39.4,11,37,29.7,26,57,45.61,13,23,56.5,18,32,50,23,18,3,4,17
2069,NYK,0,48,48,97,49.5,10,31,32.3,38,66,57.58,29,33,87.9,13,22,35,25,13,13,2,18
2070,LAL,1,48,44,91,48.4,11,27,40.7,33,64,51.56,17,20,85,12,33,45,25,9,3,2,22
2071,MEM,0,48,38,96,39.6,9,28,32.1,29,68,42.65,7,10,70,14,37,51,21,17,7,6,24
2072,CHI,0,48,40,81,49.4,6,22,27.3,34,59,57.63,17,21,81,8,28,36,24,19,9,4,19
2073,PHI,1,48,40,83,48.2,4,23,17.4,36,60,60,21,26,80.8,8,31,39,21,12,12,14,19
2074,DEN,1,48,48,80,60,13,27,48.1,35,53,66.04,17,21,81,5,31,36,33,16,11,3,17
2075,MIN,1,48,46,82,56.1,12,24,50,34,58,58.62,25,34,73.5,11,36,47,30,13,5,4,30
2076,CLE,0,48,40,89,44.9,17,34,50,23,55,41.82,27,39,69.2,16,24,40,22,10,6,1,22
2077,BKN,0,48,36,80,45,7,27,25.9,29,53,54.72,24,31,77.4,8,33,41,22,13,5,5,17
2078,GSW,0,48,42,90,46.7,16,47,34,26,43,60.47,15,16,93.8,8,35,43,27,18,5,5,20
2079,DAL,1,48,41,81,50.6,14,43,32.6,27,38,71.05,21,26,80.8,7,33,40,26,11,8,2,27
2080,UTA,0,48,44,94,46.8,14,40,35,30,54,55.56,10,11,90.9,7,35,42,33,12,4,3,17
2081,NOP,1,48,42,86,48.8,8,29,27.6,34,57,59.65,27,31,87.1,12,24,36,28,12,13,1,23
2082,ATL,0,48,40,89,44.9,6,24,25,34,65,52.31,23,27,85.2,12,31,43,20,19,4,2,19
2083,PHI,1,48,44,80,55,8,24,33.3,36,56,64.29,25,31,80.6,2,29,31,24,12,10,5,26
2084,BOS,1,48,39,91,42.9,18,48,37.5,21,43,48.84,21,24,87.5,9,33,42,27,7,6,4,17
2085,CHA,0,48,46,90,51.1,9,31,29,37,59,62.71,14,16,87.5,4,33,37,25,12,4,3,21
2086,TOR,0,48,37,94,39.4,7,35,20,30,59,50.85,23,29,79.3,16,27,43,14,12,12,8,18
2087,DET,0,48,37,89,41.6,16,38,42.1,21,51,41.18,18,21,85.7,11,39,50,23,14,4,3,23
2088,WAS,1,48,44,88,50,16,36,44.4,28,52,53.85,17,20,85,6,40,46,27,9,6,8,14
2089,IND,1,48,41,82,50,19,43,44.2,22,39,56.41,17,23,73.9,11,40,51,33,21,4,6,23
2090,MIA,1,48,49,93,52.7,16,41,39,33,52,63.46,18,21,85.7,9,37,46,32,12,7,5,19
2091,HOU,0,48,40,79,50.6,12,36,33.3,28,43,65.12,14,18,77.8,10,33,43,24,26,7,4,23
2092,BKN,1,48,40,83,48.2,16,35,45.7,24,48,50,14,21,66.7,6,35,41,27,13,9,6,18
2093,LAC,0,48,34,85,40,11,31,35.5,23,54,42.59,16,20,80,10,36,46,22,18,4,6,17
2094,POR,0,48,36,80,45,13,31,41.9,23,49,46.94,27,35,77.1,12,32,44,20,12,6,2,21
2095,MIN,0,48,37,79,46.8,10,30,33.3,27,49,55.1,19,22,86.4,7,26,33,29,15,10,4,25
2096,MEM,1,48,44,88,50,7,33,21.2,37,55,67.27,19,27,70.4,15,31,46,25,14,8,3,19
2097,SAS,1,48,43,85,50.6,12,31,38.7,31,54,57.41,13,15,86.7,9,41,50,22,19,3,13,22
2098,LAL,0,48,42,88,47.7,10,25,40,32,63,50.79,20,26,76.9,14,27,41,22,14,11,5,22
2099,NYK,1,48,42,94,44.7,10,40,25,32,54,59.26,27,29,93.1,16,31,47,23,11,7,3,31
2100,CLE,0,48,37,92,40.2,8,30,26.7,29,62,46.77,19,26,73.1,14,32,46,25,13,6,3,17
2101,BOS,1,48,50,90,55.6,16,37,43.2,34,53,64.15,15,20,75,10,36,46,30,7,3,5,19
2102,SAC,1,48,45,87,51.7,12,36,33.3,33,51,64.71,18,21,85.7,10,30,40,27,15,10,4,17
2103,OKC,1,48,52,93,55.9,15,36,41.7,37,57,64.91,13,17,76.5,15,29,44,31,19,10,6,27
2104,DET,0,48,37,80,46.3,7,31,22.6,30,49,61.22,31,41,75.6,12,31,43,22,15,6,6,23
2105,TOR,0,48,38,88,43.2,11,30,36.7,27,58,46.55,26,36,72.2,14,25,39,20,16,13,4,16
2106,DEN,0,48,42,92,45.7,12,29,41.4,30,63,47.62,16,20,80,11,27,38,26,6,3,1,16
2107,ORL,1,48,43,82,52.4,15,33,45.5,28,49,57.14,13,15,86.7,9,41,50,23,15,2,4,11
2108,PHX,0,48,38,95,40,13,42,31,25,53,47.17,8,9,88.9,11,27,38,22,11,7,4,14
2109,MIL,0,48,32,98,32.7,12,43,27.9,20,55,36.36,17,23,73.9,21,27,48,22,17,7,5,14
2110,GSW,1,48,40,82,48.8,15,36,41.7,25,46,54.35,11,14,78.6,8,36,44,29,15,5,3,27
2111,CHA,0,53,43,88,48.9,14,39,35.9,29,49,59.18,12,20,60,8,42,50,23,21,4,2,30
2112,WAS,1,48,41,84,48.8,12,30,40,29,54,53.7,19,20,95,8,44,52,25,17,5,5,21
2113,POR,1,48,37,85,43.5,12,34,35.3,25,51,49.02,20,26,76.9,11,35,46,25,9,8,2,14
2114,MIA,1,53,39,90,43.3,10,36,27.8,29,54,53.7,29,36,80.6,8,30,38,21,11,9,1,25
2115,PHI,0,48,32,83,38.6,6,30,20,26,53,49.06,25,30,83.3,9,36,45,15,17,10,5,22
2116,NOP,0,48,33,79,41.8,10,28,35.7,23,51,45.1,19,24,79.2,9,36,45,19,17,3,5,21
2117,DAL,0,48,37,86,43,18,47,38.3,19,39,48.72,13,21,61.9,7,34,41,19,13,9,1,13
2118,ATL,1,48,39,88,44.3,6,26,23.1,33,62,53.23,20,23,87,11,43,54,19,18,8,2,22
2119,HOU,0,48,37,84,44,9,35,25.7,28,49,57.14,26,31,83.9,16,33,49,29,16,9,7,18
2120,TOR,1,48,42,102,41.2,15,44,34.1,27,58,46.55,17,20,85,22,28,50,19,13,12,9,26
2121,SAS,0,53,47,98,48,12,37,32.4,35,61,57.38,16,23,69.6,13,26,39,30,12,8,2,17
2122,NYK,0,48,28,87,32.2,12,43,27.9,16,44,36.36,17,26,65.4,11,35,46,21,15,5,4,18
2123,LAL,0,48,40,88,45.5,10,32,31.3,30,56,53.57,11,17,64.7,8,35,43,26,16,7,2,20
2124,BOS,1,48,47,88,53.4,18,46,39.1,29,42,69.05,16,21,76.2,8,35,43,31,13,5,4,25
2125,CLE,0,48,46,86,53.5,11,26,42.3,35,60,58.33,17,20,85,12,30,42,24,18,4,1,23
2126,PHX,1,48,47,97,48.5,16,35,45.7,31,62,50,19,20,95,10,26,36,31,11,10,3,21
2127,MEM,1,53,50,98,51,14,32,43.8,36,66,54.55,10,13,76.9,18,35,53,24,20,4,2,22
2128,UTA,1,48,44,94,46.8,17,39,43.6,27,55,49.09,20,24,83.3,13,34,47,27,13,5,6,20
2129,DAL,0,48,32,85,37.6,11,42,26.2,21,43,48.84,12,19,63.2,4,25,29,17,6,14,4,19
2130,OKC,0,58,50,111,45,18,45,40,32,66,48.48,14,19,73.7,16,39,55,24,13,9,9,26
2131,DEN,1,48,43,88,48.9,12,28,42.9,31,60,51.67,24,26,92.3,11,36,47,27,22,10,7,15
2132,IND,0,48,45,96,46.9,14,42,33.3,31,54,57.41,15,19,78.9,11,33,44,28,18,9,5,23
2133,NOP,1,48,42,84,50,3,19,15.8,39,65,60,28,36,77.8,13,37,50,20,16,8,5,18
2134,DET,0,48,37,89,41.6,7,33,21.2,30,56,53.57,31,40,77.5,15,33,48,15,10,7,3,19
2135,MIN,0,48,41,78,52.6,9,27,33.3,32,51,62.75,26,32,81.3,8,30,38,26,19,4,6,22
2136,ATL,0,48,51,109,46.8,8,28,28.6,43,81,53.09,9,11,81.8,17,37,54,24,11,5,5,16
2137,SAC,1,48,40,76,52.6,17,39,43.6,23,37,62.16,30,35,85.7,2,22,24,30,9,12,4,20
2138,CHA,0,48,34,91,37.4,10,40,25,24,51,47.06,17,24,70.8,20,22,42,21,11,10,3,22
2139,POR,1,48,40,75,53.3,11,34,32.4,29,41,70.73,14,25,56,8,37,45,28,18,5,4,19
2140,CHI,0,48,44,87,50.6,7,27,25.9,37,60,61.67,16,18,88.9,6,29,35,23,15,5,8,23
2141,MIL,1,58,50,106,47.2,17,36,47.2,33,70,47.14,19,22,86.4,11,44,55,27,17,8,7,23
2142,LAC,1,48,41,81,50.6,12,33,36.4,29,48,60.42,20,26,76.9,6,35,41,24,15,10,7,24
2143,BKN,1,48,42,87,48.3,14,34,41.2,28,53,52.83,14,20,70,11,44,55,30,15,11,5,22
2144,ORL,1,48,36,73,49.3,8,21,38.1,28,52,53.85,14,21,66.7,4,45,49,20,19,1,6,20
2145,IND,1,48,43,86,50,22,48,45.8,21,38,55.26,21,23,91.3,10,35,45,33,17,6,8,19
2146,NOP,0,48,48,97,49.5,14,34,41.2,34,63,53.97,12,17,70.6,13,30,43,32,10,7,4,20
2147,ORL,0,48,45,82,54.9,12,25,48,33,57,57.89,25,31,80.6,11,26,37,27,20,7,4,25
2148,LAL,0,48,40,82,48.8,9,24,37.5,31,58,53.45,27,30,90,7,26,33,15,16,7,5,21
2149,MIL,0,48,36,87,41.4,13,40,32.5,23,47,48.94,13,16,81.3,6,35,41,21,19,5,9,18
2150,SAS,0,48,43,82,52.4,12,33,36.4,31,49,63.27,11,18,61.1,10,28,38,31,24,14,5,17
2151,DEN,1,48,47,88,53.4,8,24,33.3,39,64,60.94,13,20,65,8,32,40,33,22,14,7,14
2152,HOU,1,48,46,87,52.9,24,48,50,22,39,56.41,18,25,72,14,26,40,31,22,9,6,23
2153,CHI,1,48,42,80,52.5,9,28,32.1,33,52,63.46,18,22,81.8,9,40,49,30,22,7,7,21
2154,BKN,0,48,35,80,43.8,10,29,34.5,25,51,49.02,14,19,73.7,14,20,34,22,14,13,5,26
2155,MIA,0,48,40,84,47.6,14,39,35.9,26,45,57.78,13,15,86.7,5,27,32,28,12,11,2,18
2156,BOS,1,48,38,82,46.3,12,37,32.4,26,45,57.78,21,28,75,7,38,45,26,15,5,6,19
2157,ATL,1,48,46,99,46.5,11,29,37.9,35,70,50,14,17,82.4,12,36,48,23,12,11,3,18
2158,NYK,1,48,39,89,43.8,19,48,39.6,20,41,48.78,23,25,92,9,34,43,26,19,13,2,23
2159,CHA,0,48,42,101,41.6,5,32,15.6,37,69,53.62,11,16,68.8,17,28,45,27,11,8,7,23
2160,POR,1,48,38,72,52.8,16,37,43.2,22,35,62.86,18,21,85.7,4,33,37,27,19,7,2,16
2161,CLE,0,48,43,83,51.8,16,33,48.5,27,50,54,15,21,71.4,10,38,48,29,17,6,2,21
2162,LAC,1,48,40,79,50.6,17,38,44.7,23,41,56.1,22,28,78.6,4,27,31,19,9,8,2,19
2163,TOR,0,48,36,85,42.4,9,28,32.1,27,57,47.37,16,22,72.7,5,26,31,24,15,10,7,20
2164,UTA,1,48,53,95,55.8,16,38,42.1,37,57,64.91,17,22,77.3,10,31,41,30,15,10,7,23
2165,GSW,1,48,44,88,50,14,38,36.8,30,50,60,14,21,66.7,8,40,48,28,15,5,4,21
2166,SAC,0,48,37,91,40.7,14,40,35,23,51,45.1,25,29,86.2,9,34,43,24,11,9,0,20
2167,DET,1,48,39,93,41.9,9,33,27.3,30,60,50,25,33,75.8,16,42,58,20,16,6,9,19
2168,DAL,1,48,32,72,44.4,12,28,42.9,20,44,45.45,20,24,83.3,12,29,41,18,22,7,3,20
2169,MIN,0,48,38,81,46.9,11,41,26.8,27,40,67.5,20,24,83.3,4,35,39,28,18,7,8,18
2170,OKC,0,48,41,102,40.2,10,33,30.3,31,69,44.93,11,17,64.7,16,30,46,23,10,9,11,26
2171,WAS,1,48,42,80,52.5,5,19,26.3,37,61,60.66,19,30,63.3,10,37,47,21,15,2,6,18
2172,PHI,1,48,31,80,38.8,12,32,37.5,19,48,39.58,26,31,83.9,15,33,48,22,16,5,6,17
2173,PHX,0,48,32,73,43.8,6,19,31.6,26,54,48.15,18,22,81.8,6,31,37,19,15,8,5,24
2174,MEM,0,48,41,91,45.1,15,44,34.1,26,47,55.32,9,14,64.3,8,37,45,27,11,4,4,23
2175,UTA,1,48,35,75,46.7,15,40,37.5,20,35,57.14,25,26,96.2,7,35,42,18,21,5,4,15
2176,CLE,1,48,37,84,44,8,32,25,29,52,55.77,32,36,88.9,9,39,48,19,14,7,6,20
2177,MEM,1,48,39,91,42.9,9,29,31,30,62,48.39,16,20,80,12,38,50,20,11,8,2,17
2178,LAL,0,48,40,87,46,8,27,29.6,32,60,53.33,12,21,57.1,10,33,43,24,17,4,4,26
2179,CHI,0,48,40,88,45.5,13,36,36.1,27,52,51.92,11,13,84.6,15,31,46,27,17,5,10,20
2180,LAC,0,48,43,87,49.4,8,33,24.2,35,54,64.81,8,13,61.5,4,28,32,22,14,11,2,26
2181,TOR,1,48,44,103,42.7,10,37,27,34,66,51.52,15,20,75,23,29,52,28,9,11,10,16
2182,WAS,0,48,41,96,42.7,8,41,19.5,33,55,60,7,10,70,15,34,49,25,10,5,5,21
2183,PHX,1,48,35,82,42.7,11,30,36.7,24,52,46.15,21,28,75,11,33,44,22,14,7,14,22
2184,DEN,1,48,53,87,60.9,15,29,51.7,38,58,65.52,5,10,50,10,37,47,37,18,10,0,15
2185,ORL,0,53,50,92,54.3,4,23,17.4,46,69,66.67,19,20,95,7,41,48,27,18,8,4,26
2186,MIN,1,48,49,80,61.3,15,33,45.5,34,47,72.34,16,20,80,9,27,36,38,24,11,5,27
2187,BOS,1,48,47,88,53.4,27,51,52.9,20,37,54.05,12,12,100,8,26,34,30,13,5,2,17
2188,SAS,0,48,39,80,48.8,12,30,40,27,50,54,11,19,57.9,6,22,28,28,15,8,3,13
2189,NOP,0,53,47,108,43.5,7,23,30.4,40,85,47.06,20,28,71.4,19,40,59,23,16,8,6,24
2190,HOU,0,48,40,84,47.6,16,38,42.1,24,46,52.17,21,31,67.7,12,21,33,27,23,10,0,18
2191,OKC,0,48,36,84,42.9,12,35,34.3,24,49,48.98,10,16,62.5,9,29,38,22,16,6,3,18
2192,NYK,0,48,46,90,51.1,11,27,40.7,35,63,55.56,15,16,93.8,12,32,44,22,14,6,4,14
2193,MIL,1,48,38,90,42.2,17,47,36.2,21,43,48.84,15,17,88.2,18,37,55,23,19,7,6,16
2194,ATL,1,53,47,103,45.6,9,36,25,38,67,56.72,21,25,84,12,38,50,28,13,12,8,23
2195,CHA,0,48,32,86,37.2,14,42,33.3,18,44,40.91,16,23,69.6,13,37,50,22,15,3,6,21
2196,BKN,1,48,33,84,39.3,12,36,33.3,21,48,43.75,20,22,90.9,9,32,41,23,11,8,10,21
2197,POR,0,48,30,79,38,7,15,46.7,23,64,35.94,15,24,62.5,8,32,40,22,18,5,7,26
2198,SAC,1,53,47,93,50.5,15,40,37.5,32,53,60.38,17,26,65.4,6,30,36,24,14,5,4,20
2199,DET,0,48,31,83,37.3,13,37,35.1,18,46,39.13,13,15,86.7,9,25,34,16,19,10,6,22
2200,GSW,0,48,35,71,49.3,12,32,37.5,23,39,58.97,23,25,92,3,26,29,23,23,7,1,25
2201,NYK,1,48,37,80,46.3,9,33,27.3,28,47,59.57,23,27,85.2,10,40,50,24,22,5,8,21
2202,DAL,1,48,39,77,50.6,12,34,35.3,27,43,62.79,21,25,84,6,25,31,23,19,12,3,21
2203,UTA,1,48,52,103,50.5,17,40,42.5,35,63,55.56,9,10,90,15,33,48,31,8,8,3,22
2204,PHI,0,48,37,98,37.8,13,47,27.7,24,51,47.06,17,21,81,13,31,44,27,15,12,8,25
2205,MEM,1,48,50,98,51,16,36,44.4,34,62,54.84,14,18,77.8,18,42,60,34,19,6,10,20
2206,CLE,1,48,44,81,54.3,11,26,42.3,33,55,60,13,16,81.3,10,37,47,30,19,5,13,15
2207,MIN,0,48,39,92,42.4,11,41,26.8,28,51,54.9,13,17,76.5,10,37,47,22,16,2,4,25
2208,TOR,0,48,39,88,44.3,11,34,32.4,28,54,51.85,21,25,84,18,26,44,20,19,10,4,22
2209,BOS,1,48,41,83,49.4,9,31,29,32,52,61.54,32,39,82.1,7,32,39,24,14,5,7,23
2210,SAS,0,48,42,88,47.7,12,31,38.7,30,57,52.63,10,18,55.6,6,29,35,23,13,7,2,17
2211,WAS,0,48,30,83,36.1,8,34,23.5,22,49,44.9,18,22,81.8,7,32,39,18,13,4,3,15
2212,NOP,1,48,41,81,50.6,12,29,41.4,29,52,55.77,20,29,69,9,28,37,24,16,10,2,21
2213,IND,1,48,37,80,46.3,12,39,30.8,25,41,60.98,15,23,65.2,5,37,42,28,19,7,5,19
2214,MIA,0,48,31,81,38.3,11,39,28.2,20,42,47.62,26,26,100,8,34,42,17,19,10,2,22
2215,LAC,1,48,42,80,52.5,15,33,45.5,27,47,57.45,14,19,73.7,3,41,44,26,16,6,5,25
2216,CHA,0,48,33,86,38.4,8,27,29.6,25,59,42.37,25,31,80.6,12,29,41,22,18,11,7,17
2217,MIL,1,48,41,85,48.2,17,38,44.7,24,47,51.06,16,28,57.1,7,44,51,29,13,7,2,22
2218,PHX,0,48,36,83,43.4,14,34,41.2,22,49,44.9,20,21,95.2,13,26,39,26,17,8,4,22
2219,CHI,0,48,43,83,51.8,11,28,39.3,32,55,58.18,22,25,88,4,33,37,21,17,8,5,28
2220,LAL,0,48,40,83,48.2,11,26,42.3,29,57,50.88,25,28,89.3,9,31,40,22,11,6,6,17
2221,POR,1,48,43,85,50.6,10,23,43.5,33,62,53.23,12,15,80,11,31,42,30,18,6,3,24
2222,BKN,1,48,50,90,55.6,14,28,50,36,62,58.06,14,14,100,7,41,48,32,9,8,7,19
2223,GSW,0,48,50,97,51.5,19,43,44.2,31,54,57.41,10,15,66.7,9,26,35,31,14,5,3,32
2224,DEN,1,48,45,84,53.6,18,31,58.1,27,53,50.94,14,16,87.5,8,39,47,32,20,5,2,15
2225,OKC,0,48,45,93,48.4,6,29,20.7,39,64,60.94,14,19,73.7,10,30,40,19,10,9,5,19
2226,ORL,1,48,42,78,53.8,13,30,43.3,29,48,60.42,33,46,71.7,11,35,46,20,19,9,6,22
2227,PHI,0,48,39,84,46.4,19,36,52.8,20,48,41.67,14,20,70,6,26,32,25,8,3,1,25
2228,SAC,0,48,41,86,47.7,13,36,36.1,28,50,56,12,14,85.7,4,35,39,29,12,4,3,18
2229,WAS,1,48,45,78,57.7,5,21,23.8,40,57,70.18,26,32,81.3,7,36,43,27,8,4,9,18
2230,UTA,0,48,39,84,46.4,10,30,33.3,29,54,53.7,12,14,85.7,12,28,40,28,17,6,1,17
2231,SAS,0,48,37,94,39.4,14,43,32.6,23,51,45.1,12,14,85.7,13,33,46,29,23,3,6,20
2232,BOS,0,53,38,93,40.9,11,41,26.8,27,52,51.92,26,27,96.3,8,44,52,26,14,5,9,24
2233,LAL,1,53,45,98,45.9,10,36,27.8,35,62,56.45,20,23,87,11,45,56,30,18,6,8,17
2234,MIL,1,48,43,92,46.7,10,38,26.3,33,54,61.11,20,24,83.3,15,37,52,24,16,17,5,16
2235,CHI,1,48,38,88,43.2,14,31,45.2,24,57,42.11,16,18,88.9,11,40,51,28,20,6,9,18
2236,NOP,0,53,47,102,46.1,8,25,32,39,77,50.65,15,21,71.4,11,40,51,35,14,10,5,20
2237,TOR,1,48,57,106,53.8,14,33,42.4,43,73,58.9,15,16,93.8,9,41,50,31,11,16,6,17
2238,CHA,0,48,36,92,39.1,7,32,21.9,29,60,48.33,9,16,56.3,13,34,47,22,17,12,12,14
2239,DET,0,48,33,79,41.8,11,31,35.5,22,48,45.83,14,15,93.3,2,33,35,18,21,7,3,22
2240,MIA,1,48,44,89,49.4,11,34,32.4,33,55,60,11,13,84.6,9,37,46,27,11,5,5,20
2241,CLE,1,53,42,100,42,11,39,28.2,31,61,50.82,19,24,79.2,9,42,51,24,11,6,4,23
2242,POR,0,48,36,89,40.4,13,33,39.4,23,56,41.07,21,26,80.8,16,30,46,27,20,5,3,17
2243,DAL,1,48,42,84,50,11,38,28.9,31,46,67.39,8,15,53.3,7,30,37,20,12,9,4,14
2244,ATL,1,48,44,107,41.1,12,34,35.3,32,73,43.84,12,16,75,17,34,51,28,9,11,4,18
2245,HOU,0,48,37,88,42,11,38,28.9,26,50,52,16,21,76.2,16,34,50,17,19,9,5,22
2246,MEM,1,48,38,83,45.8,13,28,46.4,25,55,45.45,22,27,81.5,10,36,46,28,15,7,5,19
2247,LAC,1,48,41,84,48.8,12,33,36.4,29,51,56.86,15,19,78.9,9,34,43,20,15,10,6,20
2248,NYK,0,48,37,90,41.1,10,36,27.8,27,54,50,15,20,75,12,40,52,23,17,3,9,19
2249,PHX,1,48,41,89,46.1,17,43,39.5,24,46,52.17,17,22,77.3,7,27,34,31,11,9,8,20
2250,CHI,1,48,39,89,43.8,12,30,40,27,59,45.76,18,21,85.7,11,33,44,20,10,8,4,13
2251,GSW,0,48,39,84,46.4,18,49,36.7,21,35,60,13,17,76.5,10,31,41,31,20,8,5,22
2252,OKC,1,48,45,95,47.4,10,34,29.4,35,61,57.38,16,20,80,8,28,36,28,17,13,9,17
2253,MIN,0,48,37,87,42.5,13,34,38.2,24,53,45.28,20,24,83.3,10,32,42,24,18,5,4,24
2254,ORL,0,48,39,87,44.8,10,29,34.5,29,58,50,20,20,100,12,37,49,20,25,7,10,14
2255,MIA,1,48,40,88,45.5,16,42,38.1,24,46,52.17,20,20,100,9,30,39,32,15,7,3,16
2256,BKN,0,48,36,74,48.6,12,32,37.5,24,42,57.14,15,19,78.9,4,34,38,27,18,4,7,20
2257,ATL,0,48,39,84,46.4,11,29,37.9,28,55,50.91,20,25,80,7,30,37,28,18,1,4,27
2258,HOU,0,48,34,88,38.6,8,28,28.6,26,60,43.33,17,23,73.9,7,37,44,17,15,9,8,16
2259,CHA,0,48,43,84,51.2,14,29,48.3,29,55,52.73,8,14,57.1,6,32,38,31,21,11,6,26
2260,IND,0,48,41,87,47.1,11,39,28.2,30,48,62.5,16,23,69.6,10,28,38,23,24,11,5,24
2261,LAC,1,48,37,87,42.5,9,36,25,28,51,54.9,12,17,70.6,8,38,46,23,14,7,10,18
2262,WAS,0,48,38,81,46.9,10,25,40,28,56,50,25,26,96.2,9,32,41,22,16,8,4,18
2263,PHI,1,48,46,83,55.4,12,30,40,34,53,64.15,14,20,70,4,33,37,26,14,14,3,20
2264,UTA,1,48,42,89,47.2,19,47,40.4,23,42,54.76,18,22,81.8,11,37,48,26,16,10,6,30
2265,BKN,1,48,43,80,53.8,11,30,36.7,32,50,64,19,20,95,6,33,39,26,20,11,9,18
2266,DET,0,48,41,92,44.6,8,29,27.6,33,63,52.38,18,21,85.7,13,30,43,19,12,9,3,24
2267,MEM,0,48,38,92,41.3,6,26,23.1,32,66,48.48,23,42,54.8,18,34,52,14,16,8,4,17
2268,MIL,1,48,38,87,43.7,11,40,27.5,27,47,57.45,23,29,79.3,14,36,50,20,16,5,5,21
2269,TOR,1,48,46,92,50,14,34,41.2,32,58,55.17,33,40,82.5,12,32,44,25,7,13,9,22
2270,SAC,1,48,37,85,43.5,17,44,38.6,20,41,48.78,24,28,85.7,10,32,42,26,19,8,4,19
2271,DET,1,48,40,83,48.2,14,33,42.4,26,50,52,34,38,89.5,12,35,47,24,16,4,3,25
2272,HOU,0,48,38,87,43.7,11,34,32.4,27,53,50.94,22,26,84.6,17,32,49,18,15,7,1,25
2273,ORL,0,48,37,81,45.7,11,29,37.9,26,52,50,20,27,74.1,11,36,47,20,12,2,5,23
2274,SAS,1,48,36,86,41.9,16,40,40,20,46,43.48,19,25,76,14,38,52,27,20,6,7,21
2275,LAC,0,48,36,86,41.9,11,39,28.2,25,47,53.19,8,13,61.5,8,31,39,24,15,3,6,15
2276,DAL,1,48,41,83,49.4,11,35,31.4,30,48,62.5,21,28,75,5,32,37,15,4,10,1,22
2277,PHX,1,48,45,84,53.6,12,40,30,33,44,75,22,30,73.3,10,26,36,29,12,9,8,22
2278,BOS,1,48,36,79,45.6,21,47,44.7,15,32,46.88,19,20,95,4,43,47,29,14,4,5,15
2279,LAL,1,48,46,96,47.9,13,30,43.3,33,66,50,16,20,80,13,38,51,24,9,5,5,17
2280,WAS,0,48,38,98,38.8,7,32,21.9,31,66,46.97,11,16,68.8,15,36,51,22,10,5,6,20
2281,NOP,1,48,46,93,49.5,15,36,41.7,31,57,54.39,5,8,62.5,12,38,50,32,13,9,1,15
2282,CLE,1,48,41,89,46.1,23,50,46,18,39,46.15,16,19,84.2,10,33,43,33,14,3,5,22
2283,MIN,0,48,40,99,40.4,4,29,13.8,36,70,51.43,14,20,70,16,29,45,21,11,11,7,23
2284,GSW,0,48,39,92,42.4,12,39,30.8,27,53,50.94,24,25,96,13,29,42,23,15,8,4,24
2285,DEN,0,48,41,96,42.7,15,40,37.5,26,56,46.43,13,18,72.2,13,35,48,24,9,3,8,15
2286,NYK,0,48,45,92,48.9,10,27,37,35,65,53.85,8,16,50,12,33,45,26,14,9,2,25
2287,IND,1,48,40,94,42.6,23,46,50,17,48,35.42,22,26,84.6,17,36,53,31,12,7,1,25
2288,UTA,1,48,45,87,51.7,19,44,43.2,26,43,60.47,15,20,75,10,24,34,30,20,8,6,17
2289,GSW,0,53,44,100,44,13,44,29.5,31,56,55.36,12,16,75,10,39,49,31,10,8,6,31
2290,SAC,1,48,42,76,55.3,14,31,45.2,28,45,62.22,21,29,72.4,6,37,43,27,21,1,6,29
2291,MIL,1,48,45,92,48.9,14,36,38.9,31,56,55.36,19,29,65.5,14,35,49,24,12,8,5,18
2292,MIA,0,48,38,89,42.7,11,28,39.3,27,61,44.26,26,31,83.9,9,25,34,18,9,7,3,25
2293,PHI,1,48,39,79,49.4,14,29,48.3,25,50,50,22,27,81.5,8,33,41,28,19,8,6,22
2294,ATL,0,48,45,94,47.9,13,29,44.8,32,65,49.23,12,15,80,12,30,42,19,13,5,2,23
2295,DAL,0,53,38,95,40,8,40,20,30,55,54.55,27,34,79.4,12,37,49,17,16,8,5,30
2296,MEM,0,48,50,88,56.8,12,27,44.4,38,61,62.3,11,15,73.3,10,30,40,24,20,11,5,26
2297,CHA,1,53,43,102,42.2,10,31,32.3,33,71,46.48,24,31,77.4,15,40,55,32,10,2,2,14
2298,OKC,1,53,44,89,49.4,5,25,20,39,64,60.94,24,31,77.4,9,38,47,25,15,9,6,29
2299,CHI,0,48,36,80,45,11,31,35.5,25,49,51.02,26,29,89.7,9,31,40,22,18,7,3,20
2300,BKN,0,48,41,82,50,14,39,35.9,27,43,62.79,20,26,76.9,6,28,34,29,9,6,9,20
2301,DET,0,48,37,86,43,7,32,21.9,30,54,55.56,31,38,81.6,14,28,42,18,11,2,4,22
2302,ORL,1,48,42,85,49.4,10,37,27,32,48,66.67,19,26,73.1,5,43,48,28,12,8,5,22
2303,CHI,0,48,47,99,47.5,9,27,33.3,38,72,52.78,21,26,80.8,15,27,42,20,13,13,3,19
2304,SAS,1,48,46,86,53.5,16,38,42.1,30,48,62.5,21,26,80.8,8,34,42,37,21,7,3,17
2305,TOR,0,48,33,86,38.4,9,39,23.1,24,47,51.06,15,24,62.5,15,30,45,20,17,9,5,15
2306,ATL,1,48,55,97,56.7,12,29,41.4,43,68,63.24,14,18,77.8,10,35,45,31,7,5,8,26
2307,PHI,1,48,43,82,52.4,16,38,42.1,27,44,61.36,10,11,90.9,7,34,41,25,15,11,6,20
2308,UTA,0,48,38,91,41.8,10,39,25.6,28,52,53.85,15,19,78.9,8,30,38,24,10,7,8,30
2309,LAL,0,48,37,89,41.6,9,29,31,28,60,46.67,19,27,70.4,12,43,55,20,22,8,5,21
2310,IND,1,48,41,81,50.6,15,29,51.7,26,52,50,30,33,90.9,5,36,41,30,14,4,7,19
2311,CLE,1,53,45,87,51.7,16,35,45.7,29,52,55.77,26,34,76.5,9,33,42,18,16,5,2,28
2312,BOS,0,53,42,82,51.2,13,33,39.4,29,49,59.18,26,32,81.3,5,29,34,28,19,9,2,27
2313,MIN,1,48,41,99,41.4,13,40,32.5,28,59,47.46,16,24,66.7,14,35,49,27,10,13,8,21
2314,WAS,0,48,41,86,47.7,12,30,40,29,56,51.79,23,28,82.1,9,29,38,25,13,5,3,23
2315,CHA,0,48,33,86,38.4,11,38,28.9,22,48,45.83,16,24,66.7,10,37,47,21,15,3,4,18
2316,NOP,0,48,38,86,44.2,15,37,40.5,23,49,46.94,20,22,90.9,9,24,33,25,14,10,1,21
2317,MIL,1,48,42,109,38.5,13,45,28.9,29,64,45.31,22,27,81.5,19,41,60,23,7,8,8,23
2318,DEN,1,48,39,85,45.9,17,37,45.9,22,48,45.83,22,34,64.7,17,41,58,18,12,2,4,18
2319,NYK,0,48,37,93,39.8,12,35,34.3,25,58,43.1,22,32,68.8,13,41,54,19,13,6,5,19
2320,POR,1,48,48,90,53.3,13,35,37.1,35,55,63.64,16,20,80,11,34,45,30,16,9,6,19
2321,PHX,1,48,48,92,52.2,10,33,30.3,38,59,64.41,18,20,90,14,33,47,33,12,7,7,18
2322,HOU,0,48,40,94,42.6,14,38,36.8,26,56,46.43,17,21,81,13,26,39,23,17,10,6,18
2323,LAC,0,48,44,82,53.7,9,28,32.1,35,54,64.81,13,18,72.2,10,34,44,21,20,6,5,17
2324,SAC,0,48,40,83,48.2,12,38,31.6,28,45,62.22,18,22,81.8,9,31,40,28,13,5,2,20
2325,MEM,1,48,49,92,53.3,14,33,42.4,35,59,59.32,13,18,72.2,11,32,43,27,14,5,3,18
2326,OKC,1,48,47,95,49.5,17,38,44.7,30,57,52.63,7,8,87.5,13,23,36,27,12,10,4,21
2327,BKN,0,53,43,93,46.2,12,35,34.3,31,58,53.45,27,30,90,13,32,45,20,15,10,6,28
2328,DAL,1,53,41,81,50.6,20,40,50,21,41,51.22,27,35,77.1,7,30,37,25,18,8,4,23
2329,GSW,1,48,46,92,50,18,46,39.1,28,46,60.87,13,15,86.7,16,34,50,30,21,4,2,13
2330,MIA,0,48,39,88,44.3,14,43,32.6,25,45,55.56,18,22,81.8,8,23,31,25,12,16,5,15
2331,CHA,0,53,49,99,49.5,13,31,41.9,36,68,52.94,20,30,66.7,9,33,42,31,15,9,5,24
2332,CLE,1,48,36,87,41.4,10,33,30.3,26,54,48.15,21,30,70,12,31,43,25,13,6,3,22
2333,ORL,0,48,35,81,43.2,6,24,25,29,57,50.88,16,21,76.2,10,33,43,19,17,6,6,29
2334,MIL,1,48,39,88,44.3,10,36,27.8,29,52,55.77,22,29,75.9,14,40,54,21,19,8,12,22
2335,MIA,1,48,44,87,50.6,15,38,39.5,29,49,59.18,16,19,84.2,15,31,46,34,18,13,2,22
2336,IND,0,48,37,86,43,16,40,40,21,46,45.65,19,24,79.2,6,32,38,31,20,5,12,18
2337,DEN,1,48,42,92,45.7,9,34,26.5,33,58,56.9,17,21,81,9,45,54,34,11,12,5,17
2338,MIN,1,48,52,80,65,20,34,58.8,32,46,69.57,10,16,62.5,0,30,30,37,17,9,6,19
2339,LAL,0,48,40,90,44.4,8,30,26.7,32,60,53.33,11,16,68.8,7,40,47,25,14,8,4,16
2340,SAS,0,48,43,95,45.3,16,36,44.4,27,59,45.76,20,22,90.9,14,27,41,34,16,6,2,18
2341,UTA,1,48,38,90,42.2,13,45,28.9,25,45,55.56,20,30,66.7,11,42,53,28,16,11,5,28
2342,HOU,0,48,36,94,38.3,11,40,27.5,25,54,46.3,18,24,75,14,35,49,19,19,7,2,30
2343,DET,0,48,42,91,46.2,14,32,43.8,28,59,47.46,15,22,68.2,10,30,40,23,14,4,6,25
2344,NYK,1,53,52,97,53.6,11,30,36.7,41,67,61.19,19,22,86.4,12,34,46,26,16,5,11,24
2345,TOR,1,48,46,84,54.8,16,37,43.2,30,47,63.83,11,14,78.6,6,33,39,32,9,9,5,21
2346,CHI,1,48,43,87,49.4,16,30,53.3,27,57,47.37,22,24,91.7,9,35,44,34,18,10,5,25
2347,BKN,0,48,34,86,39.5,7,27,25.9,27,59,45.76,24,30,80,7,30,37,23,14,7,6,24
2348,POR,0,48,34,78,43.6,12,37,32.4,22,41,53.66,18,26,69.2,11,27,38,20,19,9,4,17
2349,ATL,1,48,45,91,49.5,8,22,36.4,37,69,53.62,20,25,80,10,36,46,22,12,6,12,20
2350,PHI,0,48,40,79,50.6,16,36,44.4,24,43,55.81,13,19,68.4,4,30,34,29,13,6,2,12
2351,WAS,1,48,44,85,51.8,10,33,30.3,34,52,65.38,22,26,84.6,9,38,47,26,12,7,7,21
2352,DET,0,48,36,88,40.9,8,28,28.6,28,60,46.67,19,25,76,11,30,41,12,13,6,1,26
2353,NOP,1,48,44,76,57.9,12,27,44.4,32,49,65.31,13,18,72.2,4,22,26,25,14,7,3,21
2354,GSW,0,48,41,91,45.1,10,35,28.6,31,56,55.36,13,17,76.5,10,30,40,28,16,7,7,28
2355,PHX,1,48,47,92,51.1,12,29,41.4,35,63,55.56,28,34,82.4,14,34,48,31,14,8,4,19
2356,OKC,1,48,42,110,38.2,4,30,13.3,38,80,47.5,20,25,80,21,39,60,19,6,12,8,13
2357,LAC,0,48,35,83,42.2,10,31,32.3,25,52,48.08,14,18,77.8,7,40,47,21,19,5,14,18
2358,DAL,0,48,41,82,50,12,39,30.8,29,43,67.44,17,24,70.8,11,26,37,18,12,8,5,16
2359,ORL,0,48,36,86,41.9,7,35,20,29,51,56.86,23,27,85.2,13,28,41,14,13,6,4,23
2360,SAS,1,48,48,105,45.7,12,37,32.4,36,68,52.94,7,13,53.8,14,36,50,37,13,11,0,21
2361,HOU,1,48,38,90,42.2,11,35,31.4,27,55,49.09,27,32,84.4,17,30,47,17,16,7,7,20
2362,CHI,1,48,42,87,48.3,10,21,47.6,32,66,48.48,26,29,89.7,14,46,60,29,14,4,6,18
2363,UTA,0,48,44,93,47.3,11,32,34.4,33,61,54.1,9,16,56.3,18,31,49,23,20,8,10,27
2364,NYK,1,48,43,93,46.2,11,37,29.7,32,56,57.14,18,25,72,18,32,50,24,14,7,3,24
2365,MIA,0,48,29,83,34.9,8,34,23.5,21,49,42.86,24,27,88.9,8,38,46,19,12,5,3,15
2366,DEN,0,48,45,91,49.5,12,31,38.7,33,60,55,8,14,57.1,10,28,38,28,8,4,1,28
2367,BKN,0,48,47,87,54,9,29,31,38,58,65.52,21,26,80.8,9,26,35,27,11,4,7,30
2368,MIN,0,48,38,86,44.2,8,31,25.8,30,55,54.55,22,24,91.7,10,40,50,24,16,7,5,18
2369,POR,1,48,48,83,57.8,16,35,45.7,32,48,66.67,23,31,74.2,9,36,45,23,10,3,6,15
2370,IND,0,48,38,90,42.2,12,44,27.3,26,46,56.52,18,23,78.3,14,33,47,27,13,3,4,23
2371,TOR,1,48,34,86,39.5,14,32,43.8,20,54,37.04,16,20,80,10,42,52,22,12,6,6,22
2372,BOS,0,48,37,100,37,18,48,37.5,19,52,36.54,10,12,83.3,14,31,45,26,11,5,7,24
2373,PHI,1,48,38,80,47.5,19,43,44.2,19,37,51.35,25,28,89.3,7,32,39,25,8,8,7,20
2374,MEM,1,48,47,94,50,16,34,47.1,31,60,51.67,24,31,77.4,12,26,38,21,9,7,3,22
2375,SAC,0,48,47,100,47,11,43,25.6,36,57,63.16,20,25,80,13,38,51,31,16,10,2,29
2376,CHA,1,48,47,90,52.2,11,26,42.3,36,64,56.25,21,30,70,14,38,52,28,14,7,6,24
2377,NOP,0,53,48,102,47.1,8,27,29.6,40,75,53.33,17,22,77.3,14,31,45,30,17,8,6,22
2378,CLE,1,53,41,96,42.7,13,33,39.4,28,63,44.44,22,25,88,16,32,48,19,13,10,5,20
2379,PHX,1,48,43,93,46.2,15,42,35.7,28,51,54.9,11,12,91.7,13,36,49,29,13,5,3,18
2380,GSW,1,48,45,87,51.7,14,33,42.4,31,54,57.41,26,36,72.2,6,31,37,24,13,7,5,21
2381,MIN,1,48,46,88,52.3,10,34,29.4,36,54,66.67,14,22,63.6,12,42,54,24,15,9,3,17
2382,OKC,0,48,41,94,43.6,9,41,22,32,53,60.38,15,21,71.4,11,31,42,24,11,7,4,15
2383,UTA,1,53,43,98,43.9,13,38,34.2,30,60,50,23,28,82.1,15,29,44,29,17,13,6,20
2384,POR,1,48,37,84,44,10,27,37,27,57,47.37,22,27,81.5,13,39,52,19,19,6,5,20
2385,ATL,0,48,39,95,41.1,8,35,22.9,31,60,51.67,23,28,82.1,16,29,45,23,12,8,9,21
2386,LAL,0,48,41,92,44.6,6,33,18.2,35,59,59.32,16,20,80,10,30,40,26,13,9,9,24
2387,LAC,0,48,36,82,43.9,9,32,28.1,27,50,54,14,20,70,9,34,43,16,15,10,0,18
2388,WAS,0,53,43,87,49.4,12,28,42.9,31,59,52.54,9,15,60,4,31,35,25,20,9,4,24
2389,TOR,0,48,37,87,42.5,14,39,35.9,23,48,47.92,21,28,75,8,29,37,24,6,9,5,25
2390,PHI,0,48,37,84,44,10,31,32.3,27,53,50.94,21,28,75,12,28,40,26,12,6,5,15
2391,DET,0,48,37,95,38.9,18,42,42.9,19,53,35.85,23,30,76.7,17,36,53,26,14,5,3,20
2392,SAS,1,48,43,89,48.3,16,38,42.1,27,51,52.94,12,15,80,12,31,43,27,14,5,7,20
2393,MEM,0,48,34,79,43,9,33,27.3,25,46,54.35,19,24,79.2,6,23,29,20,18,4,8,29
2394,IND,1,48,45,103,43.7,16,42,38.1,29,61,47.54,18,24,75,20,39,59,28,11,7,15,21
2395,CHI,0,48,34,84,40.5,7,29,24.1,27,55,49.09,21,25,84,10,25,35,19,10,12,7,19
2396,DEN,1,48,42,85,49.4,20,38,52.6,22,47,46.81,18,31,58.1,9,37,46,33,18,5,6,21
2397,MIA,1,48,38,76,50,11,30,36.7,27,46,58.7,25,27,92.6,6,38,44,28,16,2,2,26
2398,DAL,1,48,45,90,50,17,39,43.6,28,51,54.9,30,36,83.3,15,37,52,23,15,7,7,24
2399,SAC,0,48,40,85,47.1,14,35,40,26,50,52,15,26,57.7,9,30,39,24,12,5,5,21
2400,BOS,1,48,42,87,48.3,19,47,40.4,23,40,57.5,23,28,82.1,7,30,37,24,8,5,6,21
2401,CLE,1,48,48,85,56.5,16,27,59.3,32,58,55.17,16,18,88.9,8,40,48,32,18,4,5,17
2402,HOU,0,48,36,93,38.7,16,37,43.2,20,56,35.71,17,22,77.3,15,32,47,20,14,9,6,22
2403,OKC,0,48,42,94,44.7,15,38,39.5,27,56,48.21,18,23,78.3,10,37,47,29,13,10,5,27
2404,ORL,0,48,45,95,47.4,15,34,44.1,30,61,49.18,15,23,65.2,12,36,48,21,9,5,7,24
2405,MIL,1,48,48,85,56.5,16,31,51.6,32,54,59.26,13,21,61.9,8,39,47,29,16,6,10,22
2406,LAC,1,48,41,81,50.6,9,22,40.9,32,59,54.24,20,22,90.9,5,35,40,24,13,8,3,21
2407,ATL,1,48,40,89,44.9,13,31,41.9,27,58,46.55,15,16,93.8,9,37,46,26,17,10,2,22
2408,ORL,0,48,33,80,41.3,8,34,23.5,25,46,54.35,24,30,80,10,34,44,16,19,9,7,19
2409,HOU,0,48,44,93,47.3,16,35,45.7,28,58,48.28,18,30,60,13,32,45,18,14,4,6,22
2410,MIA,0,48,42,92,45.7,8,26,30.8,34,66,51.52,12,15,80,11,25,36,23,10,8,3,18
2411,TOR,0,48,41,84,48.8,11,28,39.3,30,56,53.57,12,18,66.7,8,33,41,25,15,9,4,21
2412,DET,0,48,39,90,43.3,9,36,25,30,54,55.56,19,32,59.4,13,36,49,26,15,6,2,21
2413,BOS,1,48,41,79,51.9,14,33,42.4,27,46,58.7,15,15,100,12,31,43,17,20,4,11,23
2414,MEM,1,48,45,98,45.9,19,42,45.2,26,56,46.43,20,29,69,17,33,50,26,12,8,10,21
2415,BKN,1,48,38,80,47.5,13,35,37.1,25,45,55.56,20,29,69,13,31,44,26,13,3,13,19
2416,GSW,0,48,42,88,47.7,15,44,34.1,27,44,61.36,24,27,88.9,7,28,35,34,19,10,3,23
2417,CHI,0,48,33,79,41.8,7,27,25.9,26,52,50,27,33,81.8,10,28,38,19,13,8,3,15
2418,SAS,1,48,44,81,54.3,17,31,54.8,27,50,54,32,44,72.7,7,30,37,34,17,9,4,22
2419,PHX,0,53,43,94,45.7,10,27,37,33,67,49.25,15,21,71.4,9,32,41,31,17,14,1,29
2420,WAS,1,48,41,80,51.3,10,26,38.5,31,54,57.41,10,11,90.9,5,34,39,26,17,8,8,22
2421,IND,0,48,51,104,49,11,35,31.4,40,69,57.97,21,22,95.5,14,28,42,32,16,8,6,34
2422,CHA,0,48,44,97,45.4,13,34,38.2,31,63,49.21,11,14,78.6,11,26,37,30,14,9,4,24
2423,NYK,1,48,50,95,52.6,16,38,42.1,34,57,59.65,14,22,63.6,11,39,50,29,12,4,6,26
2424,DEN,1,48,46,86,53.5,15,34,44.1,31,52,59.62,21,25,84,12,29,41,30,20,10,2,22
2425,NOP,1,48,42,89,47.2,8,22,36.4,34,67,50.75,32,37,86.5,15,38,53,23,16,9,7,14
2426,POR,1,53,36,82,43.9,10,29,34.5,26,53,49.06,31,36,86.1,13,35,48,14,21,8,5,19
2427,UTA,1,53,49,111,44.1,20,50,40,29,61,47.54,14,21,66.7,19,35,54,39,13,11,8,23
2428,MIN,0,53,49,107,45.8,11,33,33.3,38,74,51.35,17,23,73.9,21,39,60,20,20,5,7,22
2429,LAC,1,48,37,80,46.3,9,29,31,28,51,54.9,20,31,64.5,10,48,58,18,23,7,7,24
2430,LAL,0,48,33,94,35.1,9,45,20,24,49,48.98,22,26,84.6,8,30,38,23,10,13,5,24
2431,PHI,0,48,36,83,43.4,5,24,20.8,31,59,52.54,11,13,84.6,6,38,44,17,10,6,5,14
2432,MIL,1,48,34,84,40.5,13,42,31,21,42,50,9,14,64.3,7,41,48,24,14,4,6,16
2433,BKN,0,48,40,89,44.9,10,33,30.3,30,56,53.57,18,24,75,9,30,39,22,16,10,10,25
2434,ATL,1,48,45,90,50,7,25,28,38,65,58.46,20,24,83.3,4,34,38,30,9,12,5,18
2435,HOU,0,48,42,98,42.9,9,35,25.7,33,63,52.38,14,15,93.3,15,39,54,25,16,4,3,20
2436,CLE,0,48,38,77,49.4,10,28,35.7,28,49,57.14,19,23,82.6,6,32,38,25,17,5,5,21
2437,MEM,1,53,42,108,38.9,17,50,34,25,58,43.1,14,23,60.9,20,44,64,27,14,6,7,17
2438,WAS,1,48,42,92,45.7,11,31,35.5,31,61,50.82,19,24,79.2,14,39,53,21,17,5,10,19
2439,OKC,0,48,38,99,38.4,14,45,31.1,24,54,44.44,18,22,81.8,16,41,57,22,14,6,6,26
2440,POR,1,48,39,88,44.3,11,28,39.3,28,60,46.67,26,33,78.8,11,33,44,20,11,11,2,17
2441,SAC,0,48,39,85,45.9,17,44,38.6,22,41,53.66,13,19,68.4,4,37,41,27,16,8,5,25
2442,IND,0,48,39,97,40.2,15,42,35.7,24,55,43.64,14,21,66.7,12,30,42,21,15,7,5,20
2443,CHA,1,48,48,94,51.1,13,29,44.8,35,65,53.85,20,23,87,14,37,51,26,15,7,10,20
2444,UTA,1,48,42,83,50.6,16,38,42.1,26,45,57.78,23,31,74.2,11,32,43,27,20,10,1,21
2445,NOP,1,48,50,102,49,12,26,46.2,38,76,50,18,25,72,21,40,61,31,13,9,4,21
2446,MIN,1,48,39,94,41.5,10,38,26.3,29,56,51.79,27,33,81.8,14,41,55,25,14,6,5,21
2447,TOR,1,48,36,86,41.9,13,30,43.3,23,56,41.07,23,32,71.9,12,29,41,19,13,15,4,23
2448,DET,1,48,40,94,42.6,14,38,36.8,26,56,46.43,19,24,79.2,12,29,41,31,13,11,4,21
2449,MIA,0,48,37,80,46.3,12,28,42.9,25,52,48.08,22,28,78.6,8,38,46,21,19,6,2,24
2450,CHI,1,48,41,93,44.1,13,36,36.1,28,57,49.12,21,28,75,12,34,46,23,15,12,6,26
2451,NYK,0,53,44,109,40.4,9,37,24.3,35,72,48.61,15,18,83.3,18,36,54,28,12,7,5,26
2452,ORL,0,48,42,86,48.8,11,30,36.7,31,56,55.36,14,19,73.7,10,38,48,21,18,5,5,24
2453,PHX,1,48,40,85,47.1,8,22,36.4,32,63,50.79,19,22,86.4,8,32,40,25,12,4,5,29
2454,DAL,0,48,35,75,46.7,14,35,40,21,40,52.5,21,34,61.8,5,35,40,17,12,6,4,22
2455,SAS,0,48,40,99,40.4,7,34,20.6,33,65,50.77,15,21,71.4,14,30,44,22,15,8,8,19
2456,DEN,0,48,40,83,48.2,5,22,22.7,35,61,57.38,17,18,94.4,10,25,35,21,21,10,3,23
2457,GSW,1,48,45,99,45.5,16,45,35.6,29,54,53.7,17,23,73.9,11,37,48,31,18,11,4,23
2458,LAL,0,48,40,94,42.6,10,40,25,30,54,55.56,19,25,76,9,39,48,23,22,12,4,18
2459,BOS,1,48,46,82,56.1,12,35,34.3,34,47,72.34,22,28,78.6,6,30,36,24,11,8,3,24
2460,PHI,0,48,40,80,50,13,34,38.2,27,46,58.7,24,28,85.7,4,27,31,16,14,8,3,25
1,SAS,1,240,49,91,53.8,15,34,44.1,34,57,59.65,10,14,71.4,12,42,54,33,9,3,14,17
2,CLE,0,240,44,93,47.3,16,33,48.5,28,60,46.67,6,9,66.7,12,31,43,30,4,1,14,8
3,IND,1,240,65,100,65,19,36,52.8,46,64,71.88,8,10,80,12,36,48,41,10,6,16,24
4,PHX,1,240,47,86,54.7,16,29,55.2,31,57,54.39,15,18,83.3,13,19,32,28,13,3,13,24
5,POR,0,240,31,98,31.6,7,45,15.6,24,53,45.28,13,17,76.5,23,31,54,18,11,2,18,19
6,BKN,0,240,32,83,38.6,9,34,26.5,23,49,46.94,13,17,76.5,4,38,42,19,8,6,13,14
7,NYK,1,265,46,91,50.5,12,32,37.5,34,59,57.63,16,21,76.2,16,37,53,27,7,6,21,17
8,MIN,0,240,36,70,51.4,9,26,34.6,27,44,61.36,25,31,80.6,12,24,36,22,7,5,24,20
9,MEM,0,240,45,100,45,8,33,24.2,37,67,55.22,13,18,72.2,16,27,43,22,9,2,13,18
10,SAC,1,240,43,87,49.4,13,34,38.2,30,53,56.6,22,27,81.5,13,38,51,29,11,6,14,19
11,UTA,0,240,46,89,51.7,14,34,41.2,32,55,58.18,10,16,62.5,14,34,48,22,6,5,20,20
12,GSW,1,240,45,94,47.9,14,43,32.6,31,51,60.78,19,23,82.6,12,30,42,35,10,6,9,14
13,LAL,1,240,48,87,55.2,11,29,37.9,37,58,63.79,17,18,94.4,7,32,39,32,12,3,15,13
14,OKC,1,240,54,97,55.7,14,34,41.2,40,63,63.49,13,16,81.3,11,47,58,38,6,6,15,17
15,PHI,1,240,41,96,42.7,14,44,31.8,27,52,51.92,11,15,73.3,13,44,57,30,8,6,14,16
16,ORL,1,240,42,85,49.4,11,35,31.4,31,50,62,18,19,94.7,7,36,43,27,11,5,14,18
17,LAC,0,240,41,104,39.4,8,37,21.6,33,67,49.25,15,17,88.2,16,35,51,23,13,8,12,14
18,HOU,1,240,50,103,48.5,11,38,28.9,39,65,60,5,14,35.7,17,42,59,31,7,8,18,13
19,BOS,1,240,51,89,57.3,16,32,50,35,57,61.4,14,21,66.7,10,38,48,29,10,15,17,13
20,DAL,0,240,32,97,33,8,39,20.5,24,58,41.38,14,17,82.4,12,29,41,19,8,2,15,15
21,MIL,0,240,30,75,40,7,27,25.9,23,48,47.92,21,23,91.3,7,27,34,16,10,4,17,18
22,DEN,1,240,46,89,51.7,12,36,33.3,34,53,64.15,22,26,84.6,16,38,54,32,9,5,18,17
23,DET,0,240,36,92,39.1,8,33,24.2,28,59,47.46,15,20,75,11,29,40,17,7,3,14,9
24,MIA,1,240,46,87,52.9,9,36,25,37,51,72.55,17,19,89.5,13,33,46,29,13,7,19,16
25,CHI,0,265,49,101,48.5,8,31,25.8,41,70,58.57,13,16,81.3,15,29,44,25,15,3,12,21
26,WAS,0,240,49,103,47.6,14,38,36.8,35,65,53.85,10,10,100,8,28,36,33,9,4,12,16
27,NOP,0,240,41,86,47.7,15,37,40.5,26,49,53.06,11,14,78.6,10,29,39,26,8,1,19,17
28,CHA,1,240,46,91,50.5,19,40,47.5,27,51,52.94,9,11,81.8,10,37,47,36,10,9,10,11
29,TOR,0,240,38,90,42.2,9,34,26.5,29,56,51.79,18,21,85.7,13,28,41,23,6,3,19,21
30,ATL,0,240,39,89,43.8,12,36,33.3,27,53,50.94,25,27,92.6,9,23,32,25,6,5,17,12
31,ATL,0,240,40,90,44.4,9,30,30,31,60,51.67,17,25,68,9,31,40,23,4,1,15,25
32,CHI,1,240,48,98,49,14,35,40,34,63,53.97,19,28,67.9,17,39,56,28,9,6,13,25
33,ORL,0,240,43,95,45.3,8,27,29.6,35,68,51.47,19,25,76,10,35,45,25,7,7,11,21
34,WAS,0,240,45,86,52.3,18,43,41.9,27,43,62.79,19,29,65.5,4,35,39,32,6,5,12,22
35,NOP,1,240,42,90,46.7,20,38,52.6,22,52,42.31,10,16,62.5,5,33,38,24,11,5,9,13
36,UTA,1,240,41,88,46.6,6,35,17.1,35,53,66.04,22,25,88,14,32,46,26,7,4,18,14
37,PHX,1,240,40,76,52.6,12,32,37.5,28,44,63.64,16,17,94.1,6,35,41,25,4,4,19,16
38,DAL,0,240,36,83,43.4,8,29,27.6,28,54,51.85,9,12,75,9,40,49,20,5,5,20,9
39,MIN,1,240,38,79,48.1,10,37,27,28,42,66.67,23,29,79.3,7,37,44,29,8,11,14,22
40,POR,0,240,37,95,38.9,12,35,34.3,25,60,41.67,21,29,72.4,16,32,48,20,4,5,7,14
41,MIL,0,240,42,85,49.4,11,30,36.7,31,55,56.36,12,13,92.3,8,34,42,27,7,3,19,15
42,SAC,0,240,40,91,44,14,38,36.8,26,53,49.06,13,14,92.9,9,26,35,26,12,1,7,19
43,LAL,1,240,42,81,51.9,13,37,35.1,29,44,65.91,26,34,76.5,10,29,39,25,5,6,19,17
44,NYK,1,240,38,83,45.8,14,30,46.7,24,53,45.28,21,25,84,8,23,31,21,10,3,5,15
45,HOU,1,240,44,92,47.8,11,39,28.2,33,53,62.26,17,20,85,10,38,48,25,3,5,9,20
46,MIA,1,240,45,86,52.3,17,41,41.5,28,45,62.22,18,23,78.3,6,31,37,37,7,2,7,16
47,CHA,0,240,32,76,42.1,15,35,42.9,17,41,41.46,19,22,86.4,4,29,33,20,3,7,20,15
48,TOR,0,240,37,77,48.1,10,31,32.3,27,46,58.7,19,22,86.4,7,34,41,23,1,1,17,21
49,IND,0,240,46,89,51.7,9,32,28.1,37,57,64.91,19,22,86.4,7,32,39,37,7,2,14,17
50,PHI,1,240,42,88,47.7,18,37,48.6,24,51,47.06,23,28,82.1,8,36,44,22,6,6,13,20
51,OKC,1,240,47,89,52.8,13,38,34.2,34,51,66.67,18,20,90,8,30,38,29,13,5,10,12
52,DEN,0,240,49,97,50.5,13,36,36.1,36,61,59.02,9,10,90,6,27,33,31,9,4,9,19
53,BKN,0,240,41,82,50,11,32,34.4,30,50,60,14,19,73.7,16,29,45,22,3,4,14,19
54,BOS,1,240,54,104,51.9,14,41,34.1,40,63,63.49,9,13,69.2,16,37,53,34,12,1,6,20
55,DET,1,240,46,95,48.4,8,31,25.8,38,64,59.38,7,9,77.8,6,34,40,23,11,7,7,10
56,GSW,0,240,40,86,46.5,13,34,38.2,27,52,51.92,16,21,76.2,11,42,53,27,6,5,16,15
57,MEM,0,240,43,95,45.3,17,39,43.6,26,56,46.43,17,21,81,16,26,42,19,14,2,15,27
58,LAC,0,240,43,96,44.8,10,39,25.6,33,57,57.89,13,19,68.4,20,24,44,23,9,7,13,17
59,SAS,1,240,45,85,52.9,15,33,45.5,30,52,57.69,16,23,69.6,11,38,49,31,2,4,18,13
60,CLE,1,240,50,95,52.6,13,32,40.6,37,63,58.73,16,23,69.6,11,30,41,28,9,2,11,14
61,UTA,1,240,44,87,50.6,14,39,35.9,30,48,62.5,22,27,81.5,15,34,49,27,8,7,16,20
62,POR,0,240,35,97,36.1,8,34,23.5,27,63,42.86,14,17,82.4,20,29,49,22,9,3,13,18
63,NYK,1,240,49,99,49.5,14,36,38.9,35,63,55.56,6,10,60,17,35,52,24,7,4,15,12
64,BOS,0,240,40,86,46.5,16,42,38.1,24,44,54.55,13,16,81.3,10,26,36,25,7,12,12,16
65,NOP,1,240,49,86,57,22,40,55,27,46,58.7,15,18,83.3,5,35,40,35,7,2,13,16
66,SAC,0,240,46,84,54.8,16,38,42.1,30,46,65.22,15,20,75,5,27,32,26,7,0,14,17
67,DET,0,240,38,77,49.4,14,35,40,24,42,57.14,15,23,65.2,7,31,38,27,4,2,20,12
68,GSW,1,240,36,77,46.8,12,35,34.3,24,42,57.14,16,20,80,10,36,46,24,8,13,16,18
69,HOU,0,240,40,95,42.1,21,47,44.7,19,48,39.58,20,22,90.9,16,23,39,22,8,6,10,18
70,CHI,1,240,51,96,53.1,14,36,38.9,37,60,61.67,11,15,73.3,11,31,42,28,14,5,9,15
71,PHX,1,240,46,95,48.4,18,50,36,28,45,62.22,14,15,93.3,9,39,48,29,8,6,13,13
72,CLE,1,240,37,82,45.1,15,37,40.5,22,45,48.89,21,29,72.4,12,35,47,27,11,10,16,15
73,LAC,0,240,44,95,46.3,12,36,33.3,32,59,54.24,8,10,80,9,35,44,23,9,3,13,13
74,DAL,1,240,43,87,49.4,15,44,34.1,28,43,65.12,10,13,76.9,8,31,39,27,8,8,7,13
75,DEN,1,240,46,83,55.4,11,25,44,35,58,60.34,13,23,56.5,11,33,44,31,7,8,14,21
76,MEM,0,240,33,84,39.3,14,32,43.8,19,52,36.54,18,19,94.7,10,34,44,21,10,10,16,21
77,SAS,0,240,32,96,33.3,9,40,22.5,23,56,41.07,16,20,80,4,43,47,24,8,4,15,14
78,MIL,1,240,43,84,51.2,15,40,37.5,28,44,63.64,16,20,80,10,33,43,27,9,4,15,20
79,ORL,0,240,36,78,46.2,11,30,36.7,25,48,52.08,16,23,69.6,5,29,34,19,6,1,16,15
80,MIN,0,240,41,82,50,13,30,43.3,28,52,53.85,12,21,57.1,9,26,35,23,9,5,10,21
81,MIA,0,240,33,81,40.7,13,30,43.3,20,51,39.22,13,13,100,12,34,46,22,3,1,18,16
82,OKC,1,240,47,101,46.5,16,38,42.1,31,63,49.21,17,21,81,7,55,62,33,12,6,12,16
83,ATL,0,240,43,82,52.4,18,40,45,25,42,59.52,10,16,62.5,7,31,38,35,7,2,18,20
84,BKN,1,240,38,86,44.2,11,36,30.6,27,50,54,19,24,79.2,14,42,56,25,4,15,15,16
85,TOR,0,240,35,94,37.2,16,40,40,19,54,35.19,16,18,88.9,15,30,45,19,8,5,10,22
86,CHA,1,240,40,79,50.6,14,36,38.9,26,43,60.47,21,22,95.5,5,28,33,25,11,2,14,18
87,MIL,1,240,43,81,53.1,17,36,47.2,26,45,57.78,1,2,50,10,39,49,29,6,5,18,4
88,OKC,1,240,39,80,48.8,11,30,36.7,28,50,56,23,31,74.2,6,36,42,21,11,8,14,18
89,LAC,1,240,41,87,47.1,12,26,46.2,29,61,47.54,11,11,100,10,53,63,28,5,3,21,22
90,ATL,0,290,45,113,39.8,10,46,21.7,35,67,52.24,11,14,78.6,17,42,59,28,13,2,16,23
91,UTA,0,240,36,91,39.6,10,31,32.3,26,60,43.33,13,13,100,11,33,44,19,5,2,15,9
92,SAS,1,240,42,87,48.3,10,40,25,32,47,68.09,8,8,100,10,41,51,30,5,11,17,12
93,IND,1,240,54,99,54.5,16,45,35.6,38,54,70.37,16,23,69.6,15,29,44,33,9,8,14,23
94,DET,0,240,34,84,40.5,14,30,46.7,20,54,37.04,20,24,83.3,9,35,44,20,3,5,16,17
95,MEM,0,240,36,104,34.6,6,30,20,30,74,40.54,9,11,81.8,17,32,49,21,10,5,8,13
96,ORL,0,240,39,86,45.3,7,24,29.2,32,62,51.61,21,23,91.3,10,32,42,23,9,6,15,15
97,PHX,0,240,30,89,33.7,8,35,22.9,22,54,40.74,24,28,85.7,8,30,38,17,16,7,8,13
98,CHI,0,240,47,88,53.4,10,28,35.7,37,60,61.67,13,19,68.4,12,27,39,20,4,5,9,18
99,LAL,0,240,44,96,45.8,12,35,34.3,32,61,52.46,20,24,83.3,10,30,40,31,8,3,8,14
100,DAL,1,240,50,93,53.8,17,50,34,33,43,76.74,13,20,65,16,39,55,35,6,7,15,19
101,BOS,0,240,37,93,39.8,17,52,32.7,20,41,48.78,0,0,0,12,26,38,27,11,4,12,8
102,SAC,0,240,33,96,34.4,20,58,34.5,13,38,34.21,19,26,73.1,21,35,56,23,8,4,17,22
103,NYK,1,240,46,83,55.4,17,36,47.2,29,47,61.7,19,20,95,6,25,31,31,6,4,11,15
104,PHI,1,240,44,98,44.9,13,37,35.1,31,61,50.82,19,23,82.6,16,35,51,29,11,8,9,18
105,HOU,1,240,45,86,52.3,15,35,42.9,30,51,58.82,13,18,72.2,6,31,37,29,8,7,12,21
106,NOP,1,240,36,87,41.4,11,36,30.6,25,51,49.02,27,29,93.1,13,32,45,25,13,2,9,9
107,MIN,1,240,43,90,47.8,18,41,43.9,25,49,51.02,26,32,81.3,10,34,44,30,9,8,8,14
108,DEN,1,240,46,94,48.9,14,37,37.8,32,57,56.14,5,11,45.5,13,30,43,30,12,12,10,10
109,POR,0,240,40,85,47.1,13,38,34.2,27,47,57.45,7,8,87.5,13,34,47,28,3,3,22,19
110,TOR,0,240,47,94,50,5,21,23.8,42,73,57.53,24,33,72.7,16,24,40,21,8,6,15,20
111,GSW,1,240,47,80,58.8,26,41,63.4,21,39,53.85,14,21,66.7,4,38,42,37,3,12,15,17
112,MIA,1,290,42,88,47.7,18,45,40,24,43,55.81,15,21,71.4,5,41,46,29,8,3,18,16
113,WAS,0,240,44,89,49.4,20,43,46.5,24,46,52.17,13,17,76.5,7,34,41,26,5,4,13,22
114,CHA,0,240,39,89,43.8,10,32,31.3,29,57,50.88,16,21,76.2,8,31,39,24,8,3,12,16
115,MIA,0,240,39,84,46.4,8,27,29.6,31,57,54.39,29,32,90.6,8,31,39,21,3,2,7,22
116,DAL,1,265,46,85,54.1,15,39,38.5,31,46,67.39,40,45,88.9,6,41,47,21,4,6,17,26
117,SAC,1,240,40,94,42.6,15,48,31.3,25,46,54.35,12,16,75,11,43,54,31,8,12,9,17
118,SAS,0,290,44,98,44.9,16,44,36.4,28,54,51.85,22,26,84.6,14,45,59,31,5,11,25,17
119,MIL,0,240,35,75,46.7,12,34,35.3,23,41,56.1,27,32,84.4,9,29,38,27,3,7,14,16
120,WAS,0,240,42,89,47.2,16,40,40,26,49,53.06,22,30,73.3,8,35,43,29,9,11,15,25
121,CLE,0,240,42,88,47.7,11,30,36.7,31,58,53.45,23,27,85.2,7,29,36,27,10,2,11,16
122,TOR,1,240,49,96,51,11,31,35.5,38,65,58.46,21,28,75,8,41,49,33,9,4,14,26
123,UTA,0,240,39,83,47,15,35,42.9,24,48,50,17,21,81,6,23,29,21,4,6,11,9
124,ORL,1,240,42,90,46.7,11,34,32.4,31,56,55.36,18,19,94.7,10,30,40,24,12,4,10,17
125,PHI,1,290,52,114,45.6,12,39,30.8,40,75,53.33,17,19,89.5,8,38,46,31,15,3,12,20
126,LAC,1,240,41,84,48.8,14,35,40,27,49,55.1,24,24,100,11,37,48,26,5,2,16,22
127,HOU,0,265,46,93,49.5,17,41,41.5,29,52,55.77,27,35,77.1,4,28,32,31,11,6,11,34
128,POR,0,240,40,102,39.2,14,38,36.8,26,64,40.62,13,13,100,22,31,53,26,8,2,15,12
129,GSW,1,240,49,92,53.3,14,35,40,35,57,61.4,6,6,100,11,36,47,32,9,8,16,19
130,MIN,1,240,50,97,51.5,15,39,38.5,35,58,60.34,12,14,85.7,13,33,46,29,12,3,16,20
131,IND,1,240,44,86,51.2,9,32,28.1,35,54,64.81,20,21,95.2,4,33,37,27,4,6,7,24
132,NOP,1,240,40,85,47.1,16,39,41,24,46,52.17,17,19,89.5,8,34,42,26,8,7,14,17
133,OKC,1,240,45,87,51.7,18,36,50,27,51,52.94,13,17,76.5,10,26,36,33,14,4,17,17
134,BOS,1,240,49,87,56.3,16,38,42.1,33,49,67.35,10,13,76.9,5,35,40,34,11,8,13,12
135,PHX,0,240,39,87,44.8,14,39,35.9,25,48,52.08,13,14,92.9,9,29,38,30,7,8,16,17
136,CHI,0,240,38,75,50.7,6,20,30,32,55,58.18,16,22,72.7,8,29,37,20,7,5,21,17
137,LAL,0,240,39,84,46.4,11,31,35.5,28,53,52.83,28,32,87.5,10,31,41,27,10,2,15,14
138,NYK,1,240,45,92,48.9,14,29,48.3,31,63,49.21,18,22,81.8,13,28,41,25,9,6,7,22
139,BKN,0,240,30,86,34.9,7,30,23.3,23,56,41.07,10,13,76.9,7,39,46,17,5,5,17,14
140,CHA,0,240,45,83,54.2,17,40,42.5,28,43,65.12,11,14,78.6,7,29,36,29,12,9,18,14
141,BKN,1,240,38,73,52.1,11,27,40.7,27,46,58.7,26,33,78.8,11,37,48,20,3,7,18,11
142,ATL,0,240,37,87,42.5,12,37,32.4,25,50,50,24,29,82.8,11,27,38,30,8,2,16,18
143,PHI,1,240,41,79,51.9,16,39,41,25,40,62.5,18,23,78.3,9,32,41,27,12,9,19,22
144,DET,0,240,42,92,45.7,17,39,43.6,25,53,47.17,2,4,50,5,23,28,25,9,2,10,24
145,CLE,0,240,39,90,43.3,11,35,31.4,28,55,50.91,8,12,66.7,11,29,40,24,11,3,19,11
146,MEM,0,240,36,87,41.4,9,26,34.6,27,61,44.26,15,21,71.4,15,29,44,21,9,2,19,18
147,LAL,1,240,45,80,56.3,16,37,43.2,29,43,67.44,10,16,62.5,6,34,40,30,11,11,20,12
148,DEN,1,240,53,88,60.2,23,41,56.1,30,47,63.83,13,16,81.3,6,41,47,38,9,7,17,21
149,HOU,0,240,34,90,37.8,14,44,31.8,20,46,43.48,22,25,88,12,33,45,25,7,2,9,13
150,IND,1,240,46,88,52.3,15,35,42.9,31,53,58.49,19,21,90.5,8,31,39,30,8,5,14,23
151,ORL,0,240,42,94,44.7,9,38,23.7,33,56,58.93,22,26,84.6,15,22,37,24,9,3,10,19
152,GSW,0,240,41,93,44.1,12,35,34.3,29,58,50,12,18,66.7,11,33,44,27,12,5,15,19
153,NYK,0,240,36,83,43.4,10,29,34.5,26,54,48.15,18,24,75,9,29,38,22,9,2,18,15
154,DET,0,240,32,79,40.5,8,30,26.7,24,49,48.98,18,24,75,10,28,38,22,13,4,18,14
155,MEM,1,240,42,90,46.7,10,31,32.3,32,59,54.24,14,16,87.5,15,34,49,24,13,7,21,14
156,CHI,1,240,44,93,47.3,7,23,30.4,37,70,52.86,13,16,81.3,19,38,57,27,11,5,17,19
157,WAS,0,240,38,88,43.2,5,33,15.2,33,55,60,21,30,70,12,33,45,24,9,5,10,21
158,MIN,0,240,33,85,38.8,10,29,34.5,23,56,41.07,11,14,78.6,8,36,44,23,9,6,19,20
159,CHA,1,240,43,72,59.7,15,30,50,28,42,66.67,23,23,100,4,32,36,29,6,4,20,22
160,NOP,0,240,44,86,51.2,9,29,31,35,57,61.4,12,12,100,11,30,41,28,11,2,17,17
161,SAS,1,240,42,83,50.6,17,46,37,25,37,67.57,10,13,76.9,6,28,34,34,9,8,17,13
162,UTA,0,240,35,91,38.5,9,30,30,26,61,42.62,23,29,79.3,14,29,43,20,11,4,15,16
163,DAL,1,240,40,84,47.6,12,34,35.3,28,50,56,16,21,76.2,8,33,41,30,9,9,18,17
164,PHX,1,240,33,76,43.4,9,26,34.6,24,50,48,22,29,75.9,7,42,49,29,12,3,18,19
165,POR,1,240,41,94,43.6,9,29,31,32,65,49.23,17,24,70.8,16,39,55,29,7,5,13,23
166,MIL,0,240,41,94,43.6,12,42,28.6,29,52,55.77,17,21,81,12,33,45,21,8,6,13,24
167,SAC,0,240,38,99,38.4,17,51,33.3,21,48,43.75,7,13,53.8,15,39,54,21,4,3,7,15
168,BOS,1,240,38,89,42.7,12,44,27.3,26,45,57.78,13,18,72.2,12,39,51,25,6,4,8,11
169,LAC,1,240,51,91,56,13,35,37.1,38,56,67.86,16,18,88.9,8,43,51,32,9,4,15,22
170,TOR,1,240,36,79,45.6,14,36,38.9,22,43,51.16,31,36,86.1,9,38,47,24,9,3,17,18
171,OKC,0,240,42,86,48.8,8,30,26.7,34,56,60.71,20,24,83.3,9,30,39,24,8,6,15,17
172,MIA,1,240,44,89,49.4,13,36,36.1,31,53,58.49,18,21,85.7,8,40,48,27,8,4,9,18
173,SAC,0,240,42,86,48.8,18,42,42.9,24,44,54.55,7,12,58.3,9,26,35,26,6,3,16,23
174,PHI,1,240,43,92,46.7,14,40,35,29,52,55.77,9,11,81.8,8,33,41,28,11,7,11,15
175,DEN,0,240,36,83,43.4,11,35,31.4,25,48,52.08,17,25,68,6,45,51,27,3,4,14,19
176,GSW,1,240,47,80,58.8,17,35,48.6,30,45,66.67,22,25,88,12,31,43,29,6,2,21,23
177,ATL,0,240,34,85,40,13,38,34.2,21,47,44.68,14,21,66.7,11,45,56,21,7,2,21,22
178,NYK,1,240,44,80,55,12,28,42.9,32,52,61.54,20,29,69,9,30,39,34,9,2,13,20
179,DAL,1,240,38,94,40.4,18,49,36.7,20,45,44.44,15,17,88.2,11,42,53,20,7,7,14,17
180,LAC,1,240,34,90,37.8,7,33,21.2,27,57,47.37,27,32,84.4,7,41,48,22,10,2,7,20
181,MIA,0,240,39,94,41.5,13,43,30.2,26,51,50.98,14,16,87.5,16,35,51,24,8,4,17,10
182,HOU,0,240,36,86,41.9,12,40,30,24,46,52.17,26,30,86.7,12,17,29,23,11,1,12,19
183,CHA,0,240,32,78,41,5,31,16.1,27,47,57.45,17,22,77.3,2,34,36,22,10,8,11,15
184,MIL,0,240,38,95,40,18,44,40.9,20,51,39.22,7,12,58.3,13,31,44,26,5,10,11,14
185,MIN,1,240,49,96,51,20,43,46.5,29,53,54.72,15,22,68.2,9,41,50,37,13,9,9,12
186,PHX,1,240,44,87,50.6,18,33,54.5,26,54,48.15,16,17,94.1,8,35,43,32,11,2,16,17
187,WAS,0,240,45,91,49.5,18,42,42.9,27,49,55.1,12,13,92.3,6,33,39,26,11,4,18,22
188,IND,0,240,46,103,44.7,10,38,26.3,36,65,55.38,9,11,81.8,19,26,45,27,8,9,9,21
189,LAL,1,240,46,91,50.5,8,28,28.6,38,63,60.32,25,29,86.2,11,38,49,21,10,4,17,10
190,BKN,1,240,42,87,48.3,12,32,37.5,30,55,54.55,19,27,70.4,15,35,50,22,4,8,13,16
191,OKC,0,240,35,81,43.2,5,24,20.8,30,57,52.63,25,28,89.3,5,26,31,21,8,5,14,11
192,ATL,1,240,49,90,54.4,13,38,34.2,36,52,69.23,10,15,66.7,6,42,48,36,9,8,16,13
193,BOS,1,240,50,92,54.3,17,40,42.5,33,52,63.46,18,19,94.7,11,35,46,33,7,10,11,18
194,POR,1,240,37,93,39.8,7,26,26.9,30,67,44.78,8,12,66.7,14,41,55,19,4,2,16,19
195,TOR,0,240,33,90,36.7,7,30,23.3,26,60,43.33,12,14,85.7,10,38,48,19,4,6,21,15
196,MEM,1,240,46,91,50.5,7,23,30.4,39,68,57.35,12,17,70.6,13,41,54,25,5,8,9,12
197,NOP,0,240,36,76,47.4,12,29,41.4,24,47,51.06,24,28,85.7,7,28,35,21,9,1,14,26
198,DET,0,240,43,94,45.7,10,30,33.3,33,64,51.56,17,21,81,8,29,37,24,14,3,10,13
199,CLE,0,240,39,83,47,7,26,26.9,32,57,56.14,16,19,84.2,7,30,37,28,9,4,15,14
200,ORL,1,240,41,80,51.3,13,32,40.6,28,48,58.33,22,30,73.3,7,32,39,27,9,2,13,20
201,SAC,1,240,39,92,42.4,12,42,28.6,27,50,54,19,25,76,20,36,56,29,10,6,10,18
202,MIN,1,240,41,77,53.2,11,26,42.3,30,51,58.82,20,22,90.9,6,33,39,29,12,5,18,17
203,MIL,0,240,45,103,43.7,11,48,22.9,34,55,61.82,12,18,66.7,18,39,57,31,8,6,12,17
204,MIA,1,240,36,74,48.6,17,38,44.7,19,36,52.78,20,21,95.2,7,32,39,24,5,4,18,17
205,CLE,1,240,46,85,54.1,16,39,41,30,46,65.22,21,24,87.5,9,32,41,38,10,6,15,14
206,PHI,1,240,36,78,46.2,14,30,46.7,22,48,45.83,23,25,92,9,33,42,27,8,4,18,20
207,WAS,1,240,47,93,50.5,9,38,23.7,38,55,69.09,14,17,82.4,5,39,44,26,9,2,11,20
208,LAC,0,240,31,76,40.8,11,27,40.7,20,49,40.82,22,27,81.5,9,29,38,18,6,1,16,21
209,UTA,0,240,41,85,48.2,16,37,43.2,25,48,52.08,15,18,83.3,7,26,33,26,7,3,20,22
210,DAL,0,240,39,89,43.8,15,40,37.5,24,49,48.98,7,11,63.6,8,34,42,27,8,7,15,14
211,DEN,1,240,43,98,43.9,11,34,32.4,32,64,50,13,16,81.3,11,41,52,28,5,10,8,15
212,NYK,0,240,35,76,46.1,12,34,35.3,23,42,54.76,17,21,81,7,23,30,25,11,2,14,17
213,SAS,0,240,42,105,40,13,44,29.5,29,61,47.54,8,16,50,15,44,59,33,4,12,8,19
214,TOR,0,240,43,89,48.3,10,32,31.3,33,57,57.89,15,21,71.4,5,35,40,25,11,6,17,19
215,GSW,1,240,41,90,45.6,15,32,46.9,26,58,44.83,7,7,100,11,41,52,29,9,4,17,18
216,LAL,1,240,52,101,51.5,18,41,43.9,34,60,56.67,6,12,50,13,34,47,38,6,8,15,17
217,OKC,0,240,37,87,42.5,13,39,33.3,24,48,50,18,22,81.8,12,31,43,30,10,9,15,18
218,HOU,0,240,41,92,44.6,14,48,29.2,27,44,61.36,10,14,71.4,12,25,37,23,10,0,15,23
219,DET,0,240,40,79,50.6,11,28,39.3,29,51,56.86,17,22,77.3,9,32,41,22,7,9,14,16
220,BOS,1,240,43,89,48.3,19,53,35.8,24,36,66.67,13,16,81.3,11,40,51,28,3,3,11,15
221,PHX,1,240,43,87,49.4,18,47,38.3,25,40,62.5,20,25,80,16,33,49,29,7,6,14,21
222,POR,0,240,40,90,44.4,11,31,35.5,29,59,49.15,12,15,80,11,33,44,28,9,3,11,21
223,BKN,0,240,41,87,47.1,10,26,38.5,31,61,50.82,19,28,67.9,12,31,43,20,3,4,15,19
224,ORL,1,240,36,76,47.4,11,32,34.4,25,44,56.82,21,27,77.8,9,34,43,26,4,6,16,17
225,CHI,0,240,37,94,39.4,7,28,25,30,66,45.45,20,24,83.3,16,35,51,17,8,2,8,17
226,MEM,1,240,40,91,44,11,33,33.3,29,58,50,19,23,82.6,15,29,44,28,11,9,13,18
227,IND,1,240,53,103,51.5,13,31,41.9,40,72,55.56,14,17,82.4,14,33,47,35,6,9,10,21
228,CHA,0,240,41,91,45.1,13,37,35.1,28,54,51.85,9,11,81.8,8,32,40,28,3,2,7,15
229,NOP,0,240,42,89,47.2,11,27,40.7,31,62,50,16,24,66.7,12,25,37,29,10,1,9,17
230,ATL,1,240,41,82,50,19,40,47.5,22,42,52.38,12,18,66.7,8,37,45,29,4,5,15,21
231,LAC,1,240,43,75,57.3,14,29,48.3,29,46,63.04,30,34,88.2,7,34,41,28,4,5,10,16
232,LAL,1,240,42,77,54.5,15,40,37.5,27,37,72.97,17,22,77.3,6,44,50,24,8,6,20,15
233,SAS,0,240,40,89,44.9,17,43,39.5,23,46,50,16,18,88.9,16,29,45,31,7,5,19,12
234,MIN,0,240,38,81,46.9,11,37,29.7,27,44,61.36,14,21,66.7,8,29,37,28,12,5,14,10
235,PHI,1,240,49,83,59,24,43,55.8,25,40,62.5,13,16,81.3,9,30,39,28,6,10,16,17
236,UTA,0,240,34,83,41,16,41,39,18,42,42.86,22,28,78.6,11,22,33,22,6,4,12,18
237,BKN,0,240,39,92,42.4,12,36,33.3,27,56,48.21,14,19,73.7,9,29,38,19,12,3,13,17
238,SAC,1,240,45,84,53.6,20,40,50,25,44,56.82,17,23,73.9,13,31,44,34,8,6,15,23
239,HOU,0,240,39,92,42.4,13,38,34.2,26,54,48.15,16,19,84.2,12,31,43,22,9,3,12,14
240,MIA,1,240,40,81,49.4,14,36,38.9,26,45,57.78,25,29,86.2,6,36,42,22,11,8,14,19
241,NYK,0,240,38,92,41.3,13,43,30.2,25,49,51.02,23,34,67.6,15,31,46,24,8,3,11,19
242,GSW,1,240,45,92,48.9,16,39,41,29,53,54.72,11,13,84.6,12,29,41,34,15,3,16,14
243,TOR,0,240,47,90,52.2,11,30,36.7,36,60,60,15,20,75,7,23,30,31,10,2,12,14
244,OKC,1,240,44,82,53.7,13,34,38.2,31,48,64.58,12,24,50,9,34,43,29,6,8,13,23
245,CHI,1,240,42,80,52.5,17,29,58.6,25,51,49.02,8,12,66.7,8,35,43,30,11,3,16,18
246,DAL,1,240,48,93,51.6,24,47,51.1,24,46,52.17,5,9,55.6,10,37,47,24,7,8,14,17
247,CLE,0,240,38,82,46.3,8,25,32,30,57,52.63,17,21,81,6,22,28,26,10,4,15,12
248,WAS,0,240,40,88,45.5,11,38,28.9,29,50,58,16,21,76.2,7,35,42,27,6,1,16,22
249,DEN,1,240,50,87,57.5,21,33,63.6,29,54,53.7,9,13,69.2,11,40,51,36,7,4,17,19
250,CHA,0,240,44,88,50,23,52,44.2,21,36,58.33,7,11,63.6,5,26,31,32,3,2,9,25
251,ORL,1,240,38,78,48.7,22,44,50,16,34,47.06,20,23,87,5,38,43,28,8,8,17,16
252,MIL,1,240,43,78,55.1,8,28,28.6,35,50,70,28,35,80,6,34,40,27,7,5,12,18
253,ATL,0,240,42,92,45.7,14,35,40,28,57,49.12,15,18,83.3,9,30,39,24,5,3,11,26
254,MEM,0,240,31,86,36,12,36,33.3,19,50,38,14,17,82.4,13,32,45,25,11,7,19,19
255,BOS,1,240,39,82,47.6,15,37,40.5,24,45,53.33,11,12,91.7,8,43,51,27,7,7,13,13
256,NOP,0,240,34,86,39.5,13,35,37.1,21,51,41.18,11,18,61.1,10,31,41,22,9,3,9,12
257,SAS,1,265,44,82,53.7,16,40,40,28,42,66.67,26,32,81.3,8,38,46,34,3,2,15,16
258,LAC,1,240,41,85,48.2,8,24,33.3,33,61,54.1,10,12,83.3,12,29,41,19,11,4,17,17
259,LAL,0,240,35,86,40.7,5,30,16.7,30,56,53.57,15,18,83.3,10,38,48,24,3,3,16,14
260,DEN,0,240,35,88,39.8,8,28,28.6,27,60,45,20,27,74.1,13,33,46,29,6,1,13,24
261,CHA,0,240,34,84,40.5,12,46,26.1,22,38,57.89,17,24,70.8,12,29,41,23,4,2,11,10
262,HOU,1,240,35,91,38.5,13,42,31,22,49,44.9,18,28,64.3,15,30,45,19,10,6,10,18
263,PHX,0,240,39,87,44.8,13,41,31.7,26,46,56.52,12,15,80,13,26,39,26,6,6,14,15
264,MIA,1,240,54,92,58.7,21,39,53.8,33,53,62.26,13,18,72.2,6,38,44,41,17,4,9,13
265,POR,0,240,35,87,40.2,5,30,16.7,30,57,52.63,7,11,63.6,10,33,43,20,4,2,24,19
266,CLE,1,240,45,82,54.9,16,37,43.2,29,45,64.44,11,13,84.6,5,32,37,34,4,3,14,17
267,DAL,1,240,35,74,47.3,15,35,42.9,20,39,51.28,22,33,66.7,6,36,42,24,4,6,10,12
268,BKN,1,240,43,91,47.3,25,44,56.8,18,47,38.3,14,22,63.6,12,31,43,26,9,3,7,22
269,SAC,0,240,40,92,43.5,15,32,46.9,25,60,41.67,8,12,66.7,10,35,45,24,9,1,11,22
270,UTA,0,240,37,80,46.3,8,31,25.8,29,49,59.18,18,19,94.7,11,40,51,23,4,9,21,23
271,NYK,0,265,51,110,46.4,14,37,37.8,37,73,50.68,10,12,83.3,18,32,50,24,10,1,12,24
272,OKC,1,240,49,87,56.3,16,30,53.3,33,57,57.89,14,14,100,7,31,38,33,7,7,11,13
273,DET,1,240,37,89,41.6,6,24,25,31,65,47.69,16,20,80,8,39,47,19,9,5,13,18
274,IND,1,240,43,89,48.3,10,31,32.3,33,58,56.9,13,14,92.9,6,40,46,27,8,6,10,14
275,MIN,1,240,38,74,51.4,9,28,32.1,29,46,63.04,26,37,70.3,6,33,39,28,6,7,9,20
276,ORL,0,240,38,86,44.2,10,29,34.5,28,57,49.12,11,15,73.3,13,25,38,20,10,8,17,11
277,WAS,0,240,36,88,40.9,9,33,27.3,27,55,49.09,6,8,75,9,38,47,22,2,4,19,18
278,PHI,0,240,42,94,44.7,16,40,40,26,54,48.15,14,17,82.4,16,26,42,28,6,7,9,20
279,GSW,1,240,48,89,53.9,11,32,34.4,37,57,64.91,8,9,88.9,11,39,50,35,7,5,13,19
280,CHI,0,240,38,75,50.7,9,30,30,29,45,64.44,23,29,79.3,5,39,44,24,3,6,13,18
281,NOP,1,240,36,91,39.6,8,32,25,28,59,47.46,27,34,79.4,11,37,48,22,11,5,7,19
282,MIL,0,240,38,82,46.3,14,39,35.9,24,43,55.81,10,19,52.6,5,41,46,21,1,4,14,25
283,ATL,1,265,51,104,49,15,44,34.1,36,60,60,6,10,60,17,36,53,24,5,5,11,17
284,BOS,0,265,45,94,47.9,14,36,38.9,31,58,53.45,18,21,85.7,9,34,43,28,7,6,12,15
285,ATL,1,240,44,85,51.8,16,41,39,28,44,63.64,16,20,80,8,33,41,23,12,9,17,17
286,UTA,0,240,39,83,47,13,35,37.1,26,48,54.17,20,22,90.9,6,30,36,25,8,4,22,16
287,DEN,0,240,38,88,43.2,10,40,25,28,48,58.33,11,12,91.7,9,29,38,24,9,4,8,13
288,PHX,1,240,39,83,47,16,33,48.5,23,50,46,10,11,90.9,12,39,51,29,3,7,17,13
289,LAL,1,240,45,81,55.6,18,33,54.5,27,48,56.25,28,35,80,4,39,43,31,5,4,16,19
290,CHI,1,240,49,98,50,12,27,44.4,37,71,52.11,15,18,83.3,13,41,54,28,7,5,8,19
291,HOU,1,265,50,104,48.1,15,43,34.9,35,61,57.38,17,23,73.9,16,34,50,25,10,3,16,24
292,MEM,0,240,46,97,47.4,17,43,39.5,29,54,53.7,15,19,78.9,13,26,39,30,10,3,14,23
293,LAC,1,240,40,90,44.4,14,36,38.9,26,54,48.15,14,20,70,11,32,43,28,8,5,8,16
294,WAS,0,265,46,91,50.5,14,34,41.2,32,57,56.14,13,17,76.5,5,39,44,26,4,4,14,21
295,BKN,1,265,47,98,48,10,33,30.3,37,65,56.92,18,23,78.3,10,35,45,24,8,9,8,16
296,CLE,0,240,42,85,49.4,19,44,43.2,23,41,56.1,8,14,57.1,9,23,32,33,7,1,15,21
297,PHI,0,240,39,82,47.6,13,33,39.4,26,49,53.06,16,19,84.2,10,41,51,17,3,11,12,18
298,SAS,1,240,44,86,51.2,16,33,48.5,28,53,52.83,14,21,66.7,9,32,41,40,9,7,21,21
299,TOR,0,240,39,84,46.4,11,31,35.5,28,53,52.83,12,13,92.3,11,17,28,31,7,4,18,17
300,NYK,1,240,55,94,58.5,22,44,50,33,50,66,13,16,81.3,15,27,42,37,7,8,11,17
301,CHA,1,240,44,76,57.9,13,33,39.4,31,43,72.09,17,22,77.3,8,30,38,30,8,2,16,14
302,MIN,1,240,42,82,51.2,11,36,30.6,31,46,67.39,11,16,68.8,9,31,40,28,8,3,12,17
303,ORL,0,240,36,85,42.4,10,32,31.3,26,53,49.06,11,21,52.4,10,29,39,25,10,5,11,13
304,IND,0,240,34,85,40,13,42,31,21,43,48.84,18,23,78.3,12,28,40,25,3,4,13,23
305,GSW,1,240,40,90,44.4,10,34,29.4,30,56,53.57,11,13,84.6,12,40,52,26,5,5,13,18
306,POR,0,240,43,85,50.6,14,31,45.2,29,54,53.7,6,10,60,6,27,33,35,8,2,19,18
307,DET,0,240,31,81,38.3,9,32,28.1,22,49,44.9,20,25,80,10,31,41,15,9,1,12,14
308,OKC,0,265,47,96,49,14,38,36.8,33,58,56.9,18,24,75,13,36,49,26,7,7,19,24
309,GSW,1,240,47,85,55.3,13,38,34.2,34,47,72.34,6,10,60,7,36,43,31,6,5,12,20
310,MIL,0,290,49,119,41.2,15,51,29.4,34,68,50,11,17,64.7,15,46,61,37,9,5,14,26
311,OKC,1,240,46,86,53.5,15,34,44.1,31,52,59.62,12,14,85.7,7,38,45,28,5,3,12,17
312,SAC,0,240,35,90,38.9,11,30,36.7,24,60,40,15,19,78.9,11,31,42,27,6,5,14,15
313,NOP,0,240,39,86,45.3,14,38,36.8,25,48,52.08,20,23,87,5,32,37,26,7,2,10,18
314,LAL,1,290,42,108,38.9,14,44,31.8,28,64,43.75,30,32,93.8,15,54,69,30,4,8,17,13
315,DAL,1,240,51,92,55.4,22,39,56.4,29,53,54.72,8,13,61.5,5,44,49,34,10,4,9,18
316,MIA,0,240,37,92,40.2,8,33,24.2,29,59,49.15,10,13,76.9,11,28,39,24,3,2,9,9
317,CHI,0,240,36,87,41.4,10,35,28.6,26,52,50,23,28,82.1,9,37,46,27,9,8,12,14
318,DET,0,240,34,88,38.6,10,34,29.4,24,54,44.44,21,22,95.5,7,30,37,22,8,5,12,22
319,PHI,0,240,34,82,41.5,11,34,32.4,23,48,47.92,17,20,85,15,32,47,18,2,4,15,25
320,HOU,1,240,37,93,39.8,12,39,30.8,25,54,46.3,24,25,96,13,32,45,19,7,7,9,16
321,IND,1,240,50,86,58.1,17,28,60.7,33,58,56.9,16,22,72.7,7,27,34,28,7,3,8,21
322,ATL,1,240,46,87,52.9,18,36,50,28,51,54.9,10,17,58.8,15,29,44,30,5,3,13,18
323,DEN,1,240,48,90,53.3,15,32,46.9,33,58,56.9,17,18,94.4,15,35,50,38,10,7,16,23
324,CLE,1,240,46,86,53.5,17,41,41.5,29,45,64.44,6,10,60,9,38,47,41,4,3,14,15
325,BKN,1,240,37,81,45.7,9,39,23.1,28,42,66.67,13,18,72.2,16,34,50,20,3,4,20,16
326,SAS,1,240,40,91,44,8,31,25.8,32,60,53.33,16,19,84.2,5,35,40,23,10,1,7,15
327,CHA,0,240,34,80,42.5,9,28,32.1,25,52,48.08,15,18,83.3,6,27,33,22,5,4,12,13
328,TOR,0,240,37,85,43.5,5,27,18.5,32,58,55.17,9,12,75,8,22,30,23,10,2,10,15
329,DAL,1,240,44,92,47.8,12,42,28.6,32,50,64,15,18,83.3,10,37,47,31,9,7,6,17
330,MEM,0,240,37,94,39.4,11,44,25,26,50,52,18,27,66.7,17,23,40,25,9,9,17,15
331,WAS,1,240,39,97,40.2,14,49,28.6,25,48,52.08,15,18,83.3,14,38,52,32,8,5,14,21
332,LAC,0,240,46,85,54.1,6,20,30,40,65,61.54,18,22,81.8,11,25,36,26,4,4,10,19
333,POR,0,240,36,87,41.4,7,33,21.2,29,54,53.7,13,15,86.7,10,34,44,14,5,6,17,25
334,NYK,1,240,45,89,50.6,19,46,41.3,26,43,60.47,15,22,68.2,12,40,52,30,6,6,14,18
335,BOS,0,240,47,95,49.5,11,38,28.9,36,57,63.16,13,19,68.4,12,26,38,21,7,8,9,16
336,SAC,1,240,38,86,44.2,10,38,26.3,28,48,58.33,22,28,78.6,11,29,40,25,6,6,8,18
337,UTA,0,240,37,87,42.5,13,39,33.3,24,48,50,18,22,81.8,11,35,46,28,6,3,13,15
338,PHX,0,240,42,83,50.6,10,28,35.7,32,55,58.18,8,14,57.1,5,42,47,28,5,7,15,14
339,IND,0,240,59,107,55.1,18,36,50,41,71,57.75,9,16,56.3,10,30,40,39,6,4,11,31
340,PHI,1,240,48,90,53.3,18,37,48.6,30,53,56.6,7,9,77.8,12,25,37,32,7,10,8,18
341,GSW,0,240,38,85,44.7,14,36,38.9,24,49,48.98,20,26,76.9,7,34,41,23,8,3,13,19
342,DET,0,240,32,79,40.5,11,41,26.8,21,38,55.26,26,32,81.3,10,36,46,20,4,5,17,25
343,CLE,0,240,30,72,41.7,9,29,31,21,43,48.84,15,20,75,4,26,30,24,3,3,17,16
344,MIA,1,240,43,83,51.8,15,38,39.5,28,45,62.22,20,23,87,9,35,44,29,13,0,12,17
345,LAC,0,240,40,83,48.2,10,28,35.7,30,55,54.55,17,18,94.4,10,27,37,27,2,9,14,11
346,LAL,1,240,50,89,56.2,12,25,48,38,64,59.38,38,43,88.4,8,33,41,28,6,7,10,14
347,NOP,1,240,41,81,50.6,11,34,32.4,30,47,63.83,21,31,67.7,6,35,41,27,8,7,10,22
348,OKC,0,240,33,89,37.1,10,43,23.3,23,46,50,17,22,77.3,10,27,37,20,9,1,12,16
349,MIN,1,240,40,84,47.6,21,40,52.5,19,44,43.18,13,18,72.2,7,37,44,30,9,5,16,17
350,MIL,1,240,49,92,53.3,11,34,32.4,38,58,65.52,9,14,64.3,15,42,57,33,7,5,17,21
351,POR,0,240,43,93,46.2,10,28,35.7,33,65,50.77,15,17,88.2,14,31,45,27,8,8,16,24
352,SAS,0,240,40,85,47.1,9,33,27.3,31,52,59.62,17,21,81,8,26,34,27,6,6,15,9
353,CHA,0,240,35,84,41.7,11,39,28.2,24,45,53.33,10,14,71.4,11,28,39,25,3,4,15,9
354,HOU,1,240,54,97,55.7,27,49,55.1,27,48,56.25,12,14,85.7,12,32,44,31,7,3,9,26
355,ATL,1,240,50,90,55.6,20,42,47.6,30,48,62.5,12,14,85.7,11,32,43,40,9,5,9,14
356,SAC,1,240,38,87,43.7,15,40,37.5,23,47,48.94,18,21,85.7,6,36,42,26,6,5,7,19
357,UTA,0,240,40,89,44.9,11,37,29.7,29,52,55.77,28,33,84.8,12,28,40,24,2,4,10,11
358,BKN,0,240,34,76,44.7,12,34,35.3,22,42,52.38,13,15,86.7,8,33,41,26,5,6,15,15
359,PHX,1,240,56,94,59.6,11,24,45.8,45,70,64.29,8,10,80,7,32,39,38,11,5,10,18
360,BOS,1,240,44,86,51.2,21,48,43.8,23,38,60.53,15,17,88.2,12,29,41,28,5,3,12,9
361,DEN,1,240,41,91,45.1,8,24,33.3,33,67,49.25,24,33,72.7,19,30,49,25,8,9,14,17
362,TOR,0,240,40,94,42.6,8,33,24.2,32,61,52.46,21,26,80.8,13,29,42,27,9,7,12,20
363,NYK,1,240,42,97,43.3,15,40,37.5,27,57,47.37,6,12,50,16,31,47,25,10,4,10,15
364,CHI,0,240,47,82,57.3,9,24,37.5,38,58,65.52,10,11,90.9,3,26,29,36,7,3,7,18
365,WAS,1,240,44,92,47.8,11,35,31.4,33,57,57.89,13,19,68.4,16,39,55,28,7,8,18,18
366,ORL,0,240,42,88,47.7,10,35,28.6,32,53,60.38,13,18,72.2,12,37,49,27,5,3,13,20
367,IND,1,240,48,99,48.5,15,36,41.7,33,63,52.38,12,16,75,12,38,50,32,8,10,11,14
368,BOS,1,240,47,89,52.8,16,45,35.6,31,44,70.45,19,27,70.4,8,27,35,31,9,5,7,15
369,NOP,1,240,42,82,51.2,18,36,50,24,46,52.17,9,12,75,12,44,56,25,3,2,13,13
370,LAL,1,240,32,73,43.8,12,31,38.7,20,42,47.62,25,33,75.8,11,43,54,22,1,7,21,16
371,LAC,1,240,44,77,57.1,14,33,42.4,30,44,68.18,23,27,85.2,7,33,40,26,8,8,17,21
372,POR,0,240,45,93,48.4,12,33,36.4,33,60,55,15,25,60,15,26,41,29,11,1,10,19
373,OKC,1,240,48,95,50.5,12,32,37.5,36,63,57.14,15,19,78.9,13,33,46,27,17,5,16,20
374,TOR,0,240,40,76,52.6,11,30,36.7,29,46,63.04,12,17,70.6,5,31,36,34,12,3,27,18
375,MEM,1,240,33,82,40.2,12,34,35.3,21,48,43.75,21,31,67.7,9,42,51,18,10,4,18,17
376,DET,0,240,42,83,50.6,9,31,29,33,52,63.46,9,13,69.2,8,34,42,25,4,1,19,23
377,SAS,0,240,37,95,38.9,7,38,18.4,30,57,52.63,16,23,69.6,15,41,56,24,12,7,16,23
378,MIN,1,240,41,85,48.2,14,27,51.9,27,58,46.55,8,16,50,13,33,46,27,9,5,12,12
379,GSW,0,240,43,106,40.6,14,48,29.2,29,58,50,11,16,68.8,24,40,64,24,6,6,14,15
380,PHI,0,240,33,96,34.4,8,37,21.6,25,59,42.37,20,24,83.3,13,29,42,20,13,7,9,23
381,CLE,0,240,34,81,42,7,29,24.1,27,52,51.92,16,19,84.2,10,31,41,22,6,5,12,14
382,MIA,0,240,31,86,36,13,47,27.7,18,39,46.15,13,15,86.7,7,27,34,22,3,4,6,9
383,MIL,1,240,43,91,47.3,16,41,39,27,50,54,13,15,86.7,11,29,40,27,5,4,10,17
384,PHX,1,240,41,74,55.4,22,41,53.7,19,33,57.58,24,27,88.9,7,31,38,28,4,11,17,19
385,WAS,1,240,41,81,50.6,10,25,40,31,56,55.36,17,23,73.9,10,35,45,20,9,3,20,19
386,ORL,1,240,47,86,54.7,14,36,38.9,33,50,66,13,19,68.4,10,30,40,33,12,4,16,16
387,HOU,1,240,47,93,50.5,17,45,37.8,30,48,62.5,16,20,80,13,36,49,27,7,6,16,21
388,BKN,0,240,41,92,44.6,13,44,29.5,28,48,58.33,13,16,81.3,15,34,49,29,7,1,14,12
389,ATL,0,240,40,91,44,12,35,34.3,28,56,50,23,29,79.3,12,24,36,27,11,3,11,23
390,DAL,1,240,43,86,50,10,32,31.3,33,54,61.11,17,28,60.7,11,32,43,33,12,3,13,20
391,NYK,0,240,38,79,48.1,11,31,35.5,27,48,56.25,13,17,76.5,4,27,31,28,6,6,10,18
392,SAC,0,240,37,86,43,11,39,28.2,26,47,55.32,17,19,89.5,10,27,37,21,12,7,15,20
393,CHI,0,240,42,93,45.2,12,31,38.7,30,62,48.39,21,25,84,12,31,43,23,8,3,11,17
394,UTA,0,240,38,83,45.8,4,30,13.3,34,53,64.15,17,19,89.5,5,33,38,29,6,3,18,23
395,DEN,1,240,45,84,53.6,6,20,30,39,64,60.94,17,20,85,9,33,42,31,5,4,10,14
396,NOP,0,240,42,78,53.8,6,20,30,36,58,62.07,16,21,76.2,3,30,33,24,11,1,19,18
397,TOR,0,240,33,80,41.3,10,31,32.3,23,49,46.94,13,18,72.2,11,20,31,21,11,3,22,15
398,CLE,0,240,35,75,46.7,15,42,35.7,20,33,60.61,19,22,86.4,6,31,37,30,3,2,12,19
399,OKC,1,240,43,88,48.9,10,34,29.4,33,54,61.11,23,29,79.3,10,35,45,29,10,7,10,16
400,IND,1,240,50,88,56.8,11,29,37.9,39,59,66.1,11,18,61.1,5,35,40,38,13,6,13,16
401,PHX,1,240,45,90,50,19,39,48.7,26,51,50.98,6,8,75,14,41,55,34,7,12,23,18
402,PHI,0,240,41,95,43.2,13,37,35.1,28,58,48.28,7,18,38.9,13,27,40,33,12,7,11,12
403,MIL,0,240,45,84,53.6,17,35,48.6,28,49,57.14,12,14,85.7,9,32,41,20,3,6,15,25
404,LAC,1,240,45,86,52.3,13,31,41.9,32,55,58.18,13,15,86.7,8,34,42,29,15,7,12,13
405,MIA,1,240,38,83,45.8,13,36,36.1,25,47,53.19,18,19,94.7,7,30,37,19,7,2,8,20
406,POR,0,240,39,81,48.1,15,34,44.1,24,47,51.06,10,15,66.7,8,30,38,21,6,4,17,16
407,BOS,1,240,40,85,47.1,18,40,45,22,45,48.89,24,29,82.8,11,26,37,25,6,5,9,18
408,UTA,0,240,40,90,44.4,10,36,27.8,30,54,55.56,17,18,94.4,11,36,47,20,6,5,16,22
409,SAC,1,240,48,93,51.6,12,40,30,36,53,67.92,15,18,83.3,18,35,53,32,14,6,16,16
410,GSW,1,240,58,100,58,19,39,48.7,39,61,63.93,2,6,33.3,13,35,48,43,6,5,7,17
411,MEM,0,240,42,96,43.8,18,49,36.7,24,47,51.06,14,18,77.8,16,29,45,29,4,3,12,15
412,DET,0,240,37,90,41.1,5,23,21.7,32,67,47.76,24,30,80,12,34,46,23,8,1,15,14
413,BKN,0,240,31,84,36.9,12,40,30,19,44,43.18,17,22,77.3,14,28,42,19,6,4,14,13
414,WAS,0,240,42,98,42.9,15,39,38.5,27,59,45.76,15,20,75,17,27,44,24,6,2,11,27
415,HOU,1,240,47,91,51.6,13,39,33.3,34,52,65.38,30,36,83.3,12,35,47,25,6,11,7,15
416,CHA,0,240,38,79,48.1,9,29,31,29,50,58,7,9,77.8,4,26,30,19,8,1,17,13
417,MIN,0,240,42,88,47.7,12,35,34.3,30,53,56.6,16,23,69.6,8,29,37,25,10,7,7,16
418,ORL,1,240,44,81,54.3,12,34,35.3,32,47,68.09,12,13,92.3,10,31,41,32,10,6,18,10
419,DAL,1,240,44,91,48.4,10,30,33.3,34,61,55.74,15,17,88.2,3,37,40,31,6,3,9,18
420,NOP,1,240,42,83,50.6,10,34,29.4,32,49,65.31,10,13,76.9,11,37,48,29,7,5,14,19
421,DEN,1,240,42,81,51.9,14,27,51.9,28,54,51.85,17,22,77.3,11,38,49,26,5,1,17,19
422,SAS,0,240,39,89,43.8,14,39,35.9,25,50,50,15,21,71.4,9,39,48,31,6,10,16,14
423,PHI,1,240,37,85,43.5,13,36,36.1,24,49,48.98,11,12,91.7,7,39,46,23,7,12,12,16
424,MEM,0,265,37,98,37.8,13,38,34.2,24,60,40,24,30,80,15,34,49,22,13,7,14,23
425,DET,0,240,36,84,42.9,9,29,31,27,55,49.09,13,15,86.7,8,35,43,21,6,3,13,15
426,POR,0,240,40,88,45.5,8,28,28.6,32,60,53.33,19,25,76,13,30,43,21,7,5,13,24
427,UTA,0,240,39,84,46.4,14,32,43.8,25,52,48.08,12,14,85.7,14,33,47,25,6,3,17,13
428,CLE,1,240,38,80,47.5,12,32,37.5,26,48,54.17,20,28,71.4,9,30,39,27,8,4,14,18
429,MIA,0,240,35,89,39.3,12,33,36.4,23,56,41.07,9,14,64.3,11,38,49,23,8,3,15,13
430,CHI,1,240,41,93,44.1,11,33,33.3,30,60,50,17,21,81,13,27,40,26,9,5,9,21
431,LAL,1,240,52,90,57.8,15,36,41.7,37,54,68.52,17,20,85,4,44,48,39,6,4,9,15
432,IND,0,240,42,91,46.2,9,38,23.7,33,53,62.26,10,16,62.5,14,31,45,28,8,3,11,24
433,ATL,0,240,42,98,42.9,9,41,22,33,57,57.89,12,15,80,12,30,42,32,8,5,9,14
434,NYK,1,240,44,91,48.4,14,37,37.8,30,54,55.56,17,20,85,14,30,44,29,6,1,13,17
435,MIN,1,240,44,91,48.4,16,41,39,28,50,56,10,12,83.3,12,23,35,27,9,9,9,15
436,SAC,1,265,42,94,44.7,11,35,31.4,31,59,52.54,26,32,81.3,15,44,59,30,7,10,19,25
437,GSW,0,240,42,88,47.7,14,36,38.9,28,52,53.85,14,18,77.8,12,27,39,29,7,5,13,16
438,BOS,1,240,43,95,45.3,22,49,44.9,21,46,45.65,11,13,84.6,15,38,53,30,8,8,11,9
439,TOR,0,240,37,84,44,8,31,25.8,29,53,54.72,14,15,93.3,11,26,37,23,7,3,18,18
440,LAC,0,240,28,74,37.8,11,36,30.6,17,38,44.74,26,29,89.7,10,30,40,17,10,5,16,13
441,ORL,1,240,43,85,50.6,11,36,30.6,32,49,65.31,14,20,70,10,29,39,22,7,4,15,16
442,DET,0,240,38,83,45.8,14,36,38.9,24,47,51.06,11,14,78.6,7,37,44,24,4,7,12,19
443,MIL,1,240,51,94,54.3,24,41,58.5,27,53,50.94,14,14,100,10,25,35,35,11,2,11,12
444,PHX,0,240,51,87,58.6,14,33,42.4,37,54,68.52,13,15,86.7,7,32,39,36,7,5,14,16
445,DAL,1,240,42,100,42,9,35,25.7,33,65,50.77,14,21,66.7,22,38,60,22,5,5,12,21
446,WAS,0,240,41,89,46.1,10,34,29.4,31,55,56.36,12,14,85.7,10,30,40,24,3,5,16,20
447,MIA,1,240,40,89,44.9,12,35,34.3,28,54,51.85,12,16,75,11,36,47,24,7,2,10,11
448,ATL,1,240,41,84,48.8,17,34,50,24,50,48,11,12,91.7,10,35,45,32,10,7,16,22
449,DEN,0,240,37,84,44,12,28,42.9,25,56,44.64,19,22,86.4,6,31,37,26,7,6,8,16
450,BOS,1,240,43,87,49.4,24,50,48,19,37,51.35,20,24,83.3,12,31,43,30,9,6,15,17
451,BKN,0,265,47,102,46.1,8,31,25.8,39,71,54.93,13,19,68.4,11,37,48,29,13,5,12,20
452,SAS,1,265,46,99,46.5,9,37,24.3,37,62,59.68,21,23,91.3,13,37,50,30,6,10,18,17
453,UTA,0,240,38,83,45.8,6,26,23.1,32,57,56.14,18,21,85.7,10,41,51,23,4,5,16,14
454,NOP,1,240,52,97,53.6,13,33,39.4,39,64,60.94,9,10,90,10,29,39,36,8,5,10,13
455,CLE,0,240,37,82,45.1,12,38,31.6,25,44,56.82,17,20,85,7,38,45,22,6,7,16,12
456,BKN,0,240,33,77,42.9,10,25,40,23,52,44.23,24,31,77.4,12,33,45,18,8,3,21,18
457,CHA,0,240,37,82,45.1,10,31,32.3,27,51,52.94,14,18,77.8,12,28,40,21,11,4,16,21
458,POR,0,240,42,84,50,12,33,36.4,30,51,58.82,11,12,91.7,10,26,36,23,3,7,20,15
459,IND,1,240,50,105,47.6,6,30,20,44,75,58.67,15,16,93.8,17,33,50,21,13,4,13,23
460,CHI,1,240,49,85,57.6,8,24,33.3,41,61,67.21,21,29,72.4,12,39,51,33,9,4,15,16
461,HOU,1,240,47,98,48,15,42,35.7,32,56,57.14,8,12,66.7,11,37,48,28,9,7,10,19
462,MEM,0,240,37,81,45.7,18,44,40.9,19,37,51.35,20,26,76.9,7,29,36,34,7,4,14,20
463,WAS,0,240,36,84,42.9,13,32,40.6,23,52,44.23,13,22,59.1,9,23,32,27,12,7,16,21
464,PHI,1,240,36,81,44.4,13,41,31.7,23,40,57.5,24,25,96,10,31,41,25,9,4,16,23
465,NYK,1,240,37,86,43,11,39,28.2,26,47,55.32,13,16,81.3,10,42,52,19,8,9,16,21
466,SAC,0,240,30,85,35.3,10,37,27,20,48,41.67,21,26,80.8,11,31,42,22,7,5,12,20
467,OKC,1,240,45,87,51.7,12,35,34.3,33,52,63.46,16,21,76.2,8,37,45,25,7,8,12,19
468,LAL,0,240,47,92,51.1,12,34,35.3,35,58,60.34,15,18,83.3,8,31,39,32,3,4,10,13
469,MIN,1,240,44,93,47.3,19,41,46.3,25,52,48.08,12,15,80,7,37,44,31,8,6,9,16
470,GSW,1,240,51,97,52.6,14,34,41.2,37,63,58.73,12,15,80,14,31,45,38,3,4,7,19
471,MIA,1,240,43,91,47.3,7,34,20.6,36,57,63.16,15,21,71.4,9,35,44,23,14,6,8,16
472,NOP,1,240,42,87,48.3,13,35,37.1,29,52,55.77,15,20,75,9,31,40,28,8,2,9,21
473,UTA,1,240,46,90,51.1,14,36,38.9,32,54,59.26,18,20,90,10,39,49,24,6,7,13,21
474,TOR,0,240,38,81,46.9,14,34,41.2,24,47,51.06,13,20,65,9,31,40,24,11,4,16,24
475,PHX,1,240,40,87,46,11,38,28.9,29,49,59.18,16,20,80,10,47,57,31,3,3,10,20
476,DEN,1,240,49,89,55.1,10,25,40,39,64,60.94,9,12,75,7,33,40,37,13,5,13,20
477,LAC,0,240,37,77,48.1,12,33,36.4,25,44,56.82,18,19,94.7,5,32,37,18,6,8,15,17
478,ORL,1,240,40,80,50,14,31,45.2,26,49,53.06,19,22,86.4,6,33,39,25,7,4,15,15
479,SAS,0,240,37,81,45.7,11,29,37.9,26,52,50,21,27,77.8,12,32,44,23,6,4,17,13
480,CHA,0,240,35,94,37.2,6,37,16.2,29,57,50.88,20,27,74.1,12,36,48,20,6,3,5,16
481,ATL,0,240,41,92,44.6,20,39,51.3,21,53,39.62,20,27,74.1,11,30,41,32,7,5,9,16
482,DET,0,240,36,84,42.9,10,38,26.3,26,46,56.52,13,15,86.7,9,39,48,27,5,2,18,16
483,CHI,0,240,41,86,47.7,16,35,45.7,25,51,49.02,13,16,81.3,11,25,36,28,4,2,13,14
484,WAS,0,240,46,93,49.5,12,38,31.6,34,55,61.82,15,19,78.9,7,25,32,29,11,2,14,19
485,DAL,0,240,43,84,51.2,12,29,41.4,31,55,56.36,21,26,80.8,10,30,40,25,6,2,19,20
486,PHX,0,240,47,99,47.5,11,31,35.5,36,68,52.94,7,10,70,19,32,51,27,4,3,14,12
487,MIL,1,240,39,72,54.2,16,36,44.4,23,36,63.89,20,24,83.3,6,31,37,29,6,4,15,14
488,NYK,1,240,38,87,43.7,6,29,20.7,32,58,55.17,23,26,88.5,15,35,50,16,11,1,15,18
489,OKC,1,240,45,86,52.3,16,39,41,29,47,61.7,20,23,87,8,26,34,28,10,7,13,24
490,BOS,1,240,47,89,52.8,25,50,50,22,39,56.41,8,11,72.7,6,27,33,31,12,5,10,13
491,HOU,1,240,51,87,58.6,12,28,42.9,39,59,66.1,21,24,87.5,8,39,47,24,7,1,19,19
492,POR,0,240,34,84,40.5,11,33,33.3,23,51,45.1,14,16,87.5,13,32,45,19,10,2,18,19
493,PHI,0,240,39,79,49.4,17,35,48.6,22,44,50,10,14,71.4,6,24,30,20,6,4,13,18
494,LAC,1,240,48,80,60,20,40,50,28,40,70,10,14,71.4,6,29,35,32,9,2,10,16
495,CHA,1,240,44,82,53.7,13,36,36.1,31,46,67.39,9,13,69.2,6,29,35,26,12,7,20,11
496,TOR,0,240,41,93,44.1,9,36,25,32,57,56.14,13,19,68.4,3,34,37,32,13,8,11,20
497,MEM,0,240,36,85,42.4,16,40,40,20,45,44.44,10,11,90.9,16,30,46,24,12,5,24,19
498,DEN,1,240,40,82,48.8,11,33,33.3,29,49,59.18,9,13,69.2,7,34,41,24,4,2,10,13
499,ORL,1,240,40,77,51.9,14,32,43.8,26,45,57.78,20,26,76.9,6,28,34,29,6,6,13,20
500,NOP,0,240,35,80,43.8,4,22,18.2,31,58,53.45,21,26,80.8,7,36,43,22,7,6,12,13
501,ATL,0,240,38,88,43.2,14,39,35.9,24,49,48.98,12,18,66.7,13,25,38,19,11,6,15,23
502,CLE,1,240,47,92,51.1,20,45,44.4,27,47,57.45,2,3,66.7,8,38,46,38,4,4,12,18
503,GSW,0,240,37,92,40.2,9,28,32.1,28,64,43.75,16,19,84.2,15,27,42,19,9,3,17,20
504,BKN,0,240,38,81,46.9,7,26,26.9,31,55,56.36,23,27,85.2,8,24,32,21,7,4,13,19
505,IND,0,265,46,99,46.5,14,45,31.1,32,54,59.26,23,28,82.1,9,38,47,30,4,6,9,25
506,LAL,0,240,38,78,48.7,14,32,43.8,24,46,52.17,17,22,77.3,7,31,38,25,8,2,14,12
507,CHI,1,265,48,92,52.2,10,28,35.7,38,64,59.38,26,32,81.3,7,41,48,22,6,5,12,21
508,SAC,1,240,46,88,52.3,19,41,46.3,27,47,57.45,9,12,75,9,35,44,30,11,2,14,19
509,DET,1,240,39,88,44.3,11,30,36.7,28,58,48.28,24,31,77.4,11,47,58,27,7,7,22,21
510,MIA,0,240,34,80,42.5,5,21,23.8,29,59,49.15,15,18,83.3,8,34,42,18,5,2,9,13
511,POR,1,240,38,82,46.3,10,30,33.3,28,52,53.85,20,24,83.3,12,37,49,24,7,5,18,21
512,DAL,1,240,44,82,53.7,6,27,22.2,38,55,69.09,15,19,78.9,9,33,42,30,6,13,17,16
513,NYK,1,240,40,79,50.6,14,40,35,26,39,66.67,12,15,80,9,42,51,32,4,4,13,15
514,WAS,0,240,37,82,45.1,11,36,30.6,26,46,56.52,12,16,75,4,24,28,26,9,3,13,18
515,SAC,1,240,49,92,53.3,18,40,45,31,52,59.62,13,16,81.3,6,45,51,34,11,1,9,26
516,UTA,0,240,41,86,47.7,15,32,46.9,26,54,48.15,10,11,90.9,9,29,38,23,4,7,10,18
517,PHI,0,240,30,80,37.5,8,33,24.2,22,47,46.81,11,16,68.8,7,24,31,17,7,4,8,16
518,LAC,0,240,34,72,47.2,11,30,36.7,23,42,54.76,21,25,84,8,26,34,22,7,4,18,18
519,IND,1,240,48,89,53.9,9,28,32.1,39,61,63.93,16,19,84.2,4,39,43,34,8,10,9,11
520,BOS,1,240,43,92,46.7,20,49,40.8,23,43,53.49,17,19,89.5,14,32,46,25,5,8,9,14
521,HOU,1,240,37,80,46.3,10,32,31.3,27,48,56.25,19,21,90.5,8,28,36,21,10,5,13,19
522,SAS,0,240,39,82,47.6,11,36,30.6,28,46,60.87,12,14,85.7,10,32,42,30,9,5,15,20
523,MIL,0,240,30,82,36.6,7,39,17.9,23,43,53.49,27,35,77.1,10,34,44,23,3,2,13,18
524,MEM,1,240,42,94,44.7,8,33,24.2,34,61,55.74,17,21,81,17,36,53,27,8,7,18,19
525,MIN,1,240,48,94,51.1,12,33,36.4,36,61,59.02,10,14,71.4,19,29,48,26,11,6,11,20
526,OKC,0,240,43,99,43.4,14,37,37.8,29,62,46.77,11,15,73.3,13,37,50,24,5,4,13,16
527,DAL,1,240,51,93,54.8,13,41,31.7,38,52,73.08,12,15,80,10,39,49,33,10,6,6,17
528,CLE,0,240,40,84,47.6,15,46,32.6,25,38,65.79,16,19,84.2,10,27,37,30,9,0,13,18
529,GSW,1,240,46,93,49.5,12,27,44.4,34,66,51.52,8,12,66.7,10,35,45,28,7,4,14,19
530,TOR,0,240,47,93,50.5,11,30,36.7,36,63,57.14,14,17,82.4,11,31,42,30,6,4,12,16
531,DEN,1,240,52,95,54.7,10,29,34.5,42,66,63.64,11,18,61.1,11,31,42,36,8,8,9,14
532,SAS,0,240,39,93,41.9,14,37,37.8,25,56,44.64,10,15,66.7,13,37,50,27,6,10,15,15
533,DET,1,240,41,86,47.7,10,42,23.8,31,44,70.45,22,24,91.7,9,42,51,26,8,5,12,19
534,CHI,0,240,35,89,39.3,7,34,20.6,28,55,50.91,15,22,68.2,14,29,43,19,6,2,13,12
535,PHX,1,240,46,84,54.8,12,32,37.5,34,52,65.38,13,19,68.4,12,30,42,23,8,6,14,18
536,CHA,0,240,34,88,38.6,13,40,32.5,21,48,43.75,16,23,69.6,9,31,40,27,7,2,13,16
537,POR,0,240,39,87,44.8,10,28,35.7,29,59,49.15,11,11,100,9,29,38,23,3,5,11,11
538,BOS,1,240,49,100,49,15,40,37.5,34,60,56.67,8,12,66.7,14,31,45,34,7,10,3,11
539,MIL,1,240,43,87,49.4,17,38,44.7,26,49,53.06,21,27,77.8,7,34,41,28,5,6,7,15
540,CLE,0,240,37,76,48.7,14,32,43.8,23,44,52.27,13,20,65,5,26,31,25,8,4,12,17
541,LAC,0,240,47,104,45.2,14,47,29.8,33,57,57.89,9,10,90,17,35,52,30,3,9,10,23
542,BKN,1,240,42,79,53.2,18,35,51.4,24,44,54.55,18,20,90,8,32,40,33,7,3,15,17
543,MIA,0,240,43,95,45.3,10,33,30.3,33,62,53.23,12,18,66.7,16,35,51,20,9,6,13,18
544,MIN,0,240,41,97,42.3,16,46,34.8,25,51,49.02,11,13,84.6,11,27,38,27,8,6,12,18
545,OKC,1,240,49,93,52.7,21,47,44.7,28,46,60.87,5,5,100,8,38,46,36,8,6,10,18
546,SAC,0,240,39,86,45.3,6,32,18.8,33,54,61.11,20,23,87,7,37,44,24,10,5,13,20
547,IND,1,240,38,78,48.7,8,23,34.8,30,55,54.55,27,33,81.8,5,41,46,20,5,10,13,21
548,MEM,0,240,32,78,41,11,33,33.3,21,45,46.67,18,27,66.7,8,31,39,21,8,4,16,14
549,NYK,0,240,26,80,32.5,9,40,22.5,17,40,42.5,12,16,75,16,34,50,19,9,5,21,14
550,WAS,1,240,39,81,48.1,16,39,41,23,42,54.76,16,22,72.7,6,34,40,35,5,5,15,18
551,PHI,1,240,31,80,38.8,9,30,30,22,50,44,8,14,57.1,14,33,47,20,9,5,15,18
552,ATL,0,240,38,91,41.8,17,46,37,21,45,46.67,10,13,76.9,12,29,41,28,6,4,11,15
553,NOP,1,240,43,75,57.3,14,27,51.9,29,48,60.42,16,22,72.7,4,39,43,32,8,7,12,10
554,LAL,1,240,44,83,53,10,24,41.7,34,59,57.63,22,29,75.9,14,42,56,29,9,4,21,12
555,ORL,0,240,33,88,37.5,9,36,25,24,52,46.15,22,29,75.9,13,33,46,18,7,3,13,27
556,HOU,1,240,39,84,46.4,12,29,41.4,27,55,49.09,22,27,81.5,6,36,42,23,8,1,12,18
557,SAS,1,240,44,86,51.2,17,33,51.5,27,53,50.94,21,28,75,12,37,49,34,6,6,14,22
558,POR,1,265,49,103,47.6,16,40,40,33,63,52.38,14,15,93.3,18,34,52,31,10,3,15,18
559,BKN,0,240,36,90,40,14,42,33.3,22,48,45.83,13,17,76.5,16,25,41,22,4,2,16,14
560,TOR,0,265,43,91,47.3,16,43,37.2,27,48,56.25,16,19,84.2,9,34,43,29,9,6,20,18
561,BOS,1,240,46,94,48.9,15,39,38.5,31,55,56.36,10,13,76.9,13,30,43,29,7,4,12,12
562,CHI,0,240,37,86,43,13,35,37.1,24,51,47.06,15,19,78.9,12,26,38,27,7,3,12,19
563,UTA,0,240,47,94,50,8,26,30.8,39,68,57.35,19,25,76,14,22,36,22,7,2,15,15
564,GSW,0,240,41,88,46.6,10,30,33.3,31,58,53.45,21,29,72.4,9,30,39,26,9,7,12,24
565,PHX,0,240,44,87,50.6,9,31,29,35,56,62.5,10,16,62.5,10,31,41,21,6,1,15,14
566,LAC,1,240,42,84,50,12,35,34.3,30,49,61.22,16,18,88.9,9,36,45,29,7,6,16,20
567,DET,0,240,45,99,45.5,13,37,35.1,32,62,51.61,21,25,84,20,36,56,27,8,4,20,26
568,CHA,1,240,44,81,54.3,11,30,36.7,33,51,64.71,11,15,73.3,9,36,45,26,9,3,17,18
569,DAL,1,240,51,92,55.4,14,38,36.8,37,54,68.52,26,32,81.3,4,32,36,29,13,8,14,18
570,DEN,1,240,55,83,66.3,19,32,59.4,36,51,70.59,13,16,81.3,5,27,32,40,8,10,14,22
571,MEM,0,240,30,74,40.5,10,26,38.5,20,48,41.67,22,30,73.3,10,28,38,21,10,11,13,19
572,MIL,0,240,46,93,49.5,16,41,39,30,52,57.69,14,17,82.4,6,37,43,28,3,2,8,17
573,WAS,1,240,43,87,49.4,6,33,18.2,37,54,68.52,20,23,87,10,44,54,25,5,11,11,20
574,MIA,0,240,38,82,46.3,11,29,37.9,27,53,50.94,13,18,72.2,7,36,43,24,6,5,11,16
575,NOP,1,240,35,79,44.3,11,31,35.5,24,48,50,22,23,95.7,9,39,48,22,7,10,14,18
576,POR,0,240,37,89,41.6,16,35,45.7,21,54,38.89,17,25,68,19,30,49,22,5,5,17,16
577,OKC,1,240,42,89,47.2,12,38,31.6,30,51,58.82,11,13,84.6,9,36,45,28,5,8,9,16
578,PHI,0,240,35,88,39.8,9,37,24.3,26,51,50.98,16,20,80,13,29,42,21,8,7,12,19
579,MIN,0,265,39,94,41.5,8,30,26.7,31,64,48.44,18,22,81.8,7,38,45,25,5,5,14,25
580,HOU,1,240,45,94,47.9,14,37,37.8,31,57,54.39,19,26,73.1,14,33,47,33,12,10,7,15
581,CLE,1,265,38,88,43.2,11,34,32.4,27,54,50,26,36,72.2,10,36,46,27,7,8,13,20
582,ORL,0,240,27,79,34.2,6,26,23.1,21,53,39.62,14,20,70,12,25,37,12,7,10,14,12
583,LAL,1,240,47,90,52.2,16,34,47.1,31,56,55.36,13,19,68.4,4,34,38,27,2,7,5,16
584,ATL,1,240,37,87,42.5,15,35,42.9,22,52,42.31,10,15,66.7,15,32,47,21,9,5,16,20
585,NYK,1,240,38,79,48.1,16,33,48.5,22,46,47.83,6,8,75,11,32,43,20,7,10,16,14
586,CHA,0,240,40,100,40,9,42,21.4,31,58,53.45,11,15,73.3,13,35,48,18,6,5,7,19
587,SAC,1,240,52,102,51,10,32,31.3,42,70,60,17,18,94.4,14,32,46,31,8,3,13,15
588,SAS,0,240,46,91,50.5,16,33,48.5,30,58,51.72,21,21,100,9,28,37,39,8,4,12,20
589,BOS,0,240,41,91,45.1,11,38,28.9,30,53,56.6,16,25,64,13,34,47,24,6,3,12,18
590,TOR,0,240,43,94,45.7,16,44,36.4,27,50,54,11,15,73.3,9,27,36,30,5,2,9,20
591,CHI,1,240,46,87,52.9,16,36,44.4,30,51,58.82,17,23,73.9,7,33,40,29,6,5,14,22
592,BKN,0,240,41,84,48.8,17,41,41.5,24,43,55.81,13,18,72.2,4,24,28,24,12,4,14,17
593,DEN,1,240,45,90,50,4,21,19,41,69,59.42,21,22,95.5,8,37,45,27,10,4,8,19
594,IND,0,240,42,82,51.2,10,26,38.5,32,56,57.14,17,23,73.9,7,32,39,26,5,10,15,24
595,MIA,0,240,40,82,48.8,17,38,44.7,23,44,52.27,11,17,64.7,2,35,37,30,7,2,12,20
596,GSW,0,240,44,97,45.4,11,42,26.2,33,55,60,23,28,82.1,13,35,48,31,8,2,11,22
597,PHX,1,240,44,86,51.2,15,35,42.9,29,51,56.86,17,20,85,10,39,49,29,6,6,16,16
598,DAL,1,240,40,87,46,16,41,39,24,46,52.17,18,23,78.3,10,35,45,27,5,6,10,16
599,DET,1,240,43,82,52.4,12,30,40,31,52,59.62,20,21,95.2,13,37,50,24,7,4,23,18
600,MIN,1,240,46,98,46.9,7,25,28,39,73,53.42,14,19,73.7,13,35,48,23,9,6,11,20
601,MEM,1,240,41,91,45.1,13,37,35.1,28,54,51.85,20,23,87,15,39,54,21,3,15,15,14
602,CLE,0,240,39,89,43.8,10,44,22.7,29,45,64.44,13,17,76.5,10,32,42,27,5,4,15,16
603,POR,0,240,41,81,50.6,14,34,41.2,27,47,57.45,24,27,88.9,7,25,32,27,10,2,17,28
604,HOU,0,240,45,94,47.9,16,37,43.2,29,57,50.88,10,17,58.8,13,25,38,33,6,2,8,21
605,PHI,0,240,39,102,38.2,13,35,37.1,26,67,38.81,18,21,85.7,17,30,47,25,11,9,11,21
606,ATL,1,240,43,84,51.2,11,30,36.7,32,54,59.26,15,20,75,8,34,42,27,7,3,11,17
607,LAL,0,240,42,81,51.9,15,32,46.9,27,49,55.1,21,25,84,3,31,34,25,4,5,14,14
608,UTA,0,240,44,96,45.8,15,47,31.9,29,49,59.18,14,16,87.5,14,31,45,28,4,7,10,14
609,MIL,0,240,34,89,38.2,11,39,28.2,23,50,46,11,15,73.3,6,30,36,19,8,5,15,10
610,GSW,1,240,51,91,56,19,39,48.7,32,52,61.54,4,7,57.1,8,42,50,37,10,13,16,13
611,ORL,1,240,44,81,54.3,12,26,46.2,32,55,58.18,19,21,90.5,9,33,42,21,4,5,15,14
612,CHI,1,240,45,90,50,17,39,43.6,28,51,54.9,12,15,80,7,32,39,29,7,4,9,13
613,OKC,1,240,43,74,58.1,9,22,40.9,34,52,65.38,33,39,84.6,7,32,39,23,10,5,18,18
614,WAS,0,240,40,88,45.5,12,38,31.6,28,50,56,17,20,85,9,26,35,26,7,4,9,20
615,LAC,1,240,44,80,55,12,29,41.4,32,51,62.75,22,26,84.6,8,33,41,19,5,8,9,17
616,SAC,1,240,54,97,55.7,12,31,38.7,42,66,63.64,10,12,83.3,9,37,46,32,8,2,14,23
617,MIA,1,240,42,85,49.4,14,31,45.2,28,54,51.85,20,23,87,8,34,42,27,7,5,9,14
618,CHA,0,240,33,72,45.8,12,33,36.4,21,39,53.85,11,11,100,3,28,31,19,7,1,19,19
619,DAL,0,240,45,93,48.4,13,39,33.3,32,54,59.26,17,21,81,9,32,41,23,5,6,9,23
620,SAS,0,240,38,87,43.7,12,36,33.3,26,51,50.98,13,16,81.3,12,38,50,24,1,10,19,12
621,ORL,1,240,40,74,54.1,13,35,37.1,27,39,69.23,8,15,53.3,8,33,41,23,9,1,18,16
622,PHX,1,265,42,96,43.8,15,34,44.1,27,62,43.55,18,22,81.8,11,41,52,32,9,7,10,19
623,BKN,1,240,41,84,48.8,12,30,40,29,54,53.7,18,24,75,10,34,44,25,4,7,14,16
624,PHI,0,240,40,82,48.8,12,28,42.9,28,54,51.85,15,19,78.9,8,30,38,25,6,2,12,24
625,ATL,1,240,44,87,50.6,10,31,32.3,34,56,60.71,18,23,78.3,13,38,51,26,6,5,16,13
626,NYK,0,240,38,99,38.4,16,52,30.8,22,47,46.81,8,11,72.7,17,23,40,27,8,6,12,18
627,DET,0,240,39,89,43.8,12,42,28.6,27,47,57.45,20,22,90.9,10,32,42,26,5,3,11,16
628,TOR,0,240,36,93,38.7,13,44,29.5,23,49,46.94,13,22,59.1,11,34,45,21,6,7,12,11
629,CLE,1,240,39,90,43.3,20,42,47.6,19,48,39.58,7,11,63.6,8,34,42,28,11,3,9,10
630,NOP,1,240,53,105,50.5,24,49,49,29,56,51.79,9,11,81.8,17,45,62,38,9,5,11,19
631,HOU,1,240,49,105,46.7,9,34,26.5,40,71,56.34,7,11,63.6,16,35,51,23,15,5,7,15
632,IND,1,240,50,93,53.8,18,39,46.2,32,54,59.26,19,24,79.2,9,34,43,34,3,2,9,21
633,BOS,0,240,39,93,41.9,15,38,39.5,24,55,43.64,11,12,91.7,14,39,53,24,6,9,13,13
634,DEN,0,265,41,96,42.7,15,40,37.5,26,56,46.43,10,14,71.4,10,41,51,25,6,6,15,15
635,CHI,1,240,42,84,50,11,32,34.4,31,52,59.62,18,22,81.8,7,25,32,28,9,2,10,17
636,LAL,1,240,41,80,51.3,16,34,47.1,25,46,54.35,18,25,72,12,43,55,29,8,7,21,15
637,MIN,1,240,40,79,50.6,11,28,39.3,29,51,56.86,28,37,75.7,12,28,40,28,9,7,11,17
638,WAS,0,240,40,94,42.6,16,38,42.1,24,56,42.86,19,23,82.6,10,33,43,26,6,3,15,15
639,BKN,0,240,35,79,44.3,15,42,35.7,20,37,54.05,17,30,56.7,12,21,33,27,10,6,13,20
640,POR,0,240,45,92,48.9,16,39,41,29,53,54.72,8,11,72.7,12,29,41,28,5,3,14,26
641,UTA,1,240,49,101,48.5,16,40,40,33,61,54.1,13,15,86.7,11,40,51,29,6,9,13,16
642,MIL,1,240,37,78,47.4,15,38,39.5,22,40,55,24,28,85.7,7,39,46,20,8,3,12,20
643,LAC,0,240,37,84,44,16,40,40,21,44,47.73,16,25,64,5,33,38,25,9,3,14,21
644,OKC,0,240,37,94,39.4,15,39,38.5,22,55,40,15,16,93.8,13,25,38,22,12,7,10,20
645,MEM,1,240,38,82,46.3,12,37,32.4,26,45,57.78,18,22,81.8,15,35,50,26,6,3,19,22
646,SAC,0,240,41,92,44.6,11,37,29.7,30,55,54.55,16,18,88.9,20,31,51,29,6,6,18,22
647,BOS,1,240,53,96,55.2,25,49,51,28,47,59.57,9,11,81.8,7,44,51,35,10,5,8,19
648,IND,0,240,41,93,44.1,6,30,20,35,63,55.56,17,21,81,14,28,42,20,9,4,12,14
649,CHA,0,240,43,92,46.7,8,27,29.6,35,65,53.85,12,16,75,11,34,45,24,8,6,17,15
650,LAC,1,240,32,85,37.6,10,34,29.4,22,51,43.14,15,17,88.2,7,33,40,17,7,5,9,12
651,NYK,1,240,42,86,48.8,16,39,41,26,47,55.32,7,10,70,10,37,47,32,8,9,12,13
652,ORL,1,240,43,72,59.7,7,23,30.4,36,49,73.47,20,25,80,7,41,48,24,7,6,22,16
653,SAS,1,240,46,85,54.1,10,25,40,36,60,60,15,19,78.9,10,35,45,33,6,8,16,17
654,DET,0,240,33,86,38.4,8,36,22.2,25,50,50,17,20,85,5,23,28,25,11,2,12,19
655,GSW,0,240,36,92,39.1,7,41,17.1,29,51,56.86,9,13,69.2,12,34,46,24,2,3,17,13
656,PHI,1,240,40,88,45.5,11,37,29.7,29,51,56.86,29,31,93.5,13,29,42,26,10,5,9,19
657,DAL,0,240,40,86,46.5,16,41,39,24,45,53.33,20,23,87,12,33,45,20,6,2,17,18
658,CLE,0,240,39,87,44.8,17,44,38.6,22,43,51.16,3,8,37.5,10,29,39,31,7,5,11,11
659,PHX,0,240,40,91,44,14,39,35.9,26,52,50,16,18,88.9,15,35,50,26,2,7,22,15
660,OKC,1,240,49,102,48,9,31,29,40,71,56.34,11,15,73.3,10,31,41,21,16,8,6,15
661,TOR,1,240,42,91,46.2,13,38,34.2,29,53,54.72,14,18,77.8,11,34,45,27,8,6,16,16
662,MIN,0,240,31,80,38.8,9,33,27.3,22,47,46.81,17,18,94.4,12,42,54,24,4,7,15,14
663,HOU,1,240,42,96,43.8,16,42,38.1,26,54,48.15,18,26,69.2,13,36,49,27,13,3,13,22
664,MEM,0,265,30,83,36.1,15,40,37.5,15,43,34.88,25,33,75.8,9,36,45,21,15,9,24,17
665,PHX,0,240,39,85,45.9,9,29,31,30,56,53.57,22,29,75.9,9,38,47,23,6,6,19,17
666,ATL,0,240,37,87,42.5,11,34,32.4,26,53,49.06,17,23,73.9,12,30,42,23,4,4,12,19
667,POR,1,265,39,92,42.4,11,35,31.4,28,57,49.12,18,24,75,13,37,50,23,8,5,23,25
668,UTA,0,240,42,87,48.3,14,35,40,28,52,53.85,22,26,84.6,12,30,42,24,3,5,11,19
669,DEN,1,240,54,92,58.7,11,26,42.3,43,66,65.15,5,7,71.4,11,36,47,34,5,7,10,8
670,MIA,1,240,46,88,52.3,13,34,38.2,33,54,61.11,21,25,84,8,26,34,33,6,6,6,20
671,LAL,0,240,47,89,52.8,12,29,41.4,35,60,58.33,8,11,72.7,6,25,31,33,5,4,7,9
672,BKN,1,240,41,88,46.6,15,32,46.9,26,56,46.43,17,22,77.3,12,33,45,28,6,8,11,19
673,NOP,1,240,48,86,55.8,15,32,46.9,33,54,61.11,18,26,69.2,11,36,47,25,9,4,17,17
674,IND,0,240,40,95,42.1,10,32,31.3,30,63,47.62,12,18,66.7,17,27,44,25,9,8,16,21
675,MIN,0,265,42,85,49.4,12,31,38.7,30,54,55.56,24,32,75,8,36,44,29,4,5,13,22
676,SAC,1,265,50,100,50,11,29,37.9,39,71,54.93,13,24,54.2,14,31,45,29,8,6,8,29
677,MIL,1,240,37,86,43,15,46,32.6,22,40,55,24,32,75,11,38,49,22,7,4,7,18
678,DAL,0,240,44,94,46.8,9,34,26.5,35,60,58.33,13,18,72.2,10,32,42,20,4,4,8,12
679,TOR,0,240,41,95,43.2,12,45,26.7,29,50,58,11,17,64.7,11,36,47,31,9,2,14,14
680,PHI,1,240,46,96,47.9,19,44,43.2,27,52,51.92,10,11,90.9,15,33,48,38,5,7,7,17
681,BOS,1,240,52,94,55.3,21,43,48.8,31,51,60.78,13,13,100,9,38,47,33,4,8,9,15
682,CHA,0,240,43,84,51.2,14,33,42.4,29,51,56.86,14,17,82.4,7,25,32,24,5,6,5,13
683,CHI,0,240,36,86,41.9,11,27,40.7,25,59,42.37,14,16,87.5,7,37,44,25,4,2,12,21
684,GSW,1,240,44,98,44.9,18,44,40.9,26,54,48.15,14,18,77.8,15,41,56,26,10,5,14,14
685,LAC,1,240,54,94,57.4,13,32,40.6,41,62,66.13,19,25,76,9,40,49,32,5,7,9,13
686,CLE,1,240,33,83,39.8,18,41,43.9,15,42,35.71,26,30,86.7,12,41,53,25,7,6,16,20
687,DET,0,240,33,89,37.1,10,36,27.8,23,53,43.4,24,28,85.7,9,33,42,24,10,7,9,23
688,MEM,0,240,35,79,44.3,9,24,37.5,26,55,47.27,13,22,59.1,8,22,30,15,6,8,23,17
689,POR,1,240,48,92,52.2,13,31,41.9,35,61,57.38,13,16,81.3,16,30,46,31,13,8,14,20
690,WAS,0,240,46,98,46.9,12,34,35.3,34,64,53.12,11,15,73.3,9,30,39,29,5,3,10,17
691,UTA,0,240,34,80,42.5,16,37,43.2,18,43,41.86,23,28,82.1,7,30,37,25,8,1,13,22
692,ORL,1,240,42,77,54.5,10,30,33.3,32,47,68.09,21,31,67.7,10,35,45,27,9,6,15,20
693,ATL,0,240,37,86,43,8,28,28.6,29,58,50,15,21,71.4,8,31,39,18,3,8,14,14
694,HOU,0,240,33,99,33.3,11,45,24.4,22,54,40.74,28,31,90.3,19,39,58,14,8,5,13,29
695,MIL,1,240,39,86,45.3,16,39,41,23,47,48.94,17,20,85,8,36,44,21,9,3,8,18
696,GSW,1,240,44,98,44.9,14,44,31.8,30,54,55.56,8,16,50,16,37,53,26,8,5,11,19
697,CHA,0,240,36,82,43.9,12,39,30.8,24,43,55.81,15,20,75,9,33,42,24,3,3,13,18
698,LAL,1,265,53,101,52.5,8,23,34.8,45,78,57.69,20,24,83.3,7,38,45,30,6,6,11,16
699,WAS,0,265,52,102,51,17,41,41.5,35,61,57.38,10,12,83.3,10,35,45,35,6,6,15,19
700,PHX,1,240,36,89,40.4,13,37,35.1,23,52,44.23,25,37,67.6,14,37,51,20,6,6,14,21
701,SAS,1,240,48,91,52.7,19,39,48.7,29,52,55.77,17,20,85,11,34,45,39,6,8,12,20
702,MIA,0,240,35,83,42.2,7,26,26.9,28,57,49.12,20,24,83.3,9,36,45,21,10,1,15,16
703,DEN,1,240,36,84,42.9,12,34,35.3,24,50,48,19,21,90.5,9,32,41,22,10,8,15,23
704,OKC,0,240,44,89,49.4,9,31,29,35,58,60.34,21,22,95.5,7,30,37,20,6,2,11,15
705,NYK,0,240,35,95,36.8,12,39,30.8,23,56,41.07,17,24,70.8,17,39,56,23,7,3,13,15
706,BKN,1,240,46,90,51.1,22,46,47.8,24,44,54.55,10,13,76.9,8,35,43,30,6,4,10,16
707,TOR,0,240,46,98,46.9,13,35,37.1,33,63,52.38,20,30,66.7,12,32,44,34,11,3,12,21
708,MIN,1,240,39,79,49.4,14,35,40,25,44,56.82,18,22,81.8,5,34,39,29,4,13,14,19
709,DEN,1,240,46,86,53.5,15,35,42.9,31,51,60.78,10,11,90.9,5,38,43,35,10,6,16,17
710,LAC,0,240,45,89,50.6,10,37,27,35,52,67.31,12,16,75,9,27,36,29,10,1,14,17
711,DAL,1,240,52,96,54.2,15,43,34.9,37,53,69.81,17,21,81,11,39,50,32,7,10,16,20
712,LAL,1,240,47,86,54.7,14,36,38.9,33,50,66,8,10,80,8,31,39,28,6,5,17,12
713,MEM,0,240,36,93,38.7,11,37,29.7,25,56,44.64,18,20,90,17,33,50,23,8,5,15,22
714,CHI,1,290,44,110,40,13,37,35.1,31,73,42.47,31,38,81.6,25,49,74,29,6,8,19,18
715,IND,1,240,50,102,49,14,38,36.8,36,64,56.25,9,9,100,14,36,50,34,5,9,10,21
716,CLE,0,290,45,104,43.3,22,54,40.7,23,50,46,11,19,57.9,5,34,39,37,7,11,12,25
717,SAC,0,240,38,95,40,12,35,34.3,26,60,43.33,8,13,61.5,15,28,43,28,8,5,14,14
718,NOP,0,240,42,90,46.7,11,29,37.9,31,61,50.82,19,23,82.6,7,33,40,26,2,4,10,12
719,CHI,0,240,39,98,39.8,2,29,6.9,37,69,53.62,15,18,83.3,15,24,39,22,11,3,6,18
720,POR,0,240,35,86,40.7,10,31,32.3,25,55,45.45,16,19,84.2,15,25,40,24,9,4,18,25
721,OKC,1,240,44,93,47.3,10,27,37,34,66,51.52,14,18,77.8,12,43,55,19,7,8,15,14
722,BOS,1,240,39,74,52.7,5,22,22.7,34,52,65.38,34,37,91.9,9,47,56,21,7,9,14,16
723,SAS,0,240,39,82,47.6,16,41,39,23,41,56.1,11,15,73.3,7,34,41,28,9,7,23,15
724,UTA,0,240,35,94,37.2,11,38,28.9,24,56,42.86,16,19,84.2,12,31,43,24,11,4,18,15
725,ATL,1,240,46,93,49.5,12,32,37.5,34,61,55.74,20,23,87,15,40,55,27,8,8,18,15
726,BKN,0,240,31,79,39.2,8,31,25.8,23,48,47.92,11,14,78.6,9,26,35,18,10,1,22,22
727,CLE,1,240,44,83,53,20,40,50,24,43,55.81,13,18,72.2,9,38,47,35,2,4,16,12
728,CHA,0,240,30,81,37,11,40,27.5,19,41,46.34,14,17,82.4,5,32,37,24,6,2,13,16
729,PHI,0,240,37,94,39.4,14,42,33.3,23,52,44.23,11,12,91.7,8,20,28,20,6,5,10,23
730,WAS,0,240,46,93,49.5,12,35,34.3,34,58,58.62,8,10,80,11,30,41,34,5,5,21,12
731,DET,1,240,37,75,49.3,14,37,37.8,23,38,60.53,17,23,73.9,8,39,47,22,3,8,20,19
732,MIN,1,240,43,93,46.2,13,31,41.9,30,62,48.39,15,17,88.2,11,35,46,28,16,8,14,14
733,HOU,0,240,37,95,38.9,9,39,23.1,28,56,50,12,18,66.7,12,34,46,22,5,8,15,16
734,NYK,0,240,31,83,37.3,14,46,30.4,17,37,45.95,16,23,69.6,13,25,38,27,6,5,13,20
735,ORL,1,240,39,74,52.7,9,25,36,30,49,61.22,21,25,84,5,33,38,20,14,2,19,22
736,NOP,1,240,39,77,50.6,18,34,52.9,21,43,48.84,19,23,82.6,10,34,44,23,4,5,15,21
737,GSW,1,240,47,94,50,21,46,45.7,26,48,54.17,8,11,72.7,9,35,44,39,12,6,19,11
738,DAL,0,240,48,91,52.7,14,33,42.4,34,58,58.62,9,15,60,5,31,36,23,11,6,5,12
739,MIA,1,240,37,70,52.9,14,26,53.8,23,44,52.27,18,26,69.2,6,28,34,29,8,8,20,19
740,MIL,1,240,46,89,51.7,16,40,40,30,49,61.22,15,18,83.3,11,40,51,29,7,3,10,17
741,IND,0,240,46,100,46,13,42,31,33,58,56.9,17,23,73.9,13,30,43,27,8,5,10,19
742,BKN,1,240,44,90,48.9,15,42,35.7,29,48,60.42,8,14,57.1,12,34,46,32,5,5,10,24
743,MEM,0,240,29,75,38.7,7,26,26.9,22,49,44.9,21,26,80.8,8,32,40,16,6,4,15,13
744,DET,0,240,38,79,48.1,14,30,46.7,24,49,48.98,21,26,80.8,10,32,42,25,9,6,17,15
745,SAC,0,240,45,85,52.9,13,32,40.6,32,53,60.38,7,12,58.3,11,30,41,30,10,5,15,20
746,MIA,1,240,45,87,51.7,11,30,36.7,34,57,59.65,20,25,80,10,29,39,27,12,3,11,12
747,TOR,1,240,53,96,55.2,12,28,42.9,41,68,60.29,12,17,70.6,12,33,45,35,4,7,12,17
748,NYK,1,240,41,92,44.6,15,39,38.5,26,53,49.06,16,21,76.2,15,29,44,31,9,4,14,16
749,UTA,1,240,46,90,51.1,17,35,48.6,29,55,52.73,19,22,86.4,5,33,38,36,13,8,17,17
750,OKC,1,240,46,97,47.4,17,35,48.6,29,62,46.77,14,15,93.3,10,38,48,30,12,8,12,22
751,SAS,0,240,42,91,46.2,13,31,41.9,29,60,48.33,12,19,63.2,10,36,46,34,8,11,20,17
752,DEN,1,240,43,88,48.9,11,32,34.4,32,56,57.14,22,26,84.6,12,33,45,29,10,5,10,20
753,DAL,0,240,41,87,47.1,14,31,45.2,27,56,48.21,15,21,71.4,8,30,38,15,9,4,16,13
754,GSW,0,240,35,81,43.2,11,34,32.4,24,47,51.06,22,29,75.9,11,31,42,27,5,3,17,18
755,PHX,1,240,44,93,47.3,17,40,42.5,27,53,50.94,18,19,94.7,14,37,51,32,6,9,15,12
756,ORL,0,240,35,84,41.7,14,38,36.8,21,46,45.65,8,18,44.4,14,37,51,23,7,9,20,19
757,NOP,0,240,40,88,45.5,16,41,39,24,47,51.06,10,14,71.4,12,37,49,25,5,7,19,17
758,ATL,1,240,41,90,45.6,12,29,41.4,29,61,47.54,15,17,88.2,9,35,44,31,10,3,10,17
759,SAC,1,240,45,91,49.5,15,37,40.5,30,54,55.56,18,22,81.8,14,27,41,29,10,1,10,15
760,HOU,0,240,38,93,40.9,16,41,39,22,52,42.31,18,23,78.3,13,37,50,18,6,7,18,16
761,CHI,1,240,41,95,43.2,13,40,32.5,28,55,50.91,19,21,90.5,12,37,49,29,12,0,11,15
762,LAL,0,240,47,90,52.2,15,35,42.9,32,55,58.18,4,8,50,3,31,34,28,7,4,12,14
763,LAC,0,240,40,82,48.8,8,27,29.6,32,55,58.18,19,20,95,10,29,39,23,7,2,16,14
764,PHI,0,240,36,97,37.1,16,46,34.8,20,51,39.22,10,11,90.9,13,28,41,24,12,5,10,18
765,CLE,1,240,42,83,50.6,10,32,31.3,32,51,62.75,20,27,74.1,6,41,47,35,6,6,11,16
766,POR,0,240,33,95,34.7,3,32,9.4,30,63,47.62,11,16,68.8,22,34,56,14,11,4,16,16
767,MIL,1,240,43,79,54.4,18,37,48.6,25,42,59.52,15,18,83.3,7,40,47,32,6,10,19,13
768,CHA,1,240,37,75,49.3,7,24,29.2,30,51,58.82,12,17,70.6,4,37,41,24,12,6,19,12
769,IND,1,240,52,93,55.9,14,36,38.9,38,57,66.67,15,17,88.2,6,40,46,38,12,0,15,16
770,WAS,0,240,40,90,44.4,12,40,30,28,50,56,13,18,72.2,4,36,40,29,6,2,9,22
771,NYK,0,240,37,82,45.1,13,38,34.2,24,44,54.55,15,16,93.8,15,24,39,21,1,3,14,15
772,BOS,1,240,46,81,56.8,15,35,42.9,31,46,67.39,9,12,75,11,25,36,27,8,4,7,16
773,ORL,1,240,43,87,49.4,12,24,50,31,63,49.21,14,21,66.7,13,33,46,25,9,9,13,15
774,BKN,0,240,35,104,33.7,6,35,17.1,29,69,42.03,10,11,90.9,16,40,56,20,7,2,11,17
775,DET,0,240,43,85,50.6,14,31,45.2,29,54,53.7,9,13,69.2,7,29,36,29,7,7,12,21
776,MIN,1,240,36,84,42.9,12,38,31.6,24,46,52.17,17,23,73.9,6,45,51,22,6,9,13,14
777,GSW,1,240,38,89,42.7,13,42,31,25,47,53.19,8,10,80,13,40,53,28,7,7,22,15
778,OKC,1,240,55,92,59.8,20,40,50,35,52,67.31,17,21,81,8,48,56,30,5,9,15,22
779,CHA,0,240,32,88,36.4,11,39,28.2,21,49,42.86,9,11,81.8,13,30,43,21,13,6,19,15
780,NOP,0,240,39,104,37.5,7,32,21.9,32,72,44.44,10,13,76.9,18,36,54,20,6,7,11,19
781,DEN,1,240,50,85,58.8,13,33,39.4,37,52,71.15,14,22,63.6,11,34,45,38,8,6,13,17
782,POR,0,240,46,101,45.5,8,25,32,38,76,50,12,18,66.7,19,26,45,25,11,2,11,17
783,TOR,1,240,50,102,49,15,39,38.5,35,63,55.56,8,8,100,11,36,47,37,3,7,12,20
784,MEM,0,240,38,91,41.8,8,35,22.9,30,56,53.57,11,16,68.8,14,27,41,26,12,3,13,17
785,PHI,1,240,40,90,44.4,12,29,41.4,28,61,45.9,12,15,80,9,42,51,20,6,7,10,25
786,ATL,0,240,46,106,43.4,12,39,30.8,34,67,50.75,17,24,70.8,20,34,54,27,5,4,9,11
787,WAS,0,240,41,104,39.4,9,38,23.7,32,66,48.48,15,21,71.4,16,27,43,20,10,3,16,17
788,HOU,1,240,37,93,39.8,15,45,33.3,22,48,45.83,25,34,73.5,17,37,54,25,8,5,14,23
789,PHX,0,240,38,95,40,7,31,22.6,31,64,48.44,27,35,77.1,19,39,58,23,10,8,10,20
790,MIA,1,240,38,82,46.3,13,29,44.8,25,53,47.17,17,25,68,10,36,46,20,6,11,15,14
791,MIL,1,240,41,87,47.1,13,37,35.1,28,50,56,17,25,68,11,36,47,24,10,4,10,18
792,CLE,0,240,34,80,42.5,8,27,29.6,26,53,49.06,21,31,67.7,5,38,43,24,5,8,11,15
793,LAC,1,240,37,84,44,12,32,37.5,25,52,48.08,15,17,88.2,14,37,51,20,7,2,21,20
794,MIN,0,240,43,98,43.9,13,35,37.1,30,63,47.62,8,13,61.5,16,36,52,23,8,4,14,18
795,LAL,1,240,49,95,51.6,11,27,40.7,38,68,55.88,14,18,77.8,10,36,46,28,7,4,13,18
796,SAS,0,240,42,96,43.8,15,38,39.5,27,58,46.55,19,23,82.6,16,31,47,33,9,7,14,14
797,GSW,1,240,50,107,46.7,16,41,39,34,66,51.52,12,14,85.7,15,33,48,32,6,4,9,19
798,CHA,1,240,40,92,43.5,20,42,47.6,20,50,40,15,22,68.2,12,30,42,28,11,3,10,23
799,HOU,0,240,36,82,43.9,15,41,36.6,21,41,51.22,18,28,64.3,12,32,44,27,6,5,24,18
800,NYK,1,240,38,79,48.1,15,34,44.1,23,45,51.11,19,27,70.4,12,33,45,24,11,6,18,13
801,IND,1,240,50,94,53.2,13,30,43.3,37,64,57.81,16,19,84.2,7,35,42,36,10,5,14,15
802,NOP,1,240,50,96,52.1,16,41,39,34,55,61.82,11,18,61.1,9,34,43,35,16,6,14,21
803,DET,0,240,47,89,52.8,12,30,40,35,59,59.32,9,18,50,6,35,41,27,6,4,15,21
804,LAC,0,240,42,93,45.2,12,32,37.5,30,61,49.18,11,13,84.6,11,31,42,27,6,2,14,15
805,SAC,1,240,52,93,55.9,13,33,39.4,39,60,65,10,14,71.4,7,35,42,29,5,6,10,12
806,DAL,1,240,43,90,47.8,19,44,43.2,24,46,52.17,18,21,85.7,10,29,39,24,10,5,10,21
807,PHI,0,240,37,84,44,10,29,34.5,27,55,49.09,12,14,85.7,7,31,38,23,7,3,18,23
808,UTA,0,240,37,86,43,9,39,23.1,28,47,59.57,24,27,88.9,15,39,54,26,3,2,19,21
809,SAS,0,240,50,98,51,11,25,44,39,73,53.42,11,16,68.8,11,31,42,37,9,5,8,12
810,OKC,1,240,50,90,55.6,17,35,48.6,33,55,60,12,17,70.6,8,36,44,24,9,11,15,16
811,ORL,1,240,43,84,51.2,14,25,56,29,59,49.15,16,18,88.9,10,23,33,26,8,3,13,23
812,CHI,0,240,44,94,46.8,10,28,35.7,34,66,51.52,14,16,87.5,13,32,45,30,6,2,13,17
813,CLE,0,240,39,70,55.7,10,22,45.5,29,48,60.42,21,26,80.8,7,26,33,31,8,5,19,18
814,BKN,0,240,33,80,41.3,11,37,29.7,22,43,51.16,16,22,72.7,6,33,39,19,7,2,20,24
815,BOS,1,240,45,83,54.2,23,47,48.9,22,36,61.11,16,21,76.2,5,31,36,27,10,11,14,16
816,LAL,0,240,43,88,48.9,10,35,28.6,33,53,62.26,14,21,66.7,10,31,41,28,5,9,11,18
817,PHX,0,240,40,83,48.2,15,36,41.7,25,47,53.19,18,24,75,11,30,41,20,7,4,16,21
818,DEN,1,240,56,101,55.4,7,31,22.6,49,70,70,11,15,73.3,13,47,60,41,11,11,16,16
819,WAS,0,240,40,104,38.5,17,38,44.7,23,66,34.85,13,23,56.5,14,26,40,30,14,1,14,15
820,TOR,1,240,41,84,48.8,14,31,45.2,27,53,50.94,25,30,83.3,7,38,45,24,10,6,11,18
821,UTA,0,240,43,93,46.2,22,49,44.9,21,44,47.73,29,32,90.6,17,31,48,33,10,3,16,22
822,MEM,1,240,44,83,53,13,26,50,31,57,54.39,12,19,63.2,7,33,40,30,9,3,16,16
823,MIN,1,240,46,89,51.7,11,30,36.7,35,59,59.32,25,27,92.6,11,41,52,24,8,5,14,22
824,GSW,1,240,49,92,53.3,20,42,47.6,29,50,58,22,28,78.6,13,28,41,42,8,6,13,19
825,POR,0,240,31,83,37.3,8,29,27.6,23,54,42.59,21,30,70,9,26,35,18,8,5,15,23
826,MIL,0,240,42,90,46.7,11,44,25,31,46,67.39,15,20,75,11,33,44,24,10,5,14,22
827,LAL,1,240,52,91,57.1,14,31,45.2,38,60,63.33,20,24,83.3,5,32,37,34,8,4,10,13
828,BOS,1,240,52,91,57.1,22,45,48.9,30,46,65.22,10,12,83.3,10,41,51,32,6,5,10,13
829,NOP,1,240,50,89,56.2,10,32,31.3,40,57,70.18,23,29,79.3,8,31,39,36,14,6,10,21
830,SAC,1,240,39,89,43.8,9,33,27.3,30,56,53.57,15,19,78.9,10,38,48,21,7,5,15,18
831,SAS,0,240,36,100,36,10,40,25,26,60,43.33,11,15,73.3,13,31,44,29,8,7,12,9
832,PHI,0,240,41,86,47.7,10,35,28.6,31,51,60.78,12,16,75,6,33,39,29,3,1,14,20
833,TOR,0,240,50,98,51,6,26,23.1,44,72,61.11,19,26,73.1,15,41,56,30,6,7,15,20
834,LAC,1,240,44,88,50,13,38,34.2,31,50,62,29,37,78.4,12,36,48,28,6,4,12,21
835,PHX,1,240,35,77,45.5,10,31,32.3,25,46,54.35,36,44,81.8,9,45,54,28,15,11,24,20
836,UTA,0,240,49,101,48.5,14,45,31.1,35,56,62.5,10,13,76.9,15,29,44,29,5,7,13,21
837,DAL,1,240,49,92,53.3,11,30,36.7,38,62,61.29,7,10,70,8,47,55,28,6,10,16,14
838,BKN,0,240,31,81,38.3,10,31,32.3,21,50,42,14,15,93.3,6,25,31,27,5,1,12,12
839,MIA,1,240,42,88,47.7,11,35,31.4,31,53,58.49,14,15,93.3,10,33,43,27,10,1,13,17
840,ORL,1,240,48,76,63.2,12,26,46.2,36,50,72,10,11,90.9,7,27,34,25,7,7,12,22
841,IND,1,240,47,97,48.5,17,41,41.5,30,56,53.57,16,23,69.6,9,30,39,32,9,9,8,20
842,CHI,0,240,38,83,45.8,14,33,42.4,24,50,48,15,17,88.2,9,35,44,18,5,3,15,21
843,DET,0,240,38,99,38.4,10,37,27,28,62,45.16,14,22,63.6,16,32,48,26,14,5,19,32
844,DEN,0,240,35,89,39.3,9,26,34.6,26,63,41.27,19,22,86.4,12,33,45,27,6,5,12,18
845,HOU,0,240,42,102,41.2,11,36,30.6,31,66,46.97,18,28,64.3,22,34,56,20,9,4,9,25
846,WAS,0,240,44,92,47.8,21,45,46.7,23,47,48.94,17,20,85,15,27,42,35,7,3,19,22
847,CHA,1,240,44,89,49.4,15,37,40.5,29,52,55.77,19,20,95,12,34,46,27,7,4,13,18
848,MEM,1,240,39,79,49.4,15,35,42.9,24,44,54.55,28,41,68.3,8,38,46,27,8,11,11,20
849,GSW,0,240,47,103,45.6,18,47,38.3,29,56,51.79,13,18,72.2,13,34,47,34,7,2,9,25
850,CLE,1,240,40,83,48.2,12,37,32.4,28,46,60.87,16,21,76.2,6,30,36,31,6,2,8,18
851,NYK,0,240,35,84,41.7,11,29,37.9,24,55,43.64,19,24,79.2,16,18,34,15,8,0,12,11
852,ATL,0,240,36,89,40.4,9,38,23.7,27,51,52.94,18,20,90,15,30,45,23,5,6,16,20
853,ORL,0,240,41,91,45.1,11,36,30.6,30,55,54.55,20,25,80,14,34,48,29,6,3,16,19
854,POR,0,240,39,87,44.8,11,29,37.9,28,58,48.28,20,25,80,12,32,44,26,5,1,16,29
855,LAL,1,240,43,84,51.2,14,35,40,29,49,59.18,25,30,83.3,7,40,47,32,6,11,16,14
856,DET,0,240,45,108,41.7,8,28,28.6,37,80,46.25,13,17,76.5,17,33,50,30,8,2,10,24
857,PHX,1,240,44,85,51.8,13,31,41.9,31,54,57.41,29,36,80.6,7,32,39,29,11,6,12,16
858,SAC,0,240,49,95,51.6,9,31,29,40,64,62.5,18,24,75,15,35,50,27,8,6,13,27
859,MIA,1,240,45,87,51.7,19,40,47.5,26,47,55.32,14,18,77.8,7,40,47,34,10,3,14,13
860,BKN,0,240,39,79,49.4,15,33,45.5,24,46,52.17,17,26,65.4,7,30,37,28,6,3,12,21
861,OKC,1,240,46,84,54.8,13,32,40.6,33,52,63.46,22,24,91.7,4,27,31,28,9,8,12,20
862,MIN,1,240,39,84,46.4,13,33,39.4,26,51,50.98,30,34,88.2,12,29,41,24,8,9,12,18
863,BOS,1,240,43,83,51.8,15,37,40.5,28,46,60.87,17,23,73.9,7,32,39,31,6,1,14,24
864,MIL,0,240,37,83,44.6,13,39,33.3,24,44,54.55,10,11,90.9,5,33,38,24,8,4,18,12
865,IND,0,240,42,83,50.6,8,30,26.7,34,53,64.15,10,16,62.5,2,30,32,31,9,3,11,11
866,PHI,1,240,48,88,54.5,11,26,42.3,37,62,59.68,16,19,84.2,11,31,42,25,5,4,11,22
867,DEN,0,240,36,94,38.3,11,40,27.5,25,54,46.3,12,17,70.6,12,36,48,24,7,2,13,14
868,GSW,1,240,48,100,48,20,44,45.5,28,56,50,13,17,76.5,12,39,51,31,8,4,13,13
869,MIN,1,240,46,86,53.5,11,34,32.4,35,52,67.31,18,19,94.7,9,32,41,33,9,7,13,20
870,HOU,1,240,36,80,45,10,26,38.5,26,54,48.15,23,33,69.7,12,27,39,22,12,3,12,16
871,TOR,0,240,39,98,39.8,8,31,25.8,31,67,46.27,13,16,81.3,16,31,47,25,11,4,19,20
872,CHA,1,240,44,82,53.7,10,34,29.4,34,48,70.83,13,16,81.3,5,41,46,27,5,3,19,17
873,MIL,1,240,42,84,50,16,34,47.1,26,50,52,12,18,66.7,9,42,51,30,8,6,13,19
874,NOP,1,240,32,78,41,13,35,37.1,19,43,44.19,19,24,79.2,12,37,49,21,12,4,19,18
875,CHI,1,240,51,92,55.4,13,28,46.4,38,64,59.38,21,29,72.4,7,36,43,29,6,2,6,22
876,ATL,0,240,44,94,46.8,14,43,32.6,30,51,58.82,24,29,82.8,15,34,49,33,4,3,12,20
877,MEM,0,240,34,81,42,12,44,27.3,22,37,59.46,7,8,87.5,3,33,36,28,7,8,18,17
878,SAS,1,240,46,87,52.9,11,30,36.7,35,57,61.4,19,23,82.6,5,41,46,37,12,13,19,14
879,NYK,0,240,42,92,45.7,12,36,33.3,30,56,53.57,7,12,58.3,19,32,51,19,4,4,17,23
880,UTA,0,240,41,92,44.6,11,32,34.4,30,60,50,14,16,87.5,9,35,44,23,8,7,18,17
881,DAL,1,240,43,96,44.8,9,36,25,34,60,56.67,17,26,65.4,12,44,56,27,7,12,16,18
882,CLE,0,240,44,92,47.8,13,37,35.1,31,55,56.36,20,25,80,15,28,43,33,6,8,11,17
883,LAC,0,240,34,84,40.5,9,28,32.1,25,56,44.64,23,26,88.5,10,26,36,20,6,3,13,14
884,WAS,0,240,44,106,41.5,7,32,21.9,37,74,50,9,15,60,12,40,52,27,9,7,16,25
885,SAC,0,240,44,90,48.9,16,42,38.1,28,48,58.33,9,13,69.2,10,30,40,32,5,5,18,22
886,MIA,0,240,40,97,41.2,12,40,30,28,57,49.12,14,15,93.3,14,31,45,21,4,2,7,14
887,BOS,1,240,41,81,50.6,16,39,41,25,42,59.52,12,17,70.6,6,36,42,27,1,9,11,13
888,OKC,1,240,46,85,54.1,13,27,48.1,33,58,56.9,22,27,81.5,5,31,36,30,8,9,11,17
889,ORL,1,265,41,88,46.6,13,39,33.3,28,49,57.14,19,26,73.1,13,35,48,23,4,6,17,18
890,MEM,0,240,43,92,46.7,16,44,36.4,27,48,56.25,4,8,50,9,23,32,33,12,5,12,13
891,PHI,1,240,48,100,48,8,27,29.6,40,73,54.79,15,23,65.2,13,35,48,28,8,4,11,18
892,HOU,0,240,44,100,44,13,43,30.2,31,57,54.39,12,19,63.2,16,42,58,22,6,6,17,26
893,CLE,1,240,48,92,52.2,14,41,34.1,34,51,66.67,9,13,69.2,14,33,47,36,5,4,11,18
894,WAS,0,240,42,86,48.8,13,35,37.1,29,51,56.86,16,21,76.2,7,32,39,28,7,8,17,23
895,POR,0,240,33,76,43.4,6,21,28.6,27,55,49.09,12,17,70.6,11,31,42,19,7,4,18,14
896,TOR,0,240,35,87,40.2,9,31,29,26,56,46.43,16,23,69.6,12,28,40,22,7,3,11,14
897,PHX,0,240,43,94,45.7,11,34,32.4,32,60,53.33,15,16,93.8,9,33,42,28,9,8,14,13
898,LAC,1,240,37,82,45.1,13,39,33.3,24,43,55.81,25,26,96.2,0,35,35,20,9,6,11,13
899,CHA,1,240,47,82,57.3,16,31,51.6,31,51,60.78,5,7,71.4,5,38,43,30,8,4,19,9
900,OKC,0,240,38,98,38.8,17,47,36.2,21,51,41.18,18,21,85.7,12,28,40,23,5,4,10,23
901,DAL,1,240,53,91,58.2,15,38,39.5,38,53,71.7,25,33,75.8,11,43,54,30,8,3,12,23
902,CHI,0,265,43,99,43.4,12,37,32.4,31,62,50,10,14,71.4,18,25,43,21,10,6,8,24
903,GSW,1,240,45,101,44.6,17,41,41.5,28,60,46.67,6,11,54.5,13,39,52,33,6,2,14,20
904,NOP,1,240,36,76,47.4,10,27,37,26,49,53.06,11,16,68.8,8,28,36,27,9,6,12,14
905,BKN,1,240,49,87,56.3,17,34,50,32,53,60.38,8,11,72.7,9,32,41,31,8,7,12,23
906,DET,0,240,45,102,44.1,9,30,30,36,72,50,7,7,100,14,43,57,27,7,2,14,19
907,NYK,0,240,40,84,47.6,10,32,31.3,30,52,57.69,21,23,91.3,5,27,32,16,7,4,9,15
908,ATL,1,240,40,88,45.5,14,41,34.1,26,47,55.32,28,37,75.7,9,32,41,25,7,8,11,18
909,SAS,0,240,36,91,39.6,11,34,32.4,25,57,43.86,20,21,95.2,15,26,41,20,5,3,14,11
910,IND,1,240,50,82,61,14,29,48.3,36,53,67.92,11,19,57.9,6,35,41,30,4,3,16,20
911,NOP,0,240,46,89,51.7,11,29,37.9,35,60,58.33,19,23,82.6,10,31,41,28,5,7,13,22
912,HOU,0,240,38,85,44.7,15,38,39.5,23,47,48.94,13,16,81.3,12,36,48,22,5,3,22,20
913,DEN,0,240,38,82,46.3,10,29,34.5,28,53,52.83,20,28,71.4,9,26,35,26,9,5,21,16
914,CHA,0,240,27,79,34.2,7,29,24.1,20,50,40,23,29,79.3,8,40,48,17,2,2,15,20
915,WAS,0,240,45,95,47.4,20,47,42.6,25,48,52.08,19,21,90.5,5,34,39,32,8,1,12,25
916,LAL,1,240,49,88,55.7,14,31,45.2,35,57,61.4,27,32,84.4,5,27,32,32,5,5,8,20
917,MIL,1,240,41,94,43.6,18,52,34.6,23,42,54.76,20,24,83.3,10,43,53,26,8,5,7,24
918,SAC,1,240,51,87,58.6,17,34,50,34,53,64.15,16,18,88.9,6,36,42,32,11,1,16,22
919,PHI,0,240,42,98,42.9,15,45,33.3,27,53,50.94,22,29,75.9,18,31,49,24,7,6,10,24
920,BOS,1,240,48,92,52.2,11,34,32.4,37,58,63.79,26,28,92.9,9,40,49,25,9,5,13,17
921,TOR,1,240,40,95,42.1,10,33,30.3,30,62,48.39,17,19,89.5,16,25,41,24,14,8,12,17
922,ATL,1,240,42,81,51.9,16,36,44.4,26,45,57.78,27,33,81.8,9,31,40,31,4,9,13,19
923,POR,0,265,41,89,46.1,11,30,36.7,30,59,50.85,29,33,87.9,11,27,38,29,9,7,17,27
924,MEM,0,240,42,91,46.2,18,46,39.1,24,45,53.33,8,13,61.5,9,25,34,26,8,4,10,24
925,MIN,1,240,48,87,55.2,21,41,51.2,27,46,58.7,12,16,75,12,31,43,34,8,3,8,17
926,DET,1,265,45,93,48.4,16,27,59.3,29,66,43.94,22,31,71,16,29,45,26,3,7,17,23
927,LAL,0,240,41,89,46.1,8,25,32,33,64,51.56,16,22,72.7,10,29,39,27,12,10,7,10
928,GSW,1,240,52,93,55.9,17,32,53.1,35,61,57.38,10,13,76.9,10,39,49,33,7,7,17,22
929,UTA,0,240,41,94,43.6,12,35,34.3,29,59,49.15,21,31,67.7,19,33,52,28,7,7,15,14
930,ORL,1,240,49,82,59.8,16,27,59.3,33,55,60,13,20,65,8,31,39,34,11,5,17,20
931,SAS,0,240,42,81,51.9,11,35,31.4,31,46,67.39,16,17,94.1,4,23,27,29,7,5,15,16
932,DAL,1,240,43,82,52.4,18,42,42.9,25,40,62.5,18,23,78.3,6,34,40,30,7,6,9,13
933,BKN,0,240,37,93,39.8,10,25,40,27,68,39.71,11,14,78.6,12,22,34,22,9,3,12,17
934,CHI,1,240,43,79,54.4,12,26,46.2,31,53,58.49,20,22,90.9,8,38,46,24,3,4,15,16
935,NYK,0,240,42,94,44.7,14,37,37.8,28,57,49.12,10,11,90.9,14,32,46,27,5,2,14,19
936,IND,0,240,39,81,48.1,12,31,38.7,27,50,54,19,27,70.4,7,23,30,31,11,6,14,17
937,DEN,1,240,47,97,48.5,14,32,43.8,33,65,50.77,6,7,85.7,14,36,50,33,4,6,14,17
938,MIL,0,240,40,81,49.4,14,33,42.4,26,48,54.17,11,16,68.8,10,25,35,35,6,3,13,10
939,CLE,1,240,43,80,53.8,15,37,40.5,28,43,65.12,17,17,100,7,41,48,26,8,13,17,18
940,PHX,1,240,52,88,59.1,14,29,48.3,38,59,64.41,11,16,68.8,5,32,37,37,10,7,12,22
941,MIA,1,240,43,87,49.4,12,38,31.6,31,49,63.27,18,23,78.3,5,40,45,29,8,2,11,20
942,BOS,1,240,49,93,52.7,17,49,34.7,32,44,72.73,10,11,90.9,6,39,45,33,6,9,14,16
943,SAC,0,240,45,95,47.4,15,44,34.1,30,51,58.82,15,22,68.2,5,28,33,31,7,6,4,20
944,DET,1,240,47,84,56,17,31,54.8,30,53,56.6,22,22,100,6,42,48,32,2,2,13,21
945,WAS,0,240,42,94,44.7,16,40,40,26,54,48.15,6,9,66.7,12,35,47,27,10,5,15,23
946,GSW,1,240,47,94,50,16,38,42.1,31,56,55.36,17,22,77.3,12,40,52,30,7,8,13,21
947,NOP,1,240,47,88,53.4,12,32,37.5,35,56,62.5,11,16,68.8,8,30,38,30,13,5,15,17
948,TOR,1,240,43,81,53.1,17,33,51.5,26,48,54.17,20,24,83.3,7,34,41,30,5,3,11,17
949,ATL,0,240,43,102,42.2,13,41,31.7,30,61,49.18,18,20,90,13,36,49,24,8,2,9,13
950,LAC,0,240,36,78,46.2,12,32,37.5,24,46,52.17,22,26,84.6,8,29,37,23,7,2,19,17
951,CHA,0,240,44,90,48.9,16,39,41,28,51,54.9,13,20,65,9,29,38,27,6,2,10,20
952,SAS,0,240,41,90,45.6,12,37,32.4,29,53,54.72,10,17,58.8,6,40,46,30,6,2,15,21
953,CLE,1,240,43,88,48.9,12,35,34.3,31,53,58.49,16,22,72.7,7,39,46,25,4,5,14,11
954,PHI,0,240,41,98,41.8,8,32,25,33,66,50,14,14,100,11,29,40,21,7,8,15,16
955,PHX,1,240,44,87,50.6,8,28,28.6,36,59,61.02,18,27,66.7,8,41,49,17,8,5,14,19
956,MEM,0,240,41,80,51.3,21,37,56.8,20,43,46.51,10,16,62.5,8,27,35,33,4,5,18,15
957,MIN,0,265,42,92,45.7,20,45,44.4,22,47,46.81,19,26,73.1,10,32,42,28,6,5,14,25
958,BKN,0,240,41,91,45.1,12,33,36.4,29,58,50,13,15,86.7,8,35,43,33,6,5,10,13
959,NYK,1,240,48,86,55.8,11,27,40.7,37,59,62.71,16,20,80,8,29,37,28,12,5,10,12
960,HOU,0,240,50,97,51.5,12,25,48,38,72,52.78,17,23,73.9,20,28,48,26,5,3,15,16
961,IND,1,240,54,86,62.8,15,32,46.9,39,54,72.22,9,14,64.3,5,20,25,35,7,7,12,20
962,MIA,1,240,47,87,54,13,36,36.1,34,51,66.67,14,18,77.8,11,34,45,31,10,3,13,19
963,UTA,1,240,46,89,51.7,14,35,40,32,54,59.26,18,20,90,15,33,48,29,9,8,17,17
964,ORL,0,240,35,80,43.8,10,35,28.6,25,45,55.56,15,21,71.4,8,31,39,25,7,3,18,17
965,CHI,1,265,45,93,48.4,12,30,40,33,63,52.38,27,32,84.4,13,35,48,24,9,16,14,22
966,DAL,1,240,46,91,50.5,19,43,44.2,27,48,56.25,8,13,61.5,6,39,45,25,7,3,11,12
967,MIL,0,240,39,90,43.3,13,40,32.5,26,50,52,15,25,60,10,34,44,23,10,4,13,21
968,OKC,0,240,43,90,47.8,19,37,51.4,24,53,45.28,12,18,66.7,9,23,32,26,9,9,11,16
969,DAL,1,240,42,87,48.3,17,43,39.5,25,44,56.82,17,23,73.9,8,36,44,28,6,4,10,16
970,BKN,0,240,34,89,38.2,13,42,31,21,47,44.68,17,22,77.3,11,27,38,23,7,12,10,23
971,NOP,1,240,53,104,51,19,45,42.2,34,59,57.63,13,13,100,17,34,51,36,11,5,7,13
972,PHI,0,240,40,93,43,8,29,27.6,32,64,50,14,20,70,16,35,51,20,8,5,12,21
973,ATL,0,240,51,95,53.7,20,39,51.3,31,56,55.36,22,27,81.5,13,26,39,35,5,4,11,22
974,CLE,1,240,51,88,58,23,41,56.1,28,47,59.57,11,17,64.7,5,40,45,36,10,5,9,15
975,TOR,0,240,40,84,47.6,10,31,32.3,30,53,56.6,10,15,66.7,10,28,38,27,4,6,18,12
976,SAC,0,240,43,93,46.2,17,44,38.6,26,49,53.06,7,12,58.3,10,30,40,28,5,1,12,18
977,LAL,1,240,50,89,56.2,8,34,23.5,42,55,76.36,16,19,84.2,7,41,48,36,5,6,17,12
978,CHA,0,240,47,96,49,13,32,40.6,34,64,53.12,11,14,78.6,5,29,34,26,9,1,9,16
979,LAC,1,240,52,89,58.4,21,35,60,31,54,57.41,24,31,77.4,8,28,36,32,8,5,8,19
980,GSW,1,240,43,93,46.2,4,22,18.2,39,71,54.93,19,23,82.6,16,44,60,24,7,8,14,17
981,TOR,0,290,48,101,47.5,14,35,40,34,66,51.52,17,21,81,11,37,48,38,6,5,12,16
982,IND,1,240,45,92,48.9,11,33,33.3,34,59,57.63,14,18,77.8,11,38,49,34,5,4,11,15
983,MIN,1,240,40,90,44.4,11,30,36.7,29,60,48.33,20,27,74.1,11,47,58,21,6,11,16,19
984,UTA,1,240,43,89,48.3,17,44,38.6,26,45,57.78,20,24,83.3,12,40,52,31,3,3,16,24
985,WAS,0,240,47,96,49,7,32,21.9,40,64,62.5,11,17,64.7,13,22,35,32,11,4,18,19
986,POR,0,240,39,85,45.9,11,31,35.5,28,54,51.85,14,15,93.3,15,27,42,29,6,3,13,16
987,ORL,1,240,45,84,53.6,10,24,41.7,35,60,58.33,11,15,73.3,7,30,37,22,7,3,10,18
988,DET,0,240,36,80,45,8,31,25.8,28,49,57.14,19,22,86.4,9,27,36,22,6,5,15,18
989,LAC,1,240,34,77,44.2,16,39,41,18,38,47.37,19,22,86.4,9,39,48,23,6,5,17,12
990,BOS,1,240,48,99,48.5,19,51,37.3,29,48,60.42,16,18,88.9,17,40,57,30,12,4,11,13
991,PHX,1,240,54,88,61.4,11,25,44,43,63,68.25,21,26,80.8,9,33,42,33,13,6,18,12
992,CHA,0,240,35,88,39.8,8,29,27.6,27,59,45.76,21,25,84,11,32,43,18,6,5,11,16
993,MIA,0,240,38,91,41.8,8,30,26.7,30,61,49.18,11,12,91.7,12,33,45,24,9,0,10,19
994,HOU,0,240,31,88,35.2,10,30,33.3,21,58,36.21,18,27,66.7,10,31,41,20,10,7,11,26
995,DEN,1,240,42,86,48.8,12,28,42.9,30,58,51.72,16,19,84.2,14,28,42,26,8,6,9,11
996,MIL,0,240,39,84,46.4,15,41,36.6,24,43,55.81,15,25,60,7,25,32,27,8,3,12,21
997,OKC,1,290,52,110,47.3,23,63,36.5,29,47,61.7,8,8,100,14,31,45,40,6,8,11,15
998,MEM,0,240,35,92,38,11,38,28.9,24,54,44.44,10,12,83.3,16,30,46,19,5,3,20,15
999,LAL,1,240,39,80,48.8,12,31,38.7,27,49,55.1,23,27,85.2,3,35,38,28,4,11,5,16
1000,ATL,1,265,55,114,48.2,14,43,32.6,41,71,57.75,17,22,77.3,16,41,57,27,5,4,8,20
1001,MIL,1,240,50,88,56.8,12,30,40,38,58,65.52,17,25,68,5,31,36,34,13,2,12,21
1002,GSW,0,265,50,112,44.6,18,56,32.1,32,56,57.14,16,20,80,14,43,57,26,4,7,14,23
1003,CLE,1,240,46,97,47.4,13,44,29.5,33,53,62.26,12,13,92.3,10,41,51,31,6,4,10,19
1004,SAC,1,240,42,84,50,15,39,38.5,27,45,60,24,29,82.8,4,36,40,33,12,1,17,18
1005,SAS,0,240,36,98,36.7,12,40,30,24,58,41.38,17,21,81,14,40,54,23,6,6,12,13
1006,NYK,0,240,41,100,41,10,35,28.6,31,65,47.69,13,15,86.7,18,33,51,21,1,4,7,20
1007,PHI,0,240,44,96,45.8,12,29,41.4,32,67,47.76,21,27,77.8,11,33,44,26,7,1,5,17
1008,DAL,0,240,40,81,49.4,16,39,41,24,42,57.14,21,23,91.3,8,34,42,22,9,1,21,19
1009,CHI,0,240,42,91,46.2,11,34,32.4,31,57,54.39,20,22,90.9,11,36,47,24,13,3,16,20
1010,BKN,1,240,49,95,51.6,20,51,39.2,29,44,65.91,18,23,78.3,13,40,53,35,3,5,12,20
1011,IND,0,240,46,85,54.1,10,29,34.5,36,56,64.29,20,24,83.3,8,31,39,23,13,3,22,20
1012,POR,0,240,37,80,46.3,10,28,35.7,27,52,51.92,24,30,80,13,24,37,14,7,4,10,16
1013,LAC,1,240,53,89,59.6,14,29,48.3,39,60,65,16,19,84.2,7,29,36,31,12,5,11,21
1014,SAC,1,240,51,90,56.7,13,34,38.2,38,56,67.86,18,28,64.3,9,29,38,26,15,3,17,17
1015,SAS,0,240,46,96,47.9,10,39,25.6,36,57,63.16,11,18,61.1,18,37,55,35,6,10,18,16
1016,TOR,0,240,40,91,44,11,33,33.3,29,58,50,15,20,75,8,29,37,17,11,5,14,18
1017,WAS,0,240,37,90,41.1,11,42,26.2,26,48,54.17,17,21,81,6,37,43,28,5,4,9,25
1018,MIA,1,240,38,88,43.2,7,31,22.6,31,57,54.39,27,35,77.1,14,45,59,24,4,1,12,18
1019,CHA,0,240,41,92,44.6,14,31,45.2,27,61,44.26,10,14,71.4,7,28,35,22,12,4,14,21
1020,MEM,0,240,35,87,40.2,14,46,30.4,21,41,51.22,17,24,70.8,9,28,37,30,7,4,14,20
1021,DEN,1,240,46,91,50.5,12,36,33.3,34,55,61.82,16,17,94.1,16,32,48,34,3,6,12,20
1022,ORL,1,240,39,85,45.9,9,25,36,30,60,50,21,26,80.8,10,32,42,24,11,4,15,17
1023,PHX,0,240,47,88,53.4,14,37,37.8,33,51,64.71,12,14,85.7,8,30,38,31,6,5,17,17
1024,DET,0,240,45,89,50.6,17,40,42.5,28,49,57.14,18,24,75,13,25,38,28,5,3,17,18
1025,OKC,1,240,44,75,58.7,17,36,47.2,27,39,69.23,21,27,77.8,3,41,44,31,10,10,19,17
1026,MIN,0,240,38,82,46.3,12,38,31.6,26,44,59.09,18,20,90,6,32,38,24,8,5,17,20
1027,GSW,1,240,46,83,55.4,11,29,37.9,35,54,64.81,18,22,81.8,6,40,46,32,7,8,14,17
1028,ATL,1,240,49,95,51.6,17,44,38.6,32,51,62.75,14,18,77.8,12,31,43,29,7,4,10,13
1029,NOP,1,240,46,95,48.4,7,26,26.9,39,69,56.52,15,21,71.4,13,26,39,29,14,3,9,17
1030,HOU,1,240,55,93,59.1,11,31,35.5,44,62,70.97,14,17,82.4,7,42,49,30,9,3,15,20
1031,MEM,0,240,37,90,41.1,12,38,31.6,25,52,48.08,15,17,88.2,7,36,43,25,9,12,13,19
1032,LAL,1,240,38,94,40.4,19,36,52.8,19,58,32.76,19,26,73.1,15,37,52,30,11,2,7,8
1033,NYK,1,240,41,103,39.8,8,38,21.1,33,65,50.77,19,25,76,24,36,60,15,8,7,10,14
1034,UTA,0,240,45,87,51.7,12,36,33.3,33,51,64.71,22,25,88,10,33,43,36,3,9,11,15
1035,BOS,0,240,41,97,42.3,16,48,33.3,25,49,51.02,7,7,100,14,40,54,30,4,12,15,19
1036,PHI,1,240,47,94,50,14,32,43.8,33,62,53.23,19,21,90.5,10,30,40,27,6,11,5,22
1037,IND,0,240,42,93,45.2,13,33,39.4,29,60,48.33,8,13,61.5,9,35,44,21,9,9,13,25
1038,CLE,1,240,41,86,47.7,14,35,40,27,51,52.94,12,18,66.7,10,38,48,26,6,8,14,16
1039,HOU,0,240,35,87,40.2,13,44,29.5,22,43,51.16,16,17,94.1,5,24,29,19,11,2,5,21
1040,DET,0,240,45,81,55.6,16,31,51.6,29,50,58,15,19,78.9,7,28,35,27,8,3,19,17
1041,DEN,0,240,37,93,39.8,15,37,40.5,22,56,39.29,11,16,68.8,12,35,47,21,7,9,10,23
1042,CHA,0,240,40,90,44.4,16,46,34.8,24,44,54.55,14,17,82.4,9,31,40,25,4,6,10,18
1043,POR,1,240,49,92,53.3,12,28,42.9,37,64,57.81,9,9,100,9,30,39,26,9,1,11,20
1044,SAC,0,240,41,93,44.1,12,40,30,29,53,54.72,12,18,66.7,12,32,44,26,6,3,9,17
1045,WAS,0,240,45,97,46.4,9,29,31,36,68,52.94,10,15,66.7,12,33,45,19,4,10,13,19
1046,CHI,1,240,45,87,51.7,11,29,37.9,34,58,58.62,16,22,72.7,11,33,44,28,4,7,10,13
1047,MIL,0,240,45,92,48.9,13,45,28.9,32,47,68.09,13,18,72.2,10,29,39,27,7,5,13,17
1048,ORL,1,240,41,86,47.7,7,20,35,34,66,51.52,19,23,82.6,12,33,45,29,10,5,16,20
1049,OKC,1,240,37,87,42.5,11,26,42.3,26,61,42.62,20,25,80,15,38,53,24,2,9,13,14
1050,LAC,1,240,47,100,47,12,30,40,35,70,50,19,22,86.4,18,34,52,25,9,7,8,16
1051,BKN,0,240,47,94,50,16,39,41,31,55,56.36,10,13,76.9,8,19,27,28,11,1,11,24
1052,SAS,0,240,36,80,45,9,31,29,27,49,55.1,17,24,70.8,7,34,41,24,9,9,19,20
1053,NOP,1,240,41,82,50,11,34,32.4,30,48,62.5,17,24,70.8,12,44,56,20,3,6,16,22
1054,CLE,1,240,47,89,52.8,12,35,34.3,35,54,64.81,22,23,95.7,10,23,33,26,13,5,9,15
1055,PHX,1,240,49,79,62,14,28,50,35,51,68.63,24,32,75,9,33,42,35,5,6,16,12
1056,MIN,1,240,45,80,56.3,13,30,43.3,32,50,64,18,30,60,9,36,45,31,6,4,10,24
1057,MIA,1,240,42,84,50,13,28,46.4,29,56,51.79,18,23,78.3,7,42,49,38,3,2,10,16
1058,DAL,0,240,31,76,40.8,6,29,20.7,25,47,53.19,19,26,73.1,9,22,31,18,4,4,17,24
1059,BOS,1,240,47,87,54,17,36,47.2,30,51,58.82,18,22,81.8,7,33,40,25,6,9,12,16
1060,TOR,1,240,43,83,51.8,14,29,48.3,29,54,53.7,18,20,90,9,29,38,34,10,4,20,20
1061,NYK,1,240,44,94,46.8,13,34,38.2,31,60,51.67,17,18,94.4,14,31,45,29,9,7,6,16
1062,CHI,0,240,38,75,50.7,11,32,34.4,27,43,62.79,20,27,74.1,6,27,33,21,9,9,20,16
1063,ATL,1,240,53,101,52.5,16,38,42.1,37,63,58.73,16,18,88.9,12,34,46,32,10,2,12,18
1064,GSW,1,240,44,79,55.7,14,32,43.8,30,47,63.83,17,19,89.5,8,34,42,32,6,6,18,20
1065,PHI,0,240,39,85,45.9,13,30,43.3,26,55,47.27,16,21,76.2,13,26,39,11,14,2,16,24
1066,UTA,0,240,39,86,45.3,12,36,33.3,27,50,54,13,17,76.5,15,28,43,23,3,5,15,16
1067,LAL,0,240,48,90,53.3,12,33,36.4,36,57,63.16,14,25,56,7,30,37,28,12,3,14,16
1068,IND,0,240,50,108,46.3,12,39,30.8,38,69,55.07,12,15,80,19,31,50,33,4,2,8,21
1069,DAL,1,240,43,69,62.3,13,27,48.1,30,42,71.43,32,43,74.4,3,32,35,27,6,2,15,24
1070,LAL,0,240,45,91,49.5,13,35,37.1,32,56,57.14,16,26,61.5,4,31,35,26,10,6,12,13
1071,UTA,0,240,39,86,45.3,9,27,33.3,30,59,50.85,27,34,79.4,12,32,44,23,3,7,17,14
1072,BOS,1,240,43,85,50.6,17,46,37,26,39,66.67,15,20,75,6,34,40,27,7,5,11,15
1073,SAS,0,240,43,92,46.7,12,30,40,31,62,50,15,17,88.2,10,26,36,31,10,7,15,17
1074,ORL,0,240,45,88,51.1,18,38,47.4,27,50,54,21,28,75,12,23,35,27,7,1,12,33
1075,CHA,0,240,37,81,45.7,11,32,34.4,26,49,53.06,7,14,50,9,32,41,23,4,6,14,14
1076,POR,1,240,46,84,54.8,12,28,42.9,34,56,60.71,26,29,89.7,11,28,39,29,7,5,13,24
1077,MIA,0,240,33,84,39.3,14,36,38.9,19,48,39.58,25,25,100,8,36,44,20,5,5,13,18
1078,NYK,1,240,44,84,52.4,12,37,32.4,32,47,68.09,13,16,81.3,7,35,42,25,5,3,9,16
1079,MEM,0,240,30,80,37.5,13,36,36.1,17,44,38.64,21,28,75,9,28,37,22,11,1,14,16
1080,MIN,1,240,40,83,48.2,14,29,48.3,26,54,48.15,13,15,86.7,9,36,45,21,7,2,13,19
1081,HOU,1,240,52,98,53.1,12,36,33.3,40,62,64.52,19,25,76,14,42,56,36,10,2,15,19
1082,MIL,0,240,36,84,42.9,16,40,40,20,44,45.45,19,25,76,7,33,40,24,3,7,13,22
1083,OKC,0,240,35,79,44.3,14,35,40,21,44,47.73,17,22,77.3,8,30,38,21,5,7,12,17
1084,LAC,0,240,38,80,47.5,11,34,32.4,27,46,58.7,21,28,75,6,31,37,28,8,3,13,21
1085,BKN,1,240,54,105,51.4,21,45,46.7,33,60,55,18,19,94.7,16,34,50,41,12,9,9,24
1086,PHX,1,240,46,94,48.9,14,40,35,32,54,59.26,12,17,70.6,10,37,47,30,8,8,8,16
1087,WAS,1,240,46,86,53.5,9,25,36,37,61,60.66,17,24,70.8,14,31,45,32,9,8,19,15
1088,CLE,1,240,42,86,48.8,13,40,32.5,29,46,63.04,21,26,80.8,11,35,46,28,6,3,13,18
1089,SAC,1,240,43,84,51.2,11,38,28.9,32,46,69.57,6,10,60,11,40,51,24,10,1,19,17
1090,DEN,1,240,44,91,48.4,4,18,22.2,40,73,54.79,21,24,87.5,9,38,47,29,7,4,8,22
1091,NOP,0,240,46,91,50.5,10,35,28.6,36,56,64.29,10,13,76.9,9,31,40,21,7,6,12,14
1092,PHI,0,240,37,83,44.6,5,29,17.2,32,54,59.26,25,28,89.3,12,22,34,17,6,5,17,25
1093,MEM,0,240,38,82,46.3,11,30,36.7,27,52,51.92,23,31,74.2,13,32,45,20,5,7,13,20
1094,IND,1,240,44,90,48.9,13,35,37.1,31,55,56.36,15,16,93.8,11,33,44,31,8,6,10,26
1095,TOR,0,240,41,89,46.1,15,31,48.4,26,58,44.83,28,32,87.5,15,31,46,29,12,3,14,30
1096,CHI,1,240,42,90,46.7,8,32,25,34,58,58.62,12,17,70.6,5,35,40,27,7,10,5,19
1097,DET,1,240,47,95,49.5,11,26,42.3,36,69,52.17,15,19,78.9,15,38,53,27,6,2,9,11
1098,PHX,0,240,41,73,56.2,4,14,28.6,37,59,62.71,12,21,57.1,6,33,39,19,4,5,23,19
1099,ATL,1,240,44,95,46.3,6,27,22.2,38,68,55.88,32,40,80,20,31,51,27,7,4,14,21
1100,ORL,1,240,41,92,44.6,12,36,33.3,29,56,51.79,19,26,73.1,11,29,40,30,12,7,10,21
1101,POR,0,240,32,79,40.5,6,33,18.2,26,46,56.52,26,29,89.7,7,41,48,22,2,5,14,21
1102,OKC,0,240,44,92,47.8,8,28,28.6,36,64,56.25,8,12,66.7,11,32,43,17,7,5,10,18
1103,MIA,0,240,41,88,46.6,14,37,37.8,27,51,52.94,13,16,81.3,8,30,38,26,6,4,8,18
1104,SAC,1,240,43,80,53.8,11,30,36.7,32,50,64,23,30,76.7,6,33,39,27,4,10,14,20
1105,DAL,0,240,43,98,43.9,16,46,34.8,27,52,51.92,13,18,72.2,13,30,43,35,7,2,10,24
1106,NOP,0,240,40,85,47.1,9,23,39.1,31,62,50,28,36,77.8,9,34,43,20,5,3,15,17
1107,BOS,0,240,36,100,36,10,40,25,26,60,43.33,14,16,87.5,18,34,52,21,2,9,11,13
1108,DET,0,240,37,85,43.5,9,32,28.1,28,53,52.83,21,27,77.8,11,34,45,22,2,8,17,20
1109,LAL,1,290,49,101,48.5,9,27,33.3,40,74,54.05,38,43,88.4,7,48,55,33,9,5,20,21
1110,PHI,0,240,43,81,53.1,6,22,27.3,37,59,62.71,13,16,81.3,6,33,39,25,5,6,11,29
1111,CHA,0,240,47,92,51.1,13,32,40.6,34,60,56.67,15,21,71.4,9,26,35,35,7,6,10,22
1112,HOU,0,240,37,94,39.4,10,37,27,27,57,47.37,20,23,87,15,40,55,20,6,3,17,29
1113,LAC,1,240,45,102,44.1,10,40,25,35,62,56.45,15,18,83.3,15,43,58,28,8,8,8,20
1114,DEN,1,240,37,82,45.1,13,37,35.1,24,45,53.33,24,38,63.2,13,31,44,25,5,3,8,15
1115,NYK,1,240,45,87,51.7,17,33,51.5,28,54,51.85,18,26,69.2,11,35,46,25,6,3,7,15
1116,MIL,1,240,51,91,56,20,45,44.4,31,46,67.39,19,25,76,6,39,45,30,12,0,9,25
1117,MIN,0,240,45,79,57,14,26,53.8,31,53,58.49,8,15,53.3,7,25,32,30,9,6,13,13
1118,GSW,0,290,55,119,46.2,23,58,39.7,32,61,52.46,11,16,68.8,11,39,50,37,11,3,17,34
1119,UTA,1,240,52,93,55.9,17,41,41.5,35,52,67.31,13,17,76.5,15,34,49,38,6,6,14,18
1120,WAS,1,240,45,100,45,11,34,32.4,34,66,51.52,17,21,81,16,34,50,26,10,4,10,19
1121,BKN,1,240,36,74,48.6,12,34,35.3,24,40,60,22,37,59.5,2,38,40,24,11,6,19,22
1122,SAS,1,240,46,84,54.8,13,30,43.3,33,54,61.11,8,15,53.3,14,25,39,35,7,7,15,14
1123,IND,1,240,58,109,53.2,8,26,30.8,50,83,60.24,9,15,60,21,27,48,34,8,3,13,17
1124,PHX,0,240,51,89,57.3,13,30,43.3,38,59,64.41,16,18,88.9,7,31,38,24,8,5,20,17
1125,SAS,1,240,42,92,45.7,10,34,29.4,32,58,55.17,22,26,84.6,17,42,59,30,12,5,18,11
1126,POR,0,240,38,90,42.2,10,37,27,28,53,52.83,14,19,73.7,8,29,37,23,11,3,15,20
1127,MIL,0,240,35,87,40.2,13,34,38.2,22,53,41.51,17,24,70.8,12,39,51,21,6,4,18,24
1128,HOU,1,240,50,89,56.2,13,33,39.4,37,56,66.07,25,31,80.6,11,42,53,34,7,10,14,20
1129,OKC,1,240,42,88,47.7,10,33,30.3,32,55,58.18,13,14,92.9,6,39,45,22,11,5,13,11
1130,NOP,0,240,32,82,39,9,36,25,23,46,50,10,14,71.4,8,33,41,24,9,5,20,16
1131,DAL,1,240,51,85,60,19,35,54.3,32,50,64,27,32,84.4,6,31,37,28,3,5,13,25
1132,CLE,1,240,38,92,41.3,14,36,38.9,24,56,42.86,22,31,71,15,36,51,20,7,8,13,22
1133,LAC,1,240,48,95,50.5,9,32,28.1,39,63,61.9,22,24,91.7,12,38,50,29,6,7,11,17
1134,ORL,0,240,38,81,46.9,9,34,26.5,29,47,61.7,21,29,72.4,9,31,40,21,8,4,11,14
1135,ATL,0,240,51,97,52.6,15,34,44.1,36,63,57.14,26,30,86.7,12,24,36,32,7,2,7,24
1136,CHA,0,240,35,85,41.2,9,29,31,26,56,46.43,25,32,78.1,5,27,32,20,6,7,13,25
1137,MEM,1,240,42,90,46.7,15,41,36.6,27,49,55.1,8,13,61.5,9,34,43,30,9,7,14,21
1138,TOR,0,240,44,96,45.8,6,32,18.8,38,64,59.38,13,22,59.1,15,30,45,26,6,3,11,18
1139,SAC,1,240,48,91,52.7,22,48,45.8,26,43,60.47,16,19,84.2,8,26,34,33,8,5,10,21
1140,NYK,1,240,45,85,52.9,15,38,39.5,30,47,63.83,17,20,85,12,32,44,26,12,3,10,14
1141,MIA,0,240,42,94,44.7,16,42,38.1,26,52,50,10,13,76.9,11,20,31,25,7,1,5,12
1142,BOS,1,240,51,80,63.8,22,40,55,29,40,72.5,19,20,95,6,41,47,36,4,5,11,10
1143,PHI,0,240,42,87,48.3,7,29,24.1,35,58,60.34,31,43,72.1,6,25,31,24,13,6,12,20
1144,CHI,0,240,47,88,53.4,12,37,32.4,35,51,68.63,26,29,89.7,12,27,39,27,7,6,17,18
1145,BKN,0,240,35,77,45.5,10,33,30.3,25,44,56.82,14,16,87.5,5,27,32,22,7,3,15,15
1146,DEN,0,240,34,84,40.5,5,26,19.2,29,58,50,11,13,84.6,13,27,40,20,2,2,19,20
1147,GSW,0,240,48,86,55.8,19,37,51.4,29,49,59.18,18,23,78.3,6,27,33,30,7,3,13,19
1148,WAS,0,240,43,88,48.9,7,30,23.3,36,58,62.07,15,20,75,5,30,35,33,11,7,11,14
1149,IND,1,240,53,93,57,12,28,42.9,41,65,63.08,16,21,76.2,12,43,55,35,6,8,21,33
1150,MIN,1,240,37,75,49.3,10,21,47.6,27,54,50,12,16,75,5,33,38,24,6,4,17,17
1151,UTA,1,240,50,97,51.5,13,31,41.9,37,66,56.06,10,12,83.3,13,39,52,34,6,2,16,19
1152,LAL,1,240,53,87,60.9,20,31,64.5,33,56,58.93,15,20,75,5,25,30,35,10,4,14,21
1153,MIL,1,240,45,90,50,11,29,37.9,34,61,55.74,25,28,89.3,10,36,46,24,9,3,12,16
1154,DAL,0,240,41,89,46.1,17,43,39.5,24,46,52.17,10,18,55.6,10,23,33,25,4,3,14,16
1155,PHX,1,240,51,85,60,14,34,41.2,37,51,72.55,16,22,72.7,11,38,49,30,10,4,16,20
1156,GSW,1,240,51,91,56,16,33,48.5,35,58,60.34,16,22,72.7,11,38,49,26,6,9,10,18
1157,ATL,0,240,39,94,41.5,14,43,32.6,25,51,49.02,20,26,76.9,13,32,45,30,7,2,11,16
1158,MIA,0,240,33,82,40.2,11,34,32.4,22,48,45.83,19,25,76,11,33,44,21,9,9,17,17
1159,SAS,0,240,43,86,50,9,32,28.1,34,54,62.96,19,25,76,12,26,38,30,7,11,19,14
1160,MEM,1,240,36,80,45,17,36,47.2,19,44,43.18,16,19,84.2,7,37,44,30,8,6,18,19
1161,CHA,0,240,38,87,43.7,15,38,39.5,23,49,46.94,15,19,78.9,9,39,48,27,5,5,11,22
1162,POR,1,265,50,98,51,15,35,42.9,35,63,55.56,22,24,91.7,13,35,48,31,6,4,12,18
1163,WAS,0,240,37,77,48.1,10,24,41.7,27,53,50.94,23,29,79.3,7,42,49,31,2,3,21,22
1164,HOU,0,265,50,94,53.2,12,36,33.3,38,58,65.52,19,22,86.4,8,29,37,29,8,6,8,19
1165,MIN,1,240,42,100,42,9,32,28.1,33,68,48.53,25,29,86.2,15,33,48,26,8,7,7,22
1166,CLE,0,240,46,91,50.5,13,38,34.2,33,53,62.26,11,15,73.3,6,33,39,26,5,2,13,18
1167,DET,1,240,43,86,50,15,38,39.5,28,48,58.33,12,20,60,5,39,44,26,4,0,11,17
1168,OKC,1,240,54,96,56.3,18,40,45,36,56,64.29,14,16,87.5,16,31,47,36,11,8,16,20
1169,UTA,0,240,43,92,46.7,12,36,33.3,31,56,55.36,26,32,81.3,6,32,38,27,4,8,8,15
1170,NOP,1,240,60,104,57.7,23,46,50,37,58,63.79,10,15,66.7,12,45,57,41,5,4,9,24
1171,BKN,0,240,42,95,44.2,15,42,35.7,27,53,50.94,4,5,80,13,27,40,29,7,5,13,19
1172,DEN,1,240,44,88,50,11,33,33.3,33,55,60,15,17,88.2,11,31,42,22,5,9,12,17
1173,NYK,1,240,40,86,46.5,10,29,34.5,30,57,52.63,18,19,94.7,11,31,42,21,8,8,14,13
1174,LAC,1,240,52,88,59.1,14,27,51.9,38,61,62.3,9,12,75,6,30,36,33,8,5,15,17
1175,OKC,1,240,43,89,48.3,7,23,30.4,36,66,54.55,18,28,64.3,10,33,43,23,9,10,12,18
1176,IND,0,240,43,87,49.4,5,21,23.8,38,66,57.58,18,21,85.7,7,31,38,24,4,1,10,16
1177,LAL,0,240,45,92,48.9,11,32,34.4,34,60,56.67,15,22,68.2,13,28,41,27,9,8,15,15
1178,POR,0,240,37,86,43,18,39,46.2,19,47,40.43,17,21,81,12,34,46,27,6,6,19,19
1179,DET,0,240,40,89,44.9,10,30,33.3,30,59,50.85,23,29,79.3,6,36,42,25,4,9,10,25
1180,DAL,0,240,43,97,44.3,14,40,35,29,57,50.88,10,14,71.4,10,38,48,24,4,4,10,20
1181,MIL,1,240,42,94,44.7,10,39,25.6,32,55,58.18,28,34,82.4,10,39,49,26,7,8,9,22
1182,MIN,0,240,44,84,52.4,18,41,43.9,26,43,60.47,19,25,76,6,30,36,34,4,1,13,15
1183,BOS,1,240,41,88,46.6,15,46,32.6,26,42,61.9,22,30,73.3,5,39,44,26,7,8,6,20
1184,PHI,1,240,48,97,49.5,5,20,25,43,77,55.84,32,40,80,19,29,48,28,5,3,4,20
1185,SAS,0,240,43,93,46.2,13,41,31.7,30,52,57.69,24,27,88.9,13,30,43,29,3,3,8,22
1186,SAC,1,240,43,93,46.2,12,38,31.6,31,55,56.36,24,27,88.9,10,41,51,22,8,2,9,21
1187,CHI,0,240,45,93,48.4,14,37,37.8,31,56,55.36,9,14,64.3,14,33,47,25,6,4,10,18
1188,ATL,0,240,36,93,38.7,14,40,35,22,53,41.51,21,27,77.8,13,37,50,19,2,7,12,19
1189,CHA,1,240,50,88,56.8,14,37,37.8,36,51,70.59,14,18,77.8,7,28,35,30,8,4,10,20
1190,TOR,0,240,35,79,44.3,8,23,34.8,27,56,48.21,22,23,95.7,12,35,47,31,7,8,17,14
1191,ORL,0,240,34,74,45.9,11,29,37.9,23,45,51.11,20,30,66.7,8,26,34,25,7,0,15,17
1192,CLE,1,240,45,80,56.3,20,38,52.6,25,42,59.52,16,22,72.7,9,30,39,29,10,4,12,20
1193,PHX,1,240,44,85,51.8,14,34,41.2,30,51,58.82,13,17,76.5,5,34,39,32,5,5,7,13
1194,MEM,1,240,44,95,46.3,13,34,38.2,31,61,50.82,7,12,58.3,19,28,47,30,11,8,16,15
1195,LAC,1,240,42,83,50.6,13,26,50,29,57,50.88,28,33,84.8,8,37,45,26,6,5,11,18
1196,POR,0,240,42,90,46.7,9,29,31,33,61,54.1,17,20,85,10,25,35,24,7,5,14,21
1197,PHX,1,240,47,82,57.3,8,25,32,39,57,68.42,15,18,83.3,6,38,44,25,7,5,17,24
1198,MIA,0,240,30,80,37.5,12,37,32.4,18,43,41.86,15,18,83.3,12,24,36,22,9,1,18,22
1199,IND,0,240,41,94,43.6,14,31,45.2,27,63,42.86,14,23,60.9,14,26,40,28,9,4,11,20
1200,DEN,1,240,43,88,48.9,8,22,36.4,35,66,53.03,19,28,67.9,13,37,50,29,9,11,14,16
1201,BKN,0,240,44,90,48.9,14,39,35.9,30,51,58.82,12,16,75,6,30,36,29,6,5,13,21
1202,HOU,0,240,41,94,43.6,10,35,28.6,31,59,52.54,15,22,68.2,11,38,49,26,9,3,15,17
1203,WAS,0,240,39,91,42.9,8,27,29.6,31,64,48.44,18,22,81.8,12,28,40,31,6,9,13,23
1204,LAL,1,240,47,86,54.7,13,33,39.4,34,53,64.15,27,29,93.1,10,35,45,28,9,6,14,18
1205,ORL,1,240,37,78,47.4,9,28,32.1,28,50,56,22,28,78.6,12,32,44,21,5,5,14,16
1206,BOS,1,240,43,98,43.9,17,47,36.2,26,51,50.98,13,18,72.2,16,39,55,31,10,12,16,17
1207,TOR,0,240,38,92,41.3,11,34,32.4,27,58,46.55,13,23,56.5,11,20,31,29,10,5,10,18
1208,WAS,0,240,49,103,47.6,9,29,31,40,74,54.05,20,23,87,14,32,46,28,10,4,12,21
1209,PHI,1,240,36,85,42.4,5,25,20,31,60,51.67,20,24,83.3,6,40,46,21,7,6,10,12
1210,ATL,0,240,37,93,39.8,11,38,28.9,26,55,47.27,10,15,66.7,11,34,45,25,5,4,11,15
1211,MEM,0,240,32,75,42.7,13,42,31,19,33,57.58,19,23,82.6,3,29,32,28,6,4,16,13
1212,CHI,1,240,47,91,51.6,14,33,42.4,33,58,56.9,17,21,81,13,39,52,32,11,5,12,18
1213,MIL,1,240,47,85,55.3,12,32,37.5,35,53,66.04,35,49,71.4,8,41,49,30,6,6,10,18
1214,CHA,0,240,35,85,41.2,9,37,24.3,26,48,54.17,10,14,71.4,7,40,47,23,2,7,17,20
1215,CLE,1,240,43,85,50.6,16,43,37.2,27,42,64.29,14,16,87.5,4,45,49,32,7,6,14,16
1216,NYK,1,240,48,88,54.5,14,39,35.9,34,49,69.39,16,20,80,15,46,61,27,4,7,22,20
1217,MIN,0,240,31,75,41.3,14,37,37.8,17,38,44.74,21,29,72.4,9,41,50,22,4,7,21,26
1218,UTA,0,265,48,105,45.7,13,43,30.2,35,62,56.45,17,22,77.3,16,43,59,28,4,8,17,24
1219,SAS,1,240,51,96,53.1,12,31,38.7,39,65,60,17,23,73.9,14,35,49,38,6,10,17,19
1220,HOU,1,265,50,117,42.7,13,39,33.3,37,78,47.44,14,22,63.6,23,33,56,27,11,10,7,22
1221,OKC,1,240,32,81,39.5,8,24,33.3,24,57,42.11,30,35,85.7,9,28,37,21,12,4,8,20
1222,DET,0,240,44,94,46.8,21,37,56.8,23,57,40.35,26,32,81.3,9,31,40,30,6,2,9,30
1223,DEN,1,240,42,81,51.9,8,31,25.8,34,50,68,10,13,76.9,10,37,47,20,0,3,11,13
1224,MIA,0,240,38,82,46.3,12,31,38.7,26,51,50.98,20,22,90.9,13,31,44,21,7,2,18,17
1225,SAS,0,240,47,84,56,15,32,46.9,32,52,61.54,11,17,64.7,7,27,34,36,9,3,13,17
1226,NOP,0,240,41,93,44.1,10,42,23.8,31,51,60.78,17,23,73.9,9,33,42,27,4,5,11,16
1227,CHA,1,240,47,84,56,16,29,55.2,31,55,56.36,14,16,87.5,10,30,40,25,9,4,18,16
1228,ORL,0,240,37,78,47.4,10,23,43.5,27,55,49.09,25,27,92.6,11,25,36,24,3,5,16,23
1229,PHI,1,240,42,87,48.3,13,30,43.3,29,57,50.88,27,29,93.1,16,26,42,23,11,5,8,23
1230,POR,1,240,42,84,50,4,12,33.3,38,72,52.78,30,35,85.7,9,38,47,18,3,11,11,21
1231,LAL,0,240,40,90,44.4,12,33,36.4,28,57,49.12,20,24,83.3,10,34,44,31,7,3,14,11
1232,ATL,1,240,40,87,46,15,35,42.9,25,52,48.08,14,17,82.4,9,29,38,23,6,2,15,20
1233,PHX,1,240,46,93,49.5,15,41,36.6,31,52,59.62,16,21,76.2,7,41,48,32,7,3,10,17
1234,IND,0,240,39,91,42.9,20,47,42.6,19,44,43.18,17,25,68,6,31,37,34,3,6,14,26
1235,BKN,1,240,50,95,52.6,19,47,40.4,31,48,64.58,11,14,78.6,8,33,41,31,10,4,11,17
1236,BOS,0,240,38,89,42.7,14,44,31.8,24,45,53.33,10,14,71.4,12,26,38,21,5,2,3,17
1237,WAS,0,240,41,90,45.6,10,31,32.3,31,59,52.54,17,22,77.3,9,37,46,31,9,4,12,24
1238,MEM,0,240,39,85,45.9,14,34,41.2,25,51,49.02,11,17,64.7,8,26,34,22,9,4,15,23
1239,UTA,0,240,43,89,48.3,13,32,40.6,30,57,52.63,30,36,83.3,11,27,38,33,7,4,15,21
1240,CHI,1,240,48,91,52.7,6,24,25,42,67,62.69,14,17,82.4,9,33,42,30,7,5,12,22
1241,MIN,1,240,45,82,54.9,12,28,42.9,33,54,61.11,16,21,76.2,6,33,39,30,8,9,15,13
1242,SAC,0,240,44,85,51.8,15,37,40.5,29,48,60.42,18,32,56.3,8,30,38,27,7,6,11,20
1243,OKC,1,240,48,86,55.8,14,32,43.8,34,54,62.96,24,28,85.7,7,31,38,36,8,10,16,29
1244,TOR,0,240,42,83,50.6,10,38,26.3,32,45,71.11,16,20,80,7,31,38,31,7,5,14,18
1245,NYK,1,240,39,86,45.3,13,38,34.2,26,48,54.17,22,26,84.6,7,40,47,22,6,5,17,18
1246,IND,1,240,49,89,55.1,13,33,39.4,36,56,64.29,15,19,78.9,4,30,34,33,5,6,12,20
1247,SAS,0,240,39,93,41.9,7,34,20.6,32,59,54.24,13,16,81.3,11,30,41,26,5,3,10,15
1248,CHA,0,240,39,90,43.3,19,45,42.2,20,45,44.44,15,18,83.3,15,26,41,29,7,8,14,19
1249,DAL,0,240,42,91,46.2,11,40,27.5,31,51,60.78,15,18,83.3,11,32,43,26,4,5,15,19
1250,CLE,1,240,55,93,59.1,12,28,42.9,43,65,66.15,13,19,68.4,11,44,55,36,5,3,11,9
1251,LAL,1,240,49,91,53.8,12,28,42.9,37,63,58.73,17,24,70.8,9,36,45,33,8,1,11,15
1252,NOP,1,240,44,88,50,25,47,53.2,19,41,46.34,19,23,82.6,16,34,50,32,11,3,13,14
1253,DET,0,240,46,89,51.7,12,31,38.7,34,58,58.62,13,19,68.4,8,32,40,30,4,7,12,18
1254,MIL,0,240,38,95,40,12,42,28.6,26,53,49.06,7,10,70,9,27,36,19,6,6,10,18
1255,BOS,1,240,42,90,46.7,18,38,47.4,24,52,46.15,15,19,78.9,12,42,54,22,5,6,14,15
1256,TOR,1,240,45,88,51.1,20,38,52.6,25,50,50,11,18,61.1,13,32,45,34,9,4,12,14
1257,NYK,1,240,39,87,44.8,13,37,35.1,26,50,52,18,22,81.8,12,39,51,24,6,5,15,20
1258,HOU,0,240,35,84,41.7,8,30,26.7,27,54,50,16,19,84.2,6,32,38,23,6,9,10,18
1259,POR,1,240,42,86,48.8,9,27,33.3,33,59,55.93,12,14,85.7,10,31,41,21,2,2,13,16
1260,BKN,0,240,35,73,47.9,15,38,39.5,20,35,57.14,18,27,66.7,6,27,33,28,9,3,11,14
1261,ORL,0,240,39,88,44.3,10,35,28.6,29,53,54.72,16,22,72.7,16,24,40,18,16,8,13,22
1262,MIA,0,240,41,90,45.6,6,28,21.4,35,62,56.45,9,12,75,12,25,37,24,4,5,14,13
1263,MIN,1,240,47,93,50.5,15,30,50,32,63,50.79,15,21,71.4,9,33,42,32,7,5,11,14
1264,ATL,1,240,39,76,51.3,8,25,32,31,51,60.78,20,22,90.9,10,31,41,21,8,2,23,17
1265,PHI,1,240,43,76,56.6,15,31,48.4,28,45,62.22,25,34,73.5,5,27,32,27,6,7,8,21
1266,SAC,0,240,46,92,50,18,40,45,28,52,53.85,7,12,58.3,5,26,31,34,7,4,14,20
1267,LAC,1,240,47,87,54,20,43,46.5,27,44,61.36,14,23,60.9,12,27,39,30,5,10,10,18
1268,DEN,0,240,45,89,50.6,12,29,41.4,33,60,55,19,25,76,16,30,46,23,4,3,11,19
1269,OKC,0,240,42,83,50.6,16,34,47.1,26,49,53.06,17,20,85,9,26,35,30,5,5,12,19
1270,PHX,1,240,42,85,49.4,17,37,45.9,25,48,52.08,18,20,90,8,38,46,32,7,6,20,15
1271,IND,0,240,38,95,40,9,31,29,29,64,45.31,20,25,80,18,25,43,27,9,4,14,31
1272,LAL,1,240,44,84,52.4,8,24,33.3,36,60,60,16,18,88.9,8,36,44,30,7,9,17,12
1273,BKN,0,265,34,99,34.3,12,55,21.8,22,44,50,15,16,93.8,9,41,50,26,9,9,8,17
1274,DET,1,240,50,90,55.6,12,31,38.7,38,59,64.41,17,23,73.9,12,40,52,30,4,10,16,13
1275,GSW,0,240,44,90,48.9,10,31,32.3,34,59,57.63,9,10,90,7,38,45,28,4,6,19,25
1276,MIA,1,265,33,87,37.9,8,31,25.8,25,56,44.64,22,25,88,6,48,54,22,6,4,13,16
1277,OKC,0,240,40,96,41.7,15,49,30.6,25,47,53.19,10,11,90.9,13,27,40,23,11,6,11,18
1278,WAS,0,240,44,95,46.3,19,41,46.3,25,54,46.3,10,11,90.9,8,25,33,30,8,7,8,19
1279,MEM,1,240,32,86,37.2,20,54,37,12,32,37.5,32,40,80,11,31,42,24,13,10,13,12
1280,ORL,1,240,38,85,44.7,8,29,27.6,30,56,53.57,14,21,66.7,13,33,46,26,2,3,8,20
1281,NOP,0,240,41,81,50.6,7,23,30.4,34,58,58.62,31,41,75.6,8,29,37,21,9,2,10,28
1282,BOS,1,240,33,82,40.2,16,39,41,17,43,39.53,23,25,92,5,48,53,20,3,7,13,16
1283,CHI,0,240,35,83,42.2,9,32,28.1,26,51,50.98,12,16,75,6,37,43,21,8,6,19,17
1284,ATL,1,240,40,93,43,13,38,34.2,27,55,49.09,16,21,76.2,13,44,57,24,8,6,20,19
1285,TOR,0,240,38,95,40,4,32,12.5,34,63,53.97,16,21,76.2,9,43,52,25,6,2,7,21
1286,CLE,1,240,39,95,41.1,20,57,35.1,19,38,50,11,11,100,13,35,48,28,9,3,14,14
1287,DAL,1,240,39,85,45.9,18,43,41.9,21,42,50,29,35,82.9,13,29,42,24,4,6,12,29
1288,PHI,1,240,40,83,48.2,15,31,48.4,25,52,48.08,29,34,85.3,8,33,41,25,8,4,11,24
1289,NYK,0,240,33,83,39.8,13,40,32.5,20,43,46.51,15,22,68.2,13,28,41,20,3,3,10,20
1290,UTA,1,240,45,81,55.6,11,25,44,34,56,60.71,31,35,88.6,10,36,46,29,5,8,15,17
1291,HOU,0,240,44,88,50,8,27,29.6,36,61,59.02,19,32,59.4,16,30,46,21,7,9,13,23
1292,SAS,0,240,38,95,40,11,42,26.2,27,53,50.94,12,17,70.6,9,35,44,27,10,8,18,18
1293,IND,0,240,43,92,46.7,8,29,27.6,35,63,55.56,15,22,68.2,14,23,37,28,11,1,13,21
1294,MIL,1,265,48,92,52.2,20,43,46.5,28,49,57.14,27,32,84.4,4,36,40,31,5,3,14,22
1295,CHA,0,240,33,95,34.7,10,41,24.4,23,54,42.59,11,15,73.3,17,33,50,17,5,3,15,17
1296,PHX,1,240,46,76,60.5,13,28,46.4,33,48,68.75,22,27,81.5,7,34,41,27,7,5,14,20
1297,SAC,0,265,55,105,52.4,17,41,41.5,38,64,59.38,15,20,75,9,38,47,34,6,2,9,19
1298,DEN,1,240,46,71,64.8,10,20,50,36,51,70.59,15,23,65.2,4,36,40,31,8,3,22,18
1299,MIN,1,240,38,67,56.7,13,26,50,25,41,60.98,20,31,64.5,6,35,41,25,8,5,19,23
1300,POR,0,240,40,89,44.9,20,42,47.6,20,47,42.55,16,22,72.7,12,24,36,23,8,1,14,21
1301,LAC,0,240,36,83,43.4,17,39,43.6,19,44,43.18,16,18,88.9,7,27,34,28,9,4,11,24
1302,MIA,1,240,40,81,49.4,11,25,44,29,56,51.79,13,16,81.3,4,40,44,27,6,6,14,15
1303,BOS,1,240,51,95,53.7,24,47,51.1,27,48,56.25,19,25,76,10,40,50,26,7,8,12,21
1304,NYK,1,240,40,83,48.2,13,38,34.2,27,45,60,13,19,68.4,15,41,56,25,11,11,23,15
1305,ATL,0,240,32,93,34.4,11,40,27.5,21,53,39.62,24,33,72.7,16,34,50,21,9,7,16,20
1306,DAL,0,240,37,82,45.1,15,41,36.6,22,41,53.66,19,20,95,9,25,34,23,6,1,12,25
1307,MIL,1,240,51,94,54.3,13,31,41.9,38,63,60.32,14,17,82.4,14,36,50,33,6,5,12,15
1308,WAS,1,240,47,97,48.5,12,32,37.5,35,65,53.85,21,26,80.8,12,42,54,32,10,9,12,22
1309,SAS,0,240,39,95,41.1,18,46,39.1,21,49,42.86,20,23,87,12,35,47,26,7,4,9,19
1310,ORL,0,240,39,84,46.4,7,35,20,32,49,65.31,15,24,62.5,11,39,50,21,5,8,16,22
1311,GSW,0,240,47,98,48,15,36,41.7,32,62,51.61,9,14,64.3,12,29,41,23,5,4,8,16
1312,UTA,1,240,42,93,45.2,12,37,32.4,30,56,53.57,36,39,92.3,13,39,52,28,7,5,10,20
1313,CHI,1,240,46,90,51.1,15,34,44.1,31,56,55.36,15,20,75,7,40,47,31,5,8,9,18
1314,LAL,0,240,46,92,50,13,29,44.8,33,63,52.38,20,24,83.3,7,33,40,30,6,8,12,23
1315,NOP,1,240,39,79,49.4,12,30,40,27,49,55.1,28,37,75.7,14,30,44,29,7,4,11,20
1316,MEM,0,240,36,87,41.4,9,38,23.7,27,49,55.1,13,15,86.7,9,26,35,27,14,6,12,16
1317,OKC,1,240,43,94,45.7,8,36,22.2,35,58,60.34,18,21,85.7,12,34,46,23,9,4,9,19
1318,HOU,0,240,40,99,40.4,7,30,23.3,33,69,47.83,26,30,86.7,15,35,50,20,10,3,13,18
1319,ATL,0,240,40,89,44.9,11,30,36.7,29,59,49.15,17,23,73.9,12,16,28,25,14,2,15,13
1320,HOU,1,240,41,90,45.6,8,30,26.7,33,60,55,22,25,88,10,31,41,21,8,5,9,16
1321,NOP,0,240,42,89,47.2,13,33,39.4,29,56,51.79,16,22,72.7,8,27,35,30,9,3,9,10
1322,MIN,1,240,44,80,55,11,31,35.5,33,49,67.35,17,24,70.8,8,37,45,35,14,5,16,23
1323,SAC,0,240,32,95,33.7,8,38,21.1,24,57,42.11,21,26,80.8,23,31,54,20,6,4,17,18
1324,MIA,1,240,37,83,44.6,8,26,30.8,29,57,50.88,17,20,85,12,29,41,23,6,1,17,17
1325,DET,0,240,44,88,50,12,35,34.3,32,53,60.38,10,16,62.5,11,35,46,32,6,9,15,21
1326,LAC,1,240,49,89,55.1,15,31,48.4,34,58,58.62,15,20,75,11,32,43,22,9,7,12,16
1327,IND,1,240,53,79,67.1,11,18,61.1,42,61,68.85,9,12,75,10,35,45,41,12,9,27,21
1328,TOR,0,240,35,81,43.2,17,34,50,18,47,38.3,26,37,70.3,8,23,31,25,5,8,13,21
1329,CHI,0,240,50,86,58.1,18,40,45,32,46,69.57,13,16,81.3,6,30,36,31,1,3,12,21
1330,GSW,1,240,49,94,52.1,20,47,42.6,29,47,61.7,22,30,73.3,13,31,44,39,7,4,5,16
1331,DEN,1,240,50,90,55.6,14,33,42.4,36,57,63.16,11,15,73.3,10,38,48,30,5,4,17,18
1332,SAS,1,240,45,87,51.7,18,38,47.4,27,49,55.1,27,34,79.4,7,38,45,31,9,7,15,20
1333,PHI,1,240,40,93,43,15,35,42.9,25,58,43.1,17,18,94.4,14,32,46,23,11,9,14,19
1334,MEM,0,240,41,95,43.2,18,44,40.9,23,51,45.1,19,27,70.4,17,29,46,30,5,4,9,21
1335,UTA,1,240,52,93,55.9,21,43,48.8,31,50,62,20,26,76.9,14,42,56,34,7,8,14,23
1336,CHA,0,240,32,89,36,10,34,29.4,22,55,40,25,28,89.3,16,28,44,22,11,3,20,24
1337,POR,0,240,30,77,39,10,28,35.7,20,49,40.82,23,34,67.6,10,28,38,18,8,5,20,19
1338,ORL,0,240,36,82,43.9,12,40,30,24,42,57.14,12,20,60,10,28,38,26,10,8,13,20
1339,BOS,0,240,34,91,37.4,9,35,25.7,25,56,44.64,25,30,83.3,6,25,31,22,5,5,6,13
1340,PHX,1,240,46,93,49.5,14,39,35.9,32,54,59.26,21,23,91.3,13,33,46,23,12,3,13,16
1341,POR,0,240,28,101,27.7,11,49,22.4,17,52,32.69,10,16,62.5,13,29,42,16,8,8,10,19
1342,DAL,1,240,44,88,50,17,41,41.5,27,47,57.45,23,30,76.7,11,27,38,27,6,2,10,19
1343,LAL,0,240,40,80,50,13,34,38.2,27,46,58.7,16,25,64,7,30,37,33,8,4,18,19
1344,MIL,1,240,52,92,56.5,18,42,42.9,34,50,68,13,16,81.3,12,42,54,34,3,6,11,22
1345,CLE,1,240,32,82,39,13,44,29.5,19,38,50,34,43,79.1,12,35,47,16,11,6,11,24
1346,NYK,0,240,44,89,49.4,14,42,33.3,30,47,63.83,22,28,78.6,13,32,45,27,7,2,16,25
1347,BKN,0,240,37,82,45.1,8,27,29.6,29,55,52.73,20,28,71.4,9,32,41,18,5,4,17,29
1348,OKC,1,240,53,93,57,14,35,40,39,58,67.24,19,22,86.4,8,51,59,41,6,8,13,10
1349,WAS,0,240,38,88,43.2,7,31,22.6,31,57,54.39,21,30,70,13,33,46,24,8,8,14,23
1350,LAC,1,240,49,93,52.7,15,34,44.1,34,59,57.63,13,13,100,11,25,36,34,6,5,7,17
1351,GSW,0,240,39,89,43.8,12,39,30.8,27,50,54,15,18,83.3,14,29,43,24,4,4,17,19
1352,ATL,1,265,48,102,47.1,12,34,35.3,36,68,52.94,31,42,73.8,16,39,55,32,6,8,13,21
1353,SAS,1,240,49,94,52.1,9,27,33.3,40,67,59.7,23,27,85.2,10,36,46,36,7,4,5,15
1354,DEN,0,240,37,81,45.7,13,33,39.4,24,48,50,24,28,85.7,8,26,34,26,11,4,16,23
1355,OKC,1,240,51,86,59.3,14,33,42.4,37,53,69.81,12,16,75,4,38,42,36,4,4,13,19
1356,CHA,0,240,35,87,40.2,16,38,42.1,19,49,38.78,12,16,75,8,28,36,17,2,3,10,16
1357,NOP,1,240,54,94,57.4,19,40,47.5,35,54,64.81,14,19,73.7,13,34,47,37,11,7,11,19
1358,SAC,1,240,46,89,51.7,13,35,37.1,33,54,61.11,18,23,78.3,14,39,53,24,2,8,10,15
1359,CHI,1,265,42,95,44.2,19,47,40.4,23,48,47.92,21,25,84,8,38,46,31,9,4,14,19
1360,BOS,1,265,39,90,43.3,19,47,40.4,20,43,46.51,30,31,96.8,7,39,46,21,5,4,8,19
1361,PHI,0,265,46,102,45.1,12,34,35.3,34,68,50,28,33,84.8,13,38,51,26,8,9,11,28
1362,IND,1,240,41,92,44.6,8,25,32,33,67,49.25,22,24,91.7,14,40,54,31,7,6,14,22
1363,UTA,1,240,46,83,55.4,13,33,39.4,33,50,66,19,23,82.6,7,33,40,34,12,8,17,19
1364,HOU,0,265,48,101,47.5,11,45,24.4,37,56,66.07,12,20,60,9,41,50,29,9,4,14,18
1365,TOR,0,240,46,84,54.8,12,30,40,34,54,62.96,16,18,88.9,7,30,37,31,4,2,15,17
1366,DET,0,240,44,96,45.8,10,32,31.3,34,64,53.12,10,13,76.9,9,34,43,33,4,3,10,19
1367,MIN,0,265,44,95,46.3,14,34,41.2,30,61,49.18,18,20,90,8,39,47,22,4,6,9,27
1368,MIA,0,240,41,89,46.1,15,36,41.7,26,53,49.06,23,28,82.1,8,30,38,25,8,3,10,13
1369,MIN,1,240,43,80,53.8,12,30,40,31,50,62,15,19,78.9,5,43,48,34,8,4,18,18
1370,DAL,0,240,36,82,43.9,9,27,33.3,27,55,49.09,22,27,81.5,8,25,33,20,9,4,13,17
1371,ORL,0,240,34,94,36.2,13,42,31,21,52,40.38,11,18,61.1,16,30,46,20,13,5,13,22
1372,MEM,1,240,44,91,48.4,14,37,37.8,30,54,55.56,18,21,85.7,18,36,54,27,7,3,17,18
1373,DET,0,240,40,85,47.1,14,37,37.8,26,48,54.17,16,21,76.2,13,27,40,27,12,2,21,19
1374,LAL,1,240,44,81,54.3,16,36,44.4,28,45,62.22,28,36,77.8,5,34,39,34,6,4,15,16
1375,TOR,0,240,53,94,56.4,17,35,48.6,36,59,61.02,8,13,61.5,5,32,37,34,8,4,12,26
1376,SAC,1,240,54,94,57.4,13,33,39.4,41,61,67.21,10,14,71.4,10,34,44,39,8,6,18,21
1377,POR,0,240,33,86,38.4,6,29,20.7,27,57,47.37,12,18,66.7,12,31,43,19,8,7,15,17
1378,NYK,1,240,37,89,41.6,18,48,37.5,19,41,46.34,20,23,87,15,40,55,26,11,4,15,16
1379,IND,1,240,48,91,52.7,19,40,47.5,29,51,56.86,18,22,81.8,9,30,39,29,6,7,13,23
1380,UTA,1,240,47,90,52.2,20,44,45.5,27,46,58.7,18,22,81.8,10,37,47,33,6,8,11,15
1381,PHX,0,240,38,77,49.4,10,30,33.3,28,47,59.57,25,29,86.2,5,20,25,17,6,4,14,20
1382,WAS,0,240,44,89,49.4,15,32,46.9,29,57,50.88,25,29,86.2,12,26,38,32,7,5,15,23
1383,MIL,0,240,42,94,44.7,17,36,47.2,25,58,43.1,15,19,78.9,11,27,38,31,6,6,9,20
1384,BOS,0,240,47,90,52.2,17,35,48.6,30,55,54.55,20,29,69,13,29,42,26,3,8,15,20
1385,HOU,0,240,37,88,42,14,41,34.1,23,47,48.94,25,28,89.3,12,30,42,20,8,4,12,31
1386,MIA,1,240,41,82,50,15,36,41.7,26,46,56.52,23,32,71.9,10,35,45,30,6,5,11,21
1387,CHI,1,265,45,92,48.9,9,26,34.6,36,66,54.55,20,24,83.3,12,39,51,27,7,7,14,18
1388,CHA,0,265,40,94,42.6,17,42,40.5,23,52,44.23,15,17,88.2,14,30,44,26,3,7,15,22
1389,LAC,1,240,53,85,62.4,15,29,51.7,38,56,67.86,17,23,73.9,11,33,44,32,11,3,14,21
1390,OKC,1,240,52,88,59.1,14,28,50,38,60,63.33,18,24,75,10,30,40,37,11,7,15,21
1391,LAL,1,240,42,82,51.2,11,29,37.9,31,53,58.49,11,16,68.8,8,32,40,23,9,6,19,11
1392,NOP,1,240,50,82,61,19,35,54.3,31,47,65.96,14,16,87.5,9,42,51,35,2,9,16,14
1393,TOR,1,240,55,94,58.5,15,33,45.5,40,61,65.57,8,14,57.1,9,36,45,38,7,6,7,14
1394,MEM,1,240,43,97,44.3,17,49,34.7,26,48,54.17,18,24,75,15,39,54,29,7,8,18,24
1395,LAC,0,240,36,91,39.6,14,37,37.8,22,54,40.74,17,19,89.5,13,27,40,21,12,5,16,19
1396,PHX,0,240,46,102,45.1,8,28,28.6,38,74,51.35,15,22,68.2,16,34,50,29,5,6,12,27
1397,BKN,0,265,46,91,50.5,14,37,37.8,32,54,59.26,21,25,84,9,35,44,29,7,7,16,25
1398,POR,1,265,45,95,47.4,20,38,52.6,25,57,43.86,24,30,80,9,29,38,21,5,5,10,20
1399,DEN,1,240,47,80,58.8,10,27,37,37,53,69.81,27,31,87.1,6,32,38,35,6,10,14,23
1400,GSW,0,240,45,100,45,14,46,30.4,31,54,57.41,14,15,93.3,15,28,43,30,5,4,11,11
1401,DAL,1,240,43,95,45.3,15,40,37.5,28,55,50.91,14,20,70,15,29,44,20,7,8,11,19
1402,DET,0,240,42,89,47.2,9,24,37.5,33,65,50.77,21,30,70,13,24,37,28,6,0,12,20
1403,ATL,0,265,42,91,46.2,9,30,30,33,61,54.1,17,29,58.6,8,42,50,21,9,10,13,23
1404,MIN,0,240,41,94,43.6,13,41,31.7,28,53,52.83,13,21,61.9,18,33,51,22,6,4,13,22
1405,CLE,1,240,43,88,48.9,16,43,37.2,27,45,60,15,21,71.4,12,32,44,27,6,3,16,16
1406,SAC,0,240,38,91,41.8,15,45,33.3,23,46,50,9,12,75,8,17,25,28,9,2,9,12
1407,SAS,0,240,41,86,47.7,14,37,37.8,27,49,55.1,19,22,86.4,8,32,40,22,10,6,11,18
1408,ORL,1,265,43,98,43.9,17,41,41.5,26,57,45.61,14,22,63.6,13,44,57,25,8,3,13,24
1409,UTA,1,240,46,80,57.5,8,30,26.7,38,50,76,20,24,83.3,9,39,48,30,4,4,24,18
1410,PHI,0,240,42,104,40.4,7,38,18.4,35,66,53.03,18,23,78.3,15,19,34,30,12,6,6,20
1411,IND,0,240,38,92,41.3,8,42,19,30,50,60,17,22,77.3,10,28,38,23,12,2,9,18
1412,WAS,0,240,40,85,47.1,13,37,35.1,27,48,56.25,12,20,60,12,33,45,33,5,3,20,20
1413,BOS,1,240,46,90,51.1,16,41,39,30,49,61.22,10,19,52.6,13,43,56,26,6,6,18,20
1414,MIL,0,240,35,76,46.1,9,34,26.5,26,42,61.9,29,42,69,4,37,41,20,7,4,11,24
1415,HOU,1,240,36,83,43.4,13,34,38.2,23,49,46.94,27,32,84.4,7,39,46,22,7,2,10,24
1416,NYK,1,240,43,87,49.4,14,36,38.9,29,51,56.86,21,24,87.5,11,34,45,27,9,2,14,16
1417,MIN,1,240,46,88,52.3,14,33,42.4,32,55,58.18,16,20,80,9,43,52,31,12,7,14,18
1418,BOS,1,240,39,90,43.3,17,49,34.7,22,41,53.66,31,36,86.1,9,47,56,24,9,8,14,23
1419,CLE,1,240,41,77,53.2,16,33,48.5,25,44,56.82,16,23,69.6,12,40,52,31,9,1,24,19
1420,HOU,0,240,36,90,40,12,32,37.5,24,58,41.38,11,15,73.3,7,31,38,18,7,2,15,15
1421,PHX,1,240,44,87,50.6,14,35,40,30,52,57.69,11,17,64.7,9,35,44,30,13,5,11,18
1422,OKC,0,240,45,84,53.6,9,31,29,36,53,67.92,16,24,66.7,7,29,36,29,8,5,13,26
1423,WAS,0,240,35,84,41.7,9,30,30,26,54,48.15,11,15,73.3,7,24,31,19,12,8,17,19
1424,POR,0,240,39,95,41.1,13,40,32.5,26,55,47.27,12,17,70.6,10,32,42,27,9,3,19,15
1425,CHI,1,240,40,74,54.1,10,28,35.7,30,46,65.22,14,17,82.4,4,37,41,29,7,6,15,17
1426,ATL,0,240,40,93,43,10,42,23.8,30,51,58.82,26,30,86.7,14,25,39,21,6,3,14,11
1427,LAL,0,240,42,85,49.4,10,28,35.7,32,57,56.14,19,27,70.4,8,27,35,26,13,3,14,14
1428,DEN,0,240,48,95,50.5,9,33,27.3,39,62,62.9,15,19,78.9,9,29,38,28,8,1,13,23
1429,GSW,1,240,38,82,46.3,16,38,42.1,22,44,50,21,25,84,7,38,45,24,3,5,19,18
1430,SAC,1,240,52,100,52,21,38,55.3,31,62,50,10,15,66.7,11,31,42,35,4,1,15,23
1431,MEM,1,240,44,82,53.7,23,45,51.1,21,37,56.76,16,20,80,6,38,44,33,8,4,19,20
1432,TOR,0,240,47,87,54,13,37,35.1,34,50,68,23,27,85.2,8,29,37,31,5,10,14,20
1433,NYK,1,240,43,89,48.3,18,41,43.9,25,48,52.08,24,25,96,10,39,49,27,7,7,13,22
1434,LAC,1,240,40,82,48.8,15,36,41.7,25,46,54.35,16,20,80,10,40,50,28,6,7,15,18
1435,DAL,1,240,56,96,58.3,17,38,44.7,39,58,67.24,10,15,66.7,10,42,52,35,11,8,17,21
1436,BKN,1,240,41,91,45.1,14,39,35.9,27,52,51.92,28,33,84.8,20,31,51,25,9,3,15,24
1437,NOP,0,240,33,92,35.9,12,29,41.4,21,63,33.33,17,23,73.9,14,29,43,22,9,5,9,17
1438,PHI,0,240,33,81,40.7,6,23,26.1,27,58,46.55,20,27,74.1,8,30,38,22,8,9,14,18
1439,MIA,0,240,34,83,41,10,37,27,24,46,52.17,19,22,86.4,11,33,44,26,5,2,16,21
1440,DET,0,240,44,98,44.9,13,44,29.5,31,54,57.41,8,10,80,10,30,40,25,8,9,11,23
1441,UTA,0,240,34,94,36.2,6,34,17.6,28,60,46.67,23,34,67.6,16,41,57,23,11,2,18,24
1442,ORL,1,240,41,82,50,17,36,47.2,24,46,52.17,23,34,67.6,11,29,40,25,9,3,15,20
1443,IND,1,240,60,94,63.8,19,39,48.7,41,55,74.55,11,13,84.6,8,31,39,50,12,3,16,24
1444,CHA,0,240,36,89,40.4,10,34,29.4,26,55,47.27,9,12,75,12,30,42,20,7,1,13,20
1445,GSW,0,240,49,90,54.4,15,36,41.7,34,54,62.96,14,16,87.5,9,24,33,35,4,3,10,20
1446,MIL,1,240,49,92,53.3,12,34,35.3,37,58,63.79,15,19,78.9,8,34,42,27,5,5,14,16
1447,DEN,1,240,48,85,56.5,9,26,34.6,39,59,66.1,25,29,86.2,11,25,36,28,7,4,9,15
1448,SAS,0,240,46,95,48.4,14,40,35,32,55,58.18,15,17,88.2,10,32,42,31,10,8,12,16
1449,POR,0,240,34,87,39.1,13,40,32.5,21,47,44.68,16,22,72.7,10,36,46,23,4,3,22,34
1450,NYK,1,240,46,89,51.7,15,38,39.5,31,51,60.78,9,11,81.8,13,39,52,29,6,7,16,17
1451,OKC,0,240,50,91,54.9,18,36,50,32,55,58.18,20,26,76.9,9,28,37,30,10,1,13,23
1452,SAC,1,290,51,105,48.6,15,40,37.5,36,65,55.38,21,31,67.7,18,40,58,36,9,3,21,21
1453,MIN,0,240,37,82,45.1,10,31,32.3,27,51,52.94,22,27,81.5,8,20,28,26,7,6,13,13
1454,BKN,0,240,36,93,38.7,13,44,29.5,23,49,46.94,16,26,61.5,15,35,50,25,11,6,10,19
1455,HOU,1,240,37,76,48.7,19,39,48.7,18,37,48.65,19,27,70.4,5,43,48,27,5,4,16,19
1456,ORL,0,290,44,90,48.9,25,44,56.8,19,46,41.3,22,27,81.5,7,32,39,33,10,7,21,30
1457,DET,0,265,56,105,53.3,19,41,46.3,37,64,57.81,17,22,77.3,16,32,48,33,5,3,17,27
1458,TOR,1,240,41,85,48.2,12,26,46.2,29,59,49.15,22,27,81.5,7,39,46,25,5,6,12,20
1459,CHI,0,240,37,89,41.6,13,32,40.6,24,57,42.11,13,16,81.3,11,28,39,24,9,7,11,17
1460,IND,1,240,50,90,55.6,14,35,40,36,55,65.45,28,34,82.4,7,37,44,34,7,5,11,27
1461,LAL,0,240,35,83,42.2,4,30,13.3,31,53,58.49,22,24,91.7,9,41,50,29,3,6,22,14
1462,WAS,0,240,42,101,41.6,12,35,34.3,30,66,45.45,5,11,45.5,12,24,36,22,8,5,8,14
1463,CLE,1,240,54,101,53.5,20,42,47.6,34,59,57.63,12,16,75,18,44,62,37,5,8,11,13
1464,PHX,0,240,42,79,53.2,15,35,42.9,27,44,61.36,23,26,88.5,10,22,32,23,9,2,17,23
1465,DAL,1,240,42,84,50,13,30,43.3,29,54,53.7,29,41,70.7,7,36,43,25,12,7,12,18
1466,NOP,1,240,45,81,55.6,12,26,46.2,33,55,60,15,17,88.2,9,32,41,30,7,5,14,24
1467,UTA,1,265,53,103,51.5,16,32,50,37,71,52.11,32,35,91.4,15,28,43,28,11,8,12,22
1468,MEM,0,240,40,94,42.6,15,42,35.7,25,52,48.08,16,19,84.2,9,34,43,25,7,5,10,19
1469,LAC,1,240,42,76,55.3,18,34,52.9,24,42,57.14,29,32,90.6,10,26,36,25,9,5,14,18
1470,MIL,0,240,46,92,50,14,37,37.8,32,55,58.18,24,32,75,10,32,42,30,6,4,13,25
1471,MIA,1,240,41,93,44.1,16,42,38.1,25,51,49.02,12,17,70.6,7,32,39,30,14,3,10,23
1472,ATL,1,240,48,95,50.5,14,39,35.9,34,56,60.71,31,33,93.9,15,34,49,30,8,5,13,21
1473,SAS,0,240,36,85,42.4,10,31,32.3,26,54,48.15,16,23,69.6,6,34,40,21,6,8,16,24
1474,SAC,0,240,40,92,43.5,14,36,38.9,26,56,46.43,10,17,58.8,15,33,48,23,8,2,21,23
1475,MEM,1,240,37,80,46.3,12,38,31.6,25,42,59.52,20,25,80,8,38,46,24,5,8,15,23
1476,GSW,1,240,42,78,53.8,13,35,37.1,29,43,67.44,24,37,64.9,9,27,36,23,9,6,12,19
1477,OKC,1,240,48,91,52.7,18,40,45,30,51,58.82,13,17,76.5,10,28,38,34,7,10,12,22
1478,CHA,1,240,42,82,51.2,12,34,35.3,30,48,62.5,15,19,78.9,4,31,35,23,8,10,15,15
1479,ORL,0,240,41,92,44.6,14,36,38.9,27,56,48.21,19,23,82.6,16,25,41,19,8,4,18,24
1480,BKN,0,240,35,98,35.7,11,43,25.6,24,55,43.64,4,8,50,18,25,43,26,7,4,15,13
1481,NOP,1,240,41,88,46.6,16,39,41,25,49,51.02,14,18,77.8,17,36,53,23,10,9,17,12
1482,BOS,0,240,42,92,45.7,15,40,37.5,27,52,51.92,24,29,82.8,17,30,47,33,7,10,14,15
1483,PHI,1,240,38,80,47.5,12,30,40,26,50,52,22,30,73.3,6,37,43,28,9,6,19,22
1484,CHI,0,240,37,96,38.5,7,37,18.9,30,59,50.85,16,23,69.6,19,32,51,17,9,7,18,21
1485,UTA,1,240,49,96,51,12,44,27.3,37,52,71.15,17,18,94.4,7,46,53,37,9,6,13,15
1486,DET,0,240,40,83,48.2,13,29,44.8,27,54,50,20,27,74.1,10,27,37,27,3,4,18,21
1487,MIL,0,240,41,93,44.1,10,40,25,31,53,58.49,21,26,80.8,8,38,46,27,4,8,11,26
1488,CHA,0,240,36,86,41.9,10,26,38.5,26,60,43.33,11,16,68.8,8,37,45,24,4,5,14,15
1489,MIN,0,240,36,76,47.4,11,28,39.3,25,48,52.08,23,29,79.3,4,30,34,19,6,4,14,22
1490,MIA,0,240,35,83,42.2,11,34,32.4,24,49,48.98,23,29,79.3,12,23,35,24,7,3,14,17
1491,LAC,1,240,47,80,58.8,14,29,48.3,33,51,64.71,13,14,92.9,6,31,37,25,10,3,17,20
1492,HOU,1,240,51,91,56,15,35,42.9,36,56,64.29,19,24,79.2,6,33,39,34,11,1,10,19
1493,IND,1,240,43,97,44.3,5,35,14.3,38,62,61.29,31,38,81.6,14,38,52,23,7,5,7,24
1494,TOR,1,240,42,87,48.3,11,30,36.7,31,57,54.39,29,40,72.5,10,37,47,25,5,4,11,22
1495,PHX,1,240,38,80,47.5,11,29,37.9,27,51,52.94,22,33,66.7,9,38,47,24,10,5,16,20
1496,CLE,0,240,43,89,48.3,12,36,33.3,31,53,58.49,23,26,88.5,6,37,43,25,9,2,9,29
1497,POR,0,240,33,80,41.3,8,30,26.7,25,50,50,14,19,73.7,6,30,36,21,6,10,19,19
1498,DAL,0,240,37,93,39.8,11,40,27.5,26,53,49.06,5,10,50,8,33,41,28,6,5,16,15
1499,NYK,1,240,39,89,43.8,12,34,35.3,27,55,49.09,22,28,78.6,16,33,49,23,7,4,15,24
1500,DEN,1,240,41,83,49.4,15,38,39.5,26,45,57.78,14,18,77.8,4,40,44,27,9,9,11,15
1501,SAS,0,240,40,94,42.6,12,45,26.7,28,49,57.14,9,12,75,9,30,39,28,6,1,16,17
1502,BKN,0,240,38,100,38,12,46,26.1,26,54,48.15,20,31,64.5,17,30,47,26,9,2,7,21
1503,BOS,1,240,51,95,53.7,15,42,35.7,36,53,67.92,17,22,77.3,13,44,57,29,6,7,11,12
1504,LAL,0,240,39,82,47.6,10,32,31.3,29,50,58,21,25,84,4,31,35,26,8,10,13,15
1505,NOP,1,240,45,87,51.7,17,34,50,28,53,52.83,22,27,81.5,12,35,47,33,9,6,13,22
1506,ATL,1,240,47,95,49.5,12,32,37.5,35,63,55.56,24,37,64.9,12,46,58,27,5,3,12,18
1507,SAC,1,240,47,92,51.1,16,33,48.5,31,59,52.54,13,17,76.5,9,50,59,28,2,4,13,22
1508,MEM,0,240,30,82,36.6,12,40,30,18,42,42.86,20,28,71.4,1,33,34,20,4,1,8,14
1509,ORL,0,240,42,90,46.7,12,37,32.4,30,53,56.6,11,12,91.7,8,37,45,22,2,4,15,18
1510,PHX,1,240,44,88,50,8,27,29.6,36,61,59.02,16,19,84.2,6,29,35,21,11,4,6,17
1511,WAS,0,240,46,98,46.9,17,53,32.1,29,45,64.44,17,21,81,6,36,42,35,5,9,9,21
1512,OKC,1,240,45,83,54.2,18,33,54.5,27,50,54,16,20,80,5,41,46,31,1,6,15,24
1513,DET,1,240,41,82,50,12,28,42.9,29,54,53.7,35,40,87.5,6,35,41,29,4,4,12,22
1514,DAL,1,240,49,88,55.7,16,40,40,33,48,68.75,18,22,81.8,6,37,43,25,5,2,9,14
1515,TOR,0,240,46,91,50.5,12,24,50,34,67,50.75,23,28,82.1,6,27,33,26,9,5,8,27
1516,UTA,1,240,43,93,46.2,11,41,26.8,32,52,61.54,20,28,71.4,9,34,43,29,8,6,10,25
1517,MIA,0,240,34,78,43.6,9,31,29,25,47,53.19,32,40,80,8,38,46,20,8,8,16,24
1518,MIN,1,240,38,76,50,12,34,35.3,26,42,61.9,20,24,83.3,7,38,45,24,8,8,19,26
1519,LAL,0,240,37,88,42,7,24,29.2,30,64,46.88,25,32,78.1,8,31,39,23,12,4,10,15
1520,CHI,1,240,40,79,50.6,7,25,28,33,54,61.11,18,30,60,12,41,53,21,5,5,17,15
1521,IND,1,240,50,85,58.8,23,43,53.5,27,42,64.29,17,21,81,7,27,34,40,6,7,16,18
1522,PHI,0,240,36,92,39.1,9,38,23.7,27,54,50,11,15,73.3,12,24,36,24,12,5,8,22
1523,NYK,0,240,45,95,47.4,17,37,45.9,28,58,48.28,19,27,70.4,15,27,42,24,12,2,14,19
1524,GSW,0,240,47,103,45.6,19,48,39.6,28,55,50.91,9,13,69.2,16,31,47,32,8,3,11,21
1525,POR,1,240,48,95,50.5,16,27,59.3,32,68,47.06,22,27,81.5,16,27,43,28,8,6,14,19
1526,TOR,0,240,44,95,46.3,17,44,38.6,27,51,52.94,13,20,65,9,29,38,29,10,6,5,15
1527,MIL,1,240,41,80,51.3,12,29,41.4,29,51,56.86,25,28,89.3,7,36,43,26,5,6,17,15
1528,CLE,0,240,49,103,47.6,6,43,14,43,60,71.67,7,9,77.8,7,30,37,28,11,7,8,20
1529,HOU,0,240,49,91,53.8,14,30,46.7,35,61,57.38,15,21,71.4,14,28,42,30,8,6,17,24
1530,SAS,0,240,48,94,51.1,14,33,42.4,34,61,55.74,18,25,72,13,29,42,31,9,3,14,19
1531,ORL,1,240,40,89,44.9,7,33,21.2,33,56,58.93,30,40,75,14,35,49,24,10,6,15,20
1532,CHA,0,240,44,92,47.8,23,46,50,21,46,45.65,8,8,100,8,18,26,32,5,3,6,17
1533,ATL,0,240,37,94,39.4,15,43,34.9,22,51,43.14,21,25,84,18,33,51,29,9,4,15,16
1534,BKN,0,240,39,91,42.9,9,28,32.1,30,63,47.62,17,27,63,18,36,54,24,5,4,10,13
1535,OKC,1,240,46,91,50.5,12,35,34.3,34,56,60.71,15,16,93.8,10,41,51,29,10,8,12,20
1536,PHX,1,240,46,74,62.2,18,30,60,28,44,63.64,23,24,95.8,6,33,39,34,3,11,15,14
1537,LAC,1,240,43,87,49.4,11,39,28.2,32,48,66.67,20,25,80,11,43,54,28,3,6,18,19
1538,DEN,0,240,36,85,42.4,10,37,27,26,48,54.17,11,15,73.3,5,31,36,30,6,5,17,17
1539,NYK,0,240,38,86,44.2,6,30,20,32,56,57.14,26,29,89.7,6,34,40,22,8,4,16,30
1540,PHI,1,240,45,86,52.3,12,33,36.4,33,53,62.26,29,33,87.9,11,19,30,22,10,5,10,21
1541,MEM,0,240,38,87,43.7,13,40,32.5,25,47,53.19,17,20,85,3,30,33,29,10,4,12,22
1542,WAS,1,240,46,91,50.5,15,38,39.5,31,53,58.49,3,7,42.9,8,35,43,28,5,5,7,19
1543,SAC,1,240,46,89,51.7,17,45,37.8,29,44,65.91,8,15,53.3,5,33,38,35,9,3,12,20
1544,BOS,1,240,43,88,48.9,17,39,43.6,26,49,53.06,17,20,85,13,39,52,29,3,6,16,17
1545,CHA,0,240,40,85,47.1,15,33,45.5,25,52,48.08,17,28,60.7,8,35,43,29,5,5,19,14
1546,MIA,1,240,44,91,48.4,10,31,32.3,34,60,56.67,16,22,72.7,10,34,44,26,6,1,10,19
1547,DAL,0,240,40,90,44.4,14,33,42.4,26,57,45.61,16,19,84.2,13,26,39,29,9,3,18,27
1548,MIN,1,240,38,74,51.4,17,33,51.5,21,41,51.22,25,34,73.5,6,32,38,23,9,10,22,21
1549,MEM,0,240,37,89,41.6,13,35,37.1,24,54,44.44,18,25,72,11,25,36,23,8,5,11,13
1550,DEN,1,240,55,96,57.3,20,41,48.8,35,55,63.64,12,14,85.7,12,41,53,43,6,7,12,19
1551,BOS,1,265,48,99,48.5,11,39,28.2,37,60,61.67,21,25,84,11,32,43,25,10,4,12,15
1552,UTA,0,240,36,85,42.4,12,39,30.8,24,46,52.17,21,25,84,17,25,42,27,5,3,19,15
1553,SAS,1,240,41,85,48.2,10,36,27.8,31,49,63.27,26,28,92.9,7,35,42,33,9,10,11,20
1554,DET,0,265,48,101,47.5,14,43,32.6,34,58,58.62,12,19,63.2,19,38,57,27,7,4,19,21
1555,NOP,1,240,45,82,54.9,10,27,37,35,55,63.64,12,15,80,6,29,35,27,10,7,15,19
1556,CHI,0,240,40,97,41.2,7,27,25.9,33,70,47.14,17,22,77.3,13,34,47,19,7,4,8,20
1557,IND,1,240,43,85,50.6,19,42,45.2,24,43,55.81,15,22,68.2,6,41,47,30,6,9,14,21
1558,POR,0,240,35,101,34.7,11,36,30.6,24,65,36.92,24,32,75,22,35,57,16,6,4,13,22
1559,GSW,0,240,37,88,42,8,33,24.2,29,55,52.73,20,25,80,12,31,43,27,4,7,13,19
1560,LAL,1,240,52,97,53.6,15,30,50,37,67,55.22,14,14,100,5,37,42,41,11,7,11,21
1561,NYK,0,240,41,82,50,14,34,41.2,27,48,56.25,24,30,80,9,31,40,24,2,2,18,21
1562,OKC,1,240,49,90,54.4,14,32,43.8,35,58,60.34,17,22,77.3,3,24,27,20,6,10,4,21
1563,DAL,0,240,39,88,44.3,10,37,27,29,51,56.86,22,26,84.6,7,30,37,21,12,7,10,21
1564,WAS,0,240,42,90,46.7,8,33,24.2,34,57,59.65,10,15,66.7,10,24,34,25,11,3,17,17
1565,BKN,0,240,45,101,44.6,7,32,21.9,38,69,55.07,25,29,86.2,17,30,47,29,7,2,9,17
1566,PHX,1,240,47,82,57.3,14,33,42.4,33,49,67.35,21,26,80.8,8,36,44,28,4,11,19,17
1567,MIL,1,240,52,89,58.4,23,51,45.1,29,38,76.32,17,23,73.9,8,33,41,41,6,8,10,18
1568,ORL,0,240,31,79,39.2,9,33,27.3,22,46,47.83,21,24,87.5,9,34,43,17,5,11,16,18
1569,HOU,0,240,40,96,41.7,17,41,41.5,23,55,41.82,16,22,72.7,9,24,33,20,11,3,10,21
1570,TOR,1,240,52,91,57.1,15,38,39.5,37,53,69.81,13,19,68.4,14,39,53,43,12,5,20,18
1571,CLE,1,240,40,92,43.5,17,43,39.5,23,49,46.94,16,23,69.6,18,39,57,33,7,4,16,21
1572,PHI,1,240,45,96,46.9,10,28,35.7,35,68,51.47,12,17,70.6,12,36,48,14,10,8,10,19
1573,HOU,0,240,47,97,48.5,5,24,20.8,42,73,57.53,18,22,81.8,15,29,44,19,15,2,11,16
1574,ATL,0,240,41,89,46.1,13,45,28.9,28,44,63.64,18,21,85.7,12,28,40,24,6,3,16,21
1575,SAS,0,240,44,98,44.9,16,35,45.7,28,63,44.44,14,21,66.7,13,30,43,36,8,8,9,18
1576,BKN,1,240,41,82,50,9,22,40.9,32,60,53.33,27,43,62.8,7,35,42,22,6,7,9,22
1577,WAS,0,240,43,87,49.4,16,42,38.1,27,45,60,17,21,81,10,37,47,27,10,8,20,21
1578,SAC,0,240,45,93,48.4,10,42,23.8,35,51,68.63,13,16,81.3,11,29,40,25,5,7,12,16
1579,OKC,1,240,49,81,60.5,18,39,46.2,31,42,73.81,13,16,81.3,3,26,29,35,9,7,15,24
1580,MIN,0,240,34,73,46.6,12,27,44.4,22,46,47.83,26,32,81.3,8,26,34,22,8,1,24,16
1581,CHI,1,240,42,92,45.7,7,25,28,35,67,52.24,27,31,87.1,18,30,48,23,10,2,10,17
1582,MEM,1,265,39,90,43.3,11,46,23.9,28,44,63.64,27,32,84.4,8,42,50,24,10,17,18,24
1583,DET,0,240,40,90,44.4,9,25,36,31,65,47.69,23,32,71.9,16,36,52,20,6,4,14,27
1584,POR,1,240,49,98,50,16,40,40,33,58,56.9,16,20,80,16,30,46,28,5,5,10,17
1585,LAC,1,240,40,85,47.1,14,34,41.2,26,51,50.98,19,25,76,11,34,45,24,7,3,13,14
1586,IND,1,240,43,82,52.4,19,43,44.2,24,39,61.54,18,21,85.7,10,35,45,28,5,7,20,22
1587,UTA,1,240,47,95,49.5,16,43,37.2,31,52,59.62,20,22,90.9,13,40,53,34,4,7,14,21
1588,NOP,0,265,42,97,43.3,10,31,32.3,32,66,48.48,21,33,63.6,10,36,46,18,12,6,15,26
1589,ORL,1,240,49,93,52.7,12,26,46.2,37,67,55.22,17,25,68,7,33,40,30,11,5,16,16
1590,CHA,0,240,43,93,46.2,6,29,20.7,37,64,57.81,12,16,75,8,34,42,31,8,6,11,23
1591,BOS,1,240,46,91,50.5,13,42,31,33,49,67.35,21,28,75,11,33,44,31,8,7,8,17
1592,MIA,1,240,40,84,47.6,12,32,37.5,28,52,53.85,27,35,77.1,13,43,56,27,5,7,14,17
1593,PHX,0,240,40,90,44.4,14,41,34.1,26,49,53.06,20,25,80,14,33,47,28,5,2,16,21
1594,DAL,1,240,45,84,53.6,16,44,36.4,29,40,72.5,22,30,73.3,8,30,38,28,7,6,11,20
1595,NYK,1,240,50,92,54.3,8,26,30.8,42,66,63.64,21,26,80.8,7,34,41,27,7,4,12,18
1596,GSW,0,240,40,87,46,14,40,35,26,47,55.32,20,23,87,9,30,39,23,7,3,13,23
1597,MIL,0,240,45,95,47.4,13,42,31,32,53,60.38,19,24,79.2,17,27,44,26,7,4,11,23
1598,PHI,0,240,40,94,42.6,17,45,37.8,23,49,46.94,16,25,64,5,31,36,23,11,4,8,22
1599,DEN,1,240,40,82,48.8,14,34,41.2,26,48,54.17,26,32,81.3,10,33,43,25,6,4,14,17
1600,LAL,0,240,43,90,47.8,13,32,40.6,30,58,51.72,16,21,76.2,13,30,43,24,4,1,12,19
1601,NYK,0,240,41,93,44.1,9,29,31,32,64,50,20,21,95.2,11,30,41,17,5,2,11,22
1602,CHA,0,240,34,88,38.6,8,28,28.6,26,60,43.33,19,23,82.6,13,34,47,23,8,11,18,15
1603,GSW,1,240,48,83,57.8,10,33,30.3,38,50,76,20,24,83.3,13,36,49,38,8,2,18,14
1604,LAL,1,240,47,90,52.2,16,32,50,31,58,53.45,19,23,82.6,8,36,44,37,7,7,9,13
1605,MEM,1,240,50,97,51.5,11,33,33.3,39,64,60.94,14,22,63.6,15,36,51,29,6,7,12,16
1606,MIL,1,240,48,91,52.7,16,32,50,32,59,54.24,18,23,78.3,12,41,53,25,4,2,14,22
1607,LAC,0,240,41,89,46.1,11,34,32.4,30,55,54.55,15,15,100,9,25,34,25,4,4,11,24
1608,TOR,0,240,45,94,47.9,13,32,40.6,32,62,51.61,16,19,84.2,12,27,39,35,7,5,11,17
1609,BOS,1,240,49,94,52.1,25,53,47.2,24,41,58.54,22,28,78.6,15,36,51,33,4,5,10,19
1610,CLE,1,240,39,88,44.3,12,45,26.7,27,43,62.79,19,26,73.1,15,33,48,28,7,4,13,16
1611,OKC,0,240,46,95,48.4,13,41,31.7,33,54,61.11,15,19,78.9,11,31,42,24,6,7,9,17
1612,NOP,0,240,38,82,46.3,8,31,25.8,30,51,58.82,20,29,69,13,33,46,21,9,7,16,22
1613,UTA,1,240,48,91,52.7,17,38,44.7,31,53,58.49,13,14,92.9,8,33,41,35,7,5,12,17
1614,SAS,0,240,44,98,44.9,14,45,31.1,30,53,56.6,17,24,70.8,8,34,42,32,9,3,10,16
1615,MIN,1,240,44,87,50.6,10,33,30.3,34,54,62.96,12,14,85.7,7,36,43,31,9,5,12,18
1616,HOU,1,240,35,82,42.7,9,29,31,26,53,49.06,27,35,77.1,13,31,44,21,9,2,12,20
1617,DAL,1,240,52,100,52,23,45,51.1,29,55,52.73,17,21,81,11,41,52,26,7,6,13,18
1618,ORL,1,240,39,73,53.4,6,18,33.3,33,55,60,33,41,80.5,10,29,39,22,9,5,15,18
1619,IND,0,240,43,82,52.4,15,34,44.1,28,48,58.33,9,13,69.2,7,26,33,27,7,6,15,30
1620,POR,0,240,38,84,45.2,13,35,37.1,25,49,51.02,17,25,68,8,22,30,26,13,3,12,20
1621,CHI,0,240,35,80,43.8,8,35,22.9,27,45,60,17,19,89.5,5,32,37,23,6,5,12,22
1622,SAC,0,240,37,85,43.5,8,33,24.2,29,52,55.77,16,21,76.2,8,32,40,23,10,2,11,20
1623,ATL,0,240,45,96,46.9,13,43,30.2,32,53,60.38,16,20,80,13,28,41,28,8,5,11,22
1624,BKN,1,240,45,86,52.3,10,24,41.7,35,62,56.45,26,32,81.3,7,31,38,32,10,3,12,22
1625,DEN,1,240,39,90,43.3,12,30,40,27,60,45,12,14,85.7,12,36,48,25,11,13,17,21
1626,DET,0,240,39,79,49.4,15,35,42.9,24,44,54.55,22,29,75.9,6,30,36,26,5,3,14,25
1627,TOR,0,240,39,87,44.8,9,33,27.3,30,54,55.56,24,28,85.7,11,35,46,30,9,6,12,16
1628,DAL,0,240,35,101,34.7,7,40,17.5,28,61,45.9,19,26,73.1,14,33,47,18,10,1,12,17
1629,SAC,1,240,44,83,53,12,38,31.6,32,45,71.11,20,26,76.9,7,30,37,32,7,7,14,24
1630,WAS,0,240,44,97,45.4,11,35,31.4,33,62,53.23,19,24,79.2,9,30,39,25,7,4,9,16
1631,GSW,1,240,47,97,48.5,18,45,40,29,52,55.77,17,20,85,14,43,57,33,5,2,12,17
1632,BKN,0,240,43,89,48.3,13,33,39.4,30,56,53.57,18,26,69.2,14,31,45,32,4,7,11,23
1633,MIA,1,240,40,86,46.5,17,39,43.6,23,47,48.94,25,30,83.3,12,36,48,21,7,2,17,18
1634,HOU,1,240,46,95,48.4,11,38,28.9,35,57,61.4,19,23,82.6,12,51,63,21,7,3,17,22
1635,DEN,1,240,45,87,51.7,11,26,42.3,34,61,55.74,21,25,84,8,33,41,29,6,5,6,19
1636,ATL,0,240,42,96,43.8,19,54,35.2,23,42,54.76,10,14,71.4,12,31,43,29,9,2,14,23
1637,PHX,0,240,39,88,44.3,5,25,20,34,63,53.97,22,28,78.6,15,30,45,19,8,4,15,19
1638,PHI,1,240,44,83,53,14,31,45.2,30,52,57.69,19,21,90.5,3,35,38,34,6,6,14,21
1639,LAL,0,240,41,83,49.4,10,24,41.7,31,59,52.54,19,24,79.2,7,31,38,21,6,6,18,18
1640,WAS,1,240,42,84,50,12,30,40,30,54,55.56,22,32,68.8,7,30,37,26,9,6,12,17
1641,SAS,0,240,37,81,45.7,10,30,33.3,27,51,52.94,11,16,68.8,9,32,41,24,6,7,19,11
1642,MIL,1,240,38,90,42.2,11,37,29.7,27,53,50.94,31,35,88.6,10,41,51,26,3,6,13,22
1643,ORL,0,240,45,99,45.5,8,33,24.2,37,66,56.06,16,23,69.6,13,32,45,26,6,9,7,23
1644,MEM,1,240,43,84,51.2,16,35,45.7,27,49,55.1,14,21,66.7,8,33,41,27,8,7,20,14
1645,LAC,0,240,44,93,47.3,17,43,39.5,27,50,54,10,12,83.3,12,28,40,23,9,5,16,18
1646,CLE,0,240,41,87,47.1,17,44,38.6,24,43,55.81,5,8,62.5,6,29,35,34,4,3,12,13
1647,OKC,1,240,51,87,58.6,16,34,47.1,35,53,66.04,16,18,88.9,6,32,38,35,9,5,12,11
1648,CHI,1,240,49,90,54.4,7,28,25,42,62,67.74,9,11,81.8,5,31,36,24,11,5,12,18
1649,MIN,1,240,42,87,48.3,14,36,38.9,28,51,54.9,20,25,80,9,31,40,32,13,7,14,19
1650,IND,0,240,38,90,42.2,18,52,34.6,20,38,52.63,9,11,81.8,12,27,39,28,12,9,17,21
1651,POR,0,240,43,95,45.3,14,30,46.7,29,65,44.62,17,23,73.9,20,31,51,24,7,6,16,27
1652,DET,0,240,43,86,50,9,31,29,34,55,61.82,16,19,84.2,12,29,41,24,6,9,21,19
1653,UTA,1,240,43,94,45.7,11,30,36.7,32,64,50,22,24,91.7,15,29,44,26,15,7,13,18
1654,NOP,1,240,47,86,54.7,15,35,42.9,32,51,62.75,14,16,87.5,7,33,40,32,7,4,9,15
1655,MIA,1,240,40,83,48.2,15,29,51.7,25,54,46.3,20,24,83.3,10,29,39,25,6,2,11,17
1656,BOS,1,240,51,92,55.4,22,42,52.4,29,50,58,20,24,83.3,14,36,50,35,6,10,9,17
1657,HOU,0,240,44,89,49.4,16,34,47.1,28,55,50.91,23,23,100,8,29,37,25,4,6,9,23
1658,LAL,0,240,42,94,44.7,12,37,32.4,30,57,52.63,12,15,80,8,32,40,27,7,7,14,11
1659,NYK,1,240,44,95,46.3,13,33,39.4,31,62,50,20,25,80,12,42,54,24,8,7,11,15
1660,MIN,0,240,42,82,51.2,9,25,36,33,57,57.89,20,24,83.3,9,30,39,22,4,2,19,22
1661,SAC,0,240,43,91,47.3,21,44,47.7,22,47,46.81,12,23,52.2,12,25,37,29,4,8,7,15
1662,LAC,1,240,43,77,55.8,11,31,35.5,32,46,69.57,23,25,92,7,37,44,27,6,4,14,22
1663,CHI,1,240,48,88,54.5,18,34,52.9,30,54,55.56,10,11,90.9,7,41,48,25,7,6,16,15
1664,TOR,0,240,43,90,47.8,9,27,33.3,34,63,53.97,9,13,69.2,10,31,41,26,3,5,11,12
1665,UTA,0,240,40,78,51.3,13,30,43.3,27,48,56.25,23,28,82.1,6,32,38,24,5,6,16,22
1666,ATL,1,240,47,91,51.6,17,40,42.5,30,51,58.82,23,28,82.1,12,32,44,31,4,3,12,18
1667,IND,1,240,49,80,61.3,18,39,46.2,31,41,75.61,28,30,93.3,8,30,38,37,6,8,13,20
1668,PHI,1,240,45,84,53.6,8,22,36.4,37,62,59.68,29,32,90.6,7,29,36,20,9,3,12,25
1669,DAL,0,240,39,91,42.9,14,43,32.6,25,48,52.08,19,27,70.4,13,23,36,23,8,3,8,19
1670,BKN,0,240,37,101,36.6,15,47,31.9,22,54,40.74,13,17,76.5,17,32,49,25,6,9,11,20
1671,CHA,0,240,45,95,47.4,8,31,25.8,37,64,57.81,15,19,78.9,16,21,37,23,6,0,12,18
1672,ORL,0,240,41,89,46.1,9,36,25,32,53,60.38,15,19,78.9,15,34,49,29,8,5,12,24
1673,DEN,1,240,49,98,50,12,33,36.4,37,65,56.92,3,7,42.9,15,31,46,29,9,9,9,13
1674,CLE,1,240,45,96,46.9,23,51,45.1,22,45,48.89,11,16,68.8,14,30,44,34,8,3,12,23
1675,MEM,1,240,41,82,50,10,31,32.3,31,51,60.78,23,29,79.3,13,29,42,19,5,7,18,19
1676,NOP,0,240,40,85,47.1,11,25,44,29,60,48.33,22,24,91.7,11,28,39,23,4,3,11,23
1677,SAS,0,240,46,96,47.9,9,30,30,37,66,56.06,18,21,85.7,8,44,52,27,4,4,16,17
1678,POR,1,240,39,87,44.8,14,28,50,25,59,42.37,17,19,89.5,10,32,42,23,8,4,17,18
1679,MIL,1,240,50,106,47.2,18,49,36.7,32,57,56.14,14,18,77.8,11,36,47,34,11,7,7,15
1680,BOS,0,265,47,114,41.2,17,58,29.3,30,56,53.57,15,17,88.2,18,37,55,28,6,5,8,13
1681,PHX,0,240,42,94,44.7,5,23,21.7,37,71,52.11,15,21,71.4,14,33,47,23,10,6,15,15
1682,GSW,1,265,50,109,45.9,20,50,40,30,59,50.85,12,14,85.7,18,41,59,29,4,5,10,15
1683,LAC,1,240,56,98,57.1,19,38,50,37,60,61.67,20,23,87,14,32,46,26,4,9,11,19
1684,NYK,1,240,42,88,47.7,10,30,33.3,32,58,55.17,20,23,87,11,41,52,21,5,6,16,16
1685,CLE,1,265,47,97,48.5,19,48,39.6,28,49,57.14,22,34,64.7,14,24,38,29,7,8,12,25
1686,LAL,0,240,42,99,42.4,13,41,31.7,29,58,50,12,13,92.3,9,32,41,29,9,3,10,17
1687,BKN,0,240,39,90,43.3,16,39,41,23,51,45.1,14,20,70,11,25,36,25,4,9,14,17
1688,DET,0,240,48,94,51.1,9,22,40.9,39,72,54.17,19,27,70.4,12,24,36,23,7,3,13,26
1689,OKC,1,240,42,92,45.7,11,36,30.6,31,56,55.36,21,23,91.3,10,43,53,31,11,10,12,18
1690,SAC,1,240,53,100,53,17,43,39.5,36,57,63.16,20,26,76.9,9,33,42,35,8,5,7,24
1691,DEN,1,240,49,87,56.3,14,26,53.8,35,61,57.38,18,22,81.8,9,37,46,29,7,4,9,19
1692,TOR,1,240,44,86,51.2,8,29,27.6,36,57,63.16,18,22,81.8,15,36,51,30,4,4,19,16
1693,IND,0,240,49,95,51.6,12,33,36.4,37,62,59.68,17,21,81,11,23,34,38,6,7,11,21
1694,MEM,0,240,30,85,35.3,19,54,35.2,11,31,35.48,18,21,85.7,7,38,45,25,6,3,22,19
1695,HOU,0,265,47,102,46.1,12,33,36.4,35,69,50.72,24,27,88.9,15,32,47,34,9,5,14,32
1696,DAL,0,240,41,92,44.6,13,38,34.2,28,54,51.85,9,19,47.4,15,28,43,19,2,0,11,20
1697,MIN,1,240,42,85,49.4,11,29,37.9,31,56,55.36,17,19,89.5,12,33,45,27,10,9,14,19
1698,PHI,0,240,38,88,43.2,11,32,34.4,27,56,48.21,17,19,89.5,9,35,44,23,8,8,12,17
1699,ATL,1,240,46,85,54.1,16,36,44.4,30,49,61.22,22,27,81.5,11,29,40,25,6,10,18,24
1700,UTA,1,240,45,91,49.5,14,34,41.2,31,57,54.39,21,24,87.5,12,39,51,30,6,8,14,20
1701,WAS,0,240,44,85,51.8,18,38,47.4,26,47,55.32,25,30,83.3,5,34,39,26,3,6,12,21
1702,CHI,1,240,42,89,47.2,12,29,41.4,30,60,50,12,15,80,11,34,45,24,7,9,10,15
1703,MIA,0,240,41,87,47.1,11,30,36.7,30,57,52.63,15,18,83.3,9,31,40,27,10,4,15,18
1704,CHA,0,240,39,89,43.8,8,32,25,31,57,54.39,13,13,100,10,26,36,18,8,6,13,19
1705,WAS,0,240,39,95,41.1,14,46,30.4,25,49,51.02,16,20,80,10,34,44,24,8,6,10,25
1706,PHX,1,240,41,90,45.6,7,31,22.6,34,59,57.63,23,30,76.7,13,41,54,29,8,6,17,16
1707,NOP,1,240,55,98,56.1,22,42,52.4,33,56,58.93,14,22,63.6,11,40,51,38,11,3,15,19
1708,BOS,1,240,45,95,47.4,17,36,47.2,28,59,47.46,7,8,87.5,10,45,55,18,4,10,14,19
1709,GSW,1,240,46,87,52.9,13,38,34.2,33,49,67.35,13,19,68.4,11,32,43,31,10,4,14,20
1710,POR,0,240,40,85,47.1,13,35,37.1,27,50,54,21,23,91.3,9,28,37,23,10,4,14,20
1711,SAS,0,240,40,94,42.6,15,42,35.7,25,52,48.08,15,21,71.4,9,30,39,29,6,6,13,15
1712,MIL,1,240,45,90,50,13,36,36.1,32,54,59.26,25,32,78.1,16,30,46,25,4,1,17,23
1713,ORL,0,240,34,89,38.2,11,36,30.6,23,53,43.4,18,24,75,10,33,43,18,7,4,9,16
1714,HOU,0,240,45,85,52.9,11,27,40.7,34,58,58.62,18,21,85.7,6,25,31,26,8,4,10,21
1715,DAL,1,240,48,97,49.5,16,47,34,32,50,64,19,21,90.5,11,36,47,27,7,2,13,17
1716,MIN,1,240,48,86,55.8,18,30,60,30,56,53.57,13,16,81.3,8,28,36,33,10,4,15,16
1717,SAC,1,240,46,85,54.1,22,45,48.9,24,40,60,11,15,73.3,8,37,45,36,6,2,18,17
1718,CLE,1,240,49,101,48.5,16,42,38.1,33,59,55.93,13,15,86.7,18,31,49,32,8,3,11,22
1719,MIA,1,240,43,83,51.8,13,35,37.1,30,48,62.5,19,25,76,8,23,31,26,7,2,10,19
1720,IND,0,240,45,90,50,6,21,28.6,39,69,56.52,13,16,81.3,13,27,40,25,10,6,15,15
1721,DET,0,240,43,96,44.8,6,28,21.4,37,68,54.41,22,26,84.6,10,26,36,25,10,4,8,23
1722,PHI,1,240,53,88,60.2,14,31,45.2,39,57,68.42,15,17,88.2,5,40,45,30,10,6,10,17
1723,GSW,1,240,44,91,48.4,17,32,53.1,27,59,45.76,19,20,95,13,29,42,29,7,5,14,15
1724,POR,0,240,47,94,50,7,32,21.9,40,62,64.52,19,22,86.4,10,34,44,17,8,2,11,21
1725,NYK,0,240,44,94,46.8,11,35,31.4,33,59,55.93,23,26,88.5,12,27,39,20,7,4,10,22
1726,OKC,1,240,43,84,51.2,7,21,33.3,36,63,57.14,25,30,83.3,9,31,40,22,4,9,11,19
1727,CHI,0,240,37,77,48.1,16,38,42.1,21,39,53.85,26,29,89.7,11,29,40,25,8,4,15,19
1728,BKN,0,240,45,93,48.4,17,43,39.5,28,50,56,13,15,86.7,14,28,42,31,6,8,16,21
1729,MIL,1,240,50,88,56.8,19,42,45.2,31,46,67.39,27,32,84.4,8,41,49,24,5,8,15,24
1730,DEN,0,240,42,93,45.2,12,32,37.5,30,61,49.18,21,24,87.5,16,30,46,30,5,0,9,22
1731,CHA,0,240,33,91,36.3,7,35,20,26,56,46.43,9,11,81.8,8,28,36,15,3,4,13,14
1732,ATL,0,240,41,85,48.2,15,36,41.7,26,49,53.06,22,25,88,6,28,34,21,5,4,11,21
1733,UTA,0,240,38,86,44.2,12,37,32.4,26,49,53.06,16,21,76.2,9,28,37,28,8,3,13,12
1734,LAC,1,240,50,88,56.8,16,33,48.5,34,55,61.82,28,34,82.4,8,34,42,36,8,6,9,21
1735,NOP,1,240,38,80,47.5,9,27,33.3,29,53,54.72,27,32,84.4,11,38,49,24,4,5,16,17
1736,LAL,0,240,43,89,48.3,11,36,30.6,32,53,60.38,18,28,64.3,9,34,43,32,5,5,6,15
1737,HOU,1,240,32,88,36.4,11,29,37.9,21,59,35.59,28,32,87.5,15,36,51,18,10,10,11,19
1738,ATL,1,240,52,101,51.5,16,41,39,36,60,60,5,6,83.3,16,39,55,34,4,4,14,19
1739,WAS,1,240,52,92,56.5,13,27,48.1,39,65,60,20,26,76.9,8,39,47,36,7,8,19,18
1740,DET,0,240,35,81,43.2,4,21,19,31,60,51.67,18,23,78.3,7,35,42,19,3,7,21,25
1741,PHX,0,240,47,90,52.2,11,28,39.3,36,62,58.06,17,21,81,10,23,33,30,4,3,12,17
1742,NYK,1,240,49,82,59.8,17,29,58.6,32,53,60.38,24,28,85.7,9,29,38,28,9,5,11,20
1743,PHI,1,240,41,98,41.8,14,37,37.8,27,61,44.26,28,31,90.3,16,38,54,24,17,8,12,23
1744,IND,0,240,48,107,44.9,15,40,37.5,33,67,49.25,12,16,75,13,28,41,35,7,8,15,25
1745,CHA,0,240,41,92,44.6,9,31,29,32,61,52.46,16,21,76.2,8,31,39,18,7,4,8,24
1746,TOR,0,240,40,77,51.9,10,31,32.3,30,46,65.22,14,25,56,3,29,32,30,8,6,14,19
1747,MEM,0,240,37,92,40.2,11,40,27.5,26,52,50,11,15,73.3,13,35,48,19,4,8,18,24
1748,ORL,0,240,42,87,48.3,14,35,40,28,52,53.85,13,18,72.2,13,32,45,25,5,2,21,22
1749,BOS,1,240,48,92,52.2,18,42,42.9,30,50,60,14,20,70,9,25,34,31,14,7,11,22
1750,SAS,1,240,47,95,49.5,18,42,42.9,29,53,54.72,17,19,89.5,9,36,45,35,5,5,9,19
1751,MIN,1,240,44,88,50,14,31,45.2,30,57,52.63,17,25,68,12,33,45,30,9,4,17,19
1752,UTA,1,240,49,92,53.3,11,33,33.3,38,59,64.41,13,14,92.9,13,32,45,27,9,9,11,14
1753,GSW,0,240,40,92,43.5,16,45,35.6,24,47,51.06,17,19,89.5,16,27,43,22,8,2,13,24
1754,SAC,1,240,47,95,49.5,18,45,40,29,50,58,16,21,76.2,11,36,47,32,6,4,17,22
1755,CLE,0,240,40,83,48.2,11,33,33.3,29,50,58,16,17,94.1,9,30,39,21,7,1,16,18
1756,DEN,1,240,47,99,47.5,12,36,33.3,35,63,55.56,18,21,85.7,12,36,48,31,13,6,9,15
1757,POR,0,240,43,103,41.7,16,45,35.6,27,58,46.55,12,18,66.7,21,28,49,30,9,4,11,12
1758,BOS,1,240,43,85,50.6,13,36,36.1,30,49,61.22,17,20,85,13,31,44,22,7,8,13,15
1759,BKN,0,240,39,95,41.1,8,30,26.7,31,65,47.69,15,20,75,18,35,53,28,5,4,16,23
1760,MIA,0,240,37,80,46.3,15,34,44.1,22,46,47.83,27,35,77.1,8,34,42,26,2,1,11,20
1761,OKC,0,240,44,102,43.1,11,36,30.6,33,66,50,24,27,88.9,16,28,44,26,8,7,14,25
1762,LAC,1,240,41,81,50.6,13,32,40.6,28,49,57.14,26,30,86.7,10,30,40,27,6,9,14,20
1763,CHI,1,240,45,93,48.4,14,36,38.9,31,57,54.39,20,30,66.7,11,32,43,32,8,2,5,23
1764,DAL,0,240,39,83,47,7,32,21.9,32,51,62.75,16,18,88.9,4,30,34,21,6,2,16,19
1765,MIL,1,240,48,89,53.9,7,27,25.9,41,62,66.13,37,48,77.1,12,31,43,27,8,8,16,24
1766,MIA,1,240,41,86,47.7,15,30,50,26,56,46.43,18,19,94.7,17,30,47,29,10,3,23,12
1767,BKN,1,240,41,89,46.1,15,41,36.6,26,48,54.17,19,24,79.2,10,26,36,24,9,4,7,17
1768,DET,0,240,39,88,44.3,10,33,30.3,29,55,52.73,23,30,76.7,6,29,35,24,6,3,10,22
1769,WAS,0,240,42,82,51.2,19,44,43.2,23,38,60.53,19,24,79.2,3,30,33,28,7,6,15,16
1770,HOU,1,240,39,86,45.3,12,32,37.5,27,54,50,27,37,73,15,43,58,23,6,3,19,28
1771,LAL,1,240,49,91,53.8,14,35,40,35,56,62.5,10,17,58.8,5,41,46,31,14,4,16,16
1772,PHX,0,240,40,84,47.6,9,28,32.1,31,56,55.36,23,27,85.2,14,35,49,28,5,4,12,20
1773,MEM,0,240,35,82,42.7,10,38,26.3,25,44,56.82,24,34,70.6,5,34,39,25,7,4,11,30
1774,TOR,1,240,50,87,57.5,18,34,52.9,32,53,60.38,17,24,70.8,9,38,47,39,3,9,15,18
1775,NYK,0,240,41,94,43.6,9,39,23.1,32,55,58.18,22,32,68.8,14,32,46,21,10,4,11,21
1776,ATL,0,240,48,100,48,18,41,43.9,30,59,50.85,14,19,73.7,13,29,42,32,9,8,7,18
1777,PHI,1,240,45,87,51.7,11,30,36.7,34,57,59.65,28,34,82.4,10,43,53,28,6,4,11,20
1778,SAS,0,240,45,96,46.9,16,37,43.2,29,59,49.15,13,18,72.2,10,36,46,28,8,6,17,16
1779,UTA,1,240,43,98,43.9,16,42,38.1,27,56,48.21,15,21,71.4,15,38,53,31,5,4,16,27
1780,NOP,1,240,50,96,52.1,16,34,47.1,34,62,54.84,26,30,86.7,10,36,46,30,11,3,10,17
1781,IND,0,240,45,100,45,11,36,30.6,34,64,53.12,25,32,78.1,16,29,45,30,7,6,18,32
1782,CHA,0,240,41,77,53.2,12,31,38.7,29,46,63.04,10,11,90.9,4,27,31,27,11,5,21,18
1783,DEN,1,240,39,83,47,14,30,46.7,25,53,47.17,22,32,68.8,15,31,46,28,4,4,11,20
1784,DAL,1,240,44,89,49.4,21,43,48.8,23,46,50,18,21,85.7,12,24,36,28,7,5,10,17
1785,CHI,0,240,36,86,41.9,13,40,32.5,23,46,50,21,23,91.3,11,30,41,26,6,9,14,22
1786,SAC,0,240,36,86,41.9,10,37,27,26,49,53.06,17,24,70.8,7,31,38,27,8,2,14,19
1787,CLE,0,240,44,92,47.8,19,45,42.2,25,47,53.19,6,9,66.7,6,29,35,27,6,4,13,18
1788,GSW,0,240,41,92,44.6,16,46,34.8,25,46,54.35,18,27,66.7,13,38,51,26,9,1,15,28
1789,LAL,0,240,49,91,53.8,15,29,51.7,34,62,54.84,12,18,66.7,10,30,40,34,4,4,15,20
1790,PHX,1,240,38,84,45.2,14,39,35.9,24,45,53.33,29,34,85.3,7,34,41,27,8,7,15,22
1791,BOS,1,240,38,84,45.2,18,44,40.9,20,40,50,26,26,100,12,33,45,23,9,9,15,13
1792,LAC,1,240,44,84,52.4,11,29,37.9,33,55,60,20,21,95.2,6,43,49,21,7,2,17,17
1793,DET,0,240,45,81,55.6,10,29,34.5,35,52,67.31,23,30,76.7,6,24,30,26,11,4,15,18
1794,SAS,0,240,31,87,35.6,5,41,12.2,26,46,56.52,15,22,68.2,9,42,51,20,9,5,17,14
1795,PHI,1,240,52,95,54.7,20,46,43.5,32,49,65.31,22,25,88,9,38,47,37,14,6,14,27
1796,DAL,1,240,43,86,50,17,40,42.5,26,46,56.52,17,19,89.5,10,33,43,27,8,9,17,17
1797,SAC,1,240,48,94,51.1,25,45,55.6,23,49,46.94,10,14,71.4,10,33,43,38,4,3,13,24
1798,TOR,0,240,47,96,49,14,39,35.9,33,57,57.89,22,30,73.3,17,21,38,32,12,0,10,21
1799,MEM,0,240,41,89,46.1,18,44,40.9,23,45,51.11,13,16,81.3,10,28,38,26,9,5,18,19
1800,NOP,1,240,40,82,48.8,10,27,37,30,55,54.55,31,40,77.5,10,37,47,27,7,7,14,20
1801,CHA,0,240,40,84,47.6,17,41,41.5,23,43,53.49,17,22,77.3,6,25,31,31,3,2,11,22
1802,IND,1,240,52,92,56.5,13,31,41.9,39,61,63.93,14,19,73.7,11,32,43,33,8,5,18,20
1803,MIN,0,240,40,91,44,13,36,36.1,27,55,49.09,14,19,73.7,11,36,47,26,5,3,14,28
1804,MIL,1,265,44,86,51.2,15,37,40.5,29,49,59.18,30,37,81.1,6,42,48,34,5,4,11,21
1805,HOU,1,240,32,93,34.4,12,39,30.8,20,54,37.04,17,20,85,15,45,60,20,7,2,16,18
1806,ATL,0,240,44,96,45.8,17,44,38.6,27,52,51.92,17,18,94.4,13,22,35,25,9,2,10,21
1807,NYK,1,240,52,86,60.5,17,29,58.6,35,57,61.4,15,23,65.2,14,28,42,36,5,3,15,22
1808,OKC,1,240,50,96,52.1,18,38,47.4,32,58,55.17,16,17,94.1,7,32,39,35,9,7,12,17
1809,MIA,1,240,37,77,48.1,15,35,42.9,22,42,52.38,27,34,79.4,8,35,43,31,7,3,11,22
1810,POR,0,240,43,90,47.8,19,40,47.5,24,50,48,22,26,84.6,11,25,36,25,5,4,12,21
1811,DEN,1,240,47,88,53.4,12,29,41.4,35,59,59.32,23,29,79.3,14,35,49,29,9,8,16,19
1812,LAC,1,240,49,89,55.1,13,34,38.2,36,55,65.45,21,22,95.5,9,26,35,33,7,9,9,20
1813,BKN,0,240,42,88,47.7,14,29,48.3,28,59,47.46,20,21,95.2,10,31,41,24,4,6,13,13
1814,UTA,0,240,44,92,47.8,12,38,31.6,32,54,59.26,20,21,95.2,9,32,41,32,9,9,17,21
1815,WAS,0,240,36,85,42.4,9,31,29,27,54,50,20,31,64.5,13,31,44,21,5,2,22,19
1816,CLE,0,240,30,85,35.3,9,40,22.5,21,45,46.67,25,33,75.8,18,30,48,15,10,3,14,23
1817,ORL,1,240,39,84,46.4,7,26,26.9,32,58,55.17,19,25,76,12,31,43,22,7,8,14,22
1818,CHI,0,265,47,114,41.2,15,34,44.1,32,80,40,20,25,80,18,33,51,25,3,4,6,27
1819,WAS,0,240,38,91,41.8,6,33,18.2,32,58,55.17,15,21,71.4,12,29,41,19,4,7,16,19
1820,GSW,0,265,49,104,47.1,19,48,39.6,30,56,53.57,19,23,82.6,24,36,60,29,3,2,29,28
1821,POR,0,240,39,105,37.1,18,53,34,21,52,40.38,16,18,88.9,18,30,48,20,9,1,15,24
1822,SAS,0,240,39,83,47,17,42,40.5,22,41,53.66,17,20,85,10,34,44,35,4,9,13,20
1823,OKC,1,265,51,98,52,5,29,17.2,46,69,66.67,31,36,86.1,11,28,39,15,17,7,11,22
1824,UTA,0,240,38,84,45.2,9,31,29,29,53,54.72,18,24,75,8,32,40,23,10,10,16,17
1825,ATL,0,240,41,104,39.4,13,39,33.3,28,65,43.08,19,21,90.5,23,32,55,20,3,4,14,23
1826,MIN,1,240,44,88,50,15,38,39.5,29,50,58,24,26,92.3,15,39,54,30,4,8,13,17
1827,HOU,1,240,35,82,42.7,13,39,33.3,22,43,51.16,31,42,73.8,11,36,47,21,3,3,10,20
1828,DAL,1,240,47,91,51.6,12,39,30.8,35,52,67.31,19,22,86.4,9,33,42,26,8,5,15,23
1829,DET,0,240,34,81,42,6,30,20,28,51,54.9,17,24,70.8,8,30,38,17,3,2,16,17
1830,BOS,1,240,48,91,52.7,19,47,40.4,29,44,65.91,18,21,85.7,8,26,34,24,8,5,8,19
1831,LAC,1,240,43,88,48.9,15,34,44.1,28,54,51.85,16,21,76.2,11,29,40,23,8,9,14,18
1832,NYK,0,240,44,88,50,15,37,40.5,29,51,56.86,20,27,74.1,12,32,44,28,4,3,14,20
1833,CHA,1,240,44,79,55.7,13,25,52,31,54,57.41,18,20,90,7,24,31,30,7,4,16,15
1834,MIA,0,240,37,86,43,15,42,35.7,22,44,50,10,15,66.7,7,30,37,23,5,5,18,23
1835,BKN,1,240,50,104,48.1,10,33,30.3,40,71,56.34,14,18,77.8,18,37,55,27,8,8,11,18
1836,TOR,0,240,47,93,50.5,6,32,18.8,41,61,67.21,16,21,76.2,14,28,42,32,7,2,14,21
1837,SAC,1,240,42,92,45.7,14,39,35.9,28,53,52.83,16,20,80,15,35,50,25,7,0,13,22
1838,ORL,1,240,49,89,55.1,10,26,38.5,39,63,61.9,15,19,78.9,6,39,45,26,5,4,10,20
1839,PHI,1,240,42,87,48.3,11,30,36.7,31,57,54.39,30,37,81.1,14,34,48,24,6,8,11,14
1840,PHX,0,240,40,83,48.2,11,32,34.4,29,51,56.86,15,23,65.2,8,32,40,26,8,5,11,19
1841,MEM,0,240,37,86,43,15,35,42.9,22,51,43.14,14,19,73.7,8,20,28,24,7,4,10,23
1842,DEN,0,240,38,90,42.2,10,28,35.7,28,62,45.16,20,27,74.1,12,35,47,22,4,5,10,24
1843,CHI,1,240,47,102,46.1,13,28,46.4,34,74,45.95,14,24,58.3,24,32,56,27,9,2,8,19
1844,CLE,1,240,40,87,46,14,38,36.8,26,49,53.06,17,26,65.4,12,39,51,21,13,2,13,17
1845,LAL,1,240,47,86,54.7,17,35,48.6,30,51,58.82,22,29,75.9,11,48,59,31,6,4,15,16
1846,IND,1,240,50,102,49,7,33,21.2,43,69,62.32,21,25,84,15,36,51,30,9,8,10,21
1847,MIL,0,240,43,96,44.8,12,33,36.4,31,63,49.21,21,28,75,12,34,46,19,3,9,12,17
1848,NOP,0,240,34,95,35.8,7,31,22.6,27,64,42.19,14,20,70,12,30,42,22,7,5,12,21
1849,LAC,1,240,40,87,46,12,27,44.4,28,60,46.67,19,25,76,13,38,51,21,7,9,11,14
1850,MIN,1,240,36,87,41.4,12,40,30,24,47,51.06,18,21,85.7,11,44,55,20,4,10,14,16
1851,SAS,0,240,38,101,37.6,8,36,22.2,30,65,46.15,10,15,66.7,13,36,49,23,7,4,12,17
1852,BKN,1,240,43,94,45.7,11,27,40.7,32,67,47.76,17,24,70.8,12,33,45,24,7,6,12,19
1853,OKC,0,240,37,87,42.5,8,29,27.6,29,58,50,19,24,79.2,4,26,30,22,14,10,9,21
1854,HOU,1,240,40,83,48.2,15,33,45.5,25,50,50,15,22,68.2,10,43,53,28,6,5,21,16
1855,ORL,0,240,41,84,48.8,2,23,8.7,39,61,63.93,27,37,73,7,29,36,22,10,6,11,21
1856,GSW,1,240,36,86,41.9,10,34,29.4,26,52,50,28,33,84.8,15,35,50,20,4,3,17,19
1857,UTA,0,240,35,87,40.2,12,33,36.4,23,54,42.59,15,18,83.3,11,32,43,22,6,3,19,20
1858,TOR,0,240,37,86,43,14,37,37.8,23,49,46.94,15,17,88.2,8,38,46,29,3,8,14,18
1859,DEN,0,240,41,98,41.8,12,31,38.7,29,67,43.28,8,9,88.9,14,32,46,29,7,5,11,20
1860,DET,0,240,41,91,45.1,11,35,31.4,30,56,53.57,9,9,100,8,34,42,30,9,6,17,17
1861,MIA,1,240,41,89,46.1,14,38,36.8,27,51,52.94,16,19,84.2,8,36,44,33,5,4,7,18
1862,POR,0,240,39,95,41.1,16,46,34.8,23,49,46.94,12,16,75,11,29,40,22,8,3,10,30
1863,CLE,1,240,46,86,53.5,14,34,41.2,32,52,61.54,15,20,75,10,35,45,29,5,2,17,27
1864,ATL,0,240,42,94,44.7,12,35,34.3,30,59,50.85,17,18,94.4,11,38,49,25,5,4,13,23
1865,DAL,1,240,56,101,55.4,22,49,44.9,34,52,65.38,13,19,68.4,11,36,47,37,11,5,8,14
1866,CHA,0,240,39,90,43.3,10,37,27,29,53,54.72,12,12,100,12,30,42,25,9,9,17,24
1867,PHI,1,240,47,92,51.1,8,27,29.6,39,65,60,29,34,85.3,11,32,43,29,7,2,11,14
1868,CHI,1,240,38,90,42.2,12,25,48,26,65,40,23,29,79.3,21,36,57,23,6,6,16,16
1869,WAS,0,240,52,92,56.5,14,35,40,38,57,66.67,8,8,100,2,30,32,39,8,6,11,22
1870,MEM,1,240,47,91,51.6,11,26,42.3,36,65,55.38,11,14,78.6,9,37,46,26,10,8,14,9
1871,PHX,0,240,37,75,49.3,12,25,48,25,50,50,17,21,81,8,36,44,25,8,5,22,21
1872,LAL,1,240,38,102,37.3,9,30,30,29,72,40.28,21,25,84,21,24,45,24,11,2,10,19
1873,MIL,1,240,55,91,60.4,23,38,60.5,32,53,60.38,13,19,68.4,12,25,37,32,12,6,12,23
1874,NYK,0,240,43,87,49.4,7,23,30.4,36,64,56.25,29,33,87.9,12,24,36,27,8,4,17,17
1875,NOP,1,240,47,87,54,14,31,45.2,33,56,58.93,19,23,82.6,13,29,42,29,12,7,14,22
1876,IND,1,240,43,94,45.7,19,40,47.5,24,54,44.44,17,21,81,7,34,41,28,8,4,6,15
1877,SAC,0,240,38,85,44.7,14,41,34.1,24,44,54.55,27,33,81.8,11,27,38,29,8,2,14,18
1878,BOS,0,240,46,97,47.4,12,41,29.3,34,56,60.71,8,12,66.7,13,43,56,27,5,9,18,19
1879,BKN,1,240,46,91,50.5,14,34,41.2,32,57,56.14,23,31,74.2,14,43,57,31,4,8,11,21
1880,MIA,0,240,48,89,53.9,12,25,48,36,64,56.25,21,24,87.5,6,22,28,27,3,1,12,22
1881,MIN,1,240,43,84,51.2,11,31,35.5,32,53,60.38,26,30,86.7,10,31,41,26,5,3,11,16
1882,CLE,1,240,44,89,49.4,10,30,33.3,34,59,57.63,12,18,66.7,8,35,43,25,11,1,11,18
1883,GSW,0,240,38,86,44.2,17,43,39.5,21,43,48.84,19,24,79.2,6,36,42,31,5,4,15,15
1884,HOU,0,240,36,89,40.4,11,31,35.5,25,58,43.1,14,18,77.8,11,43,54,24,5,7,17,23
1885,LAL,1,240,40,89,44.9,8,27,29.6,32,62,51.61,19,27,70.4,9,39,48,24,11,7,12,17
1886,ATL,0,240,45,101,44.6,15,38,39.5,30,63,47.62,16,21,76.2,15,25,40,23,11,4,11,14
1887,NOP,0,240,41,82,50,8,25,32,33,57,57.89,28,35,80,13,26,39,20,10,1,12,17
1888,POR,0,265,38,95,40,13,40,32.5,25,55,45.45,24,27,88.9,11,29,40,17,11,5,11,20
1889,ORL,0,240,35,88,39.8,9,29,31,26,59,44.07,22,27,81.5,8,29,37,24,3,5,11,27
1890,DAL,0,240,39,87,44.8,19,52,36.5,20,35,57.14,23,35,65.7,15,32,47,26,5,12,16,21
1891,DET,0,240,39,83,47,8,30,26.7,31,53,58.49,15,23,65.2,10,39,49,24,9,3,16,20
1892,PHX,1,240,36,83,43.4,9,26,34.6,27,57,47.37,35,43,81.4,12,32,44,24,10,5,17,21
1893,CHA,0,240,44,91,48.4,12,25,48,32,66,48.48,17,19,89.5,10,26,36,29,6,4,8,22
1894,MIL,1,240,53,89,59.6,14,33,42.4,39,56,69.64,12,15,80,8,36,44,33,5,6,16,19
1895,DEN,0,240,49,99,49.5,6,25,24,43,74,58.11,13,20,65,8,38,46,35,9,7,11,14
1896,UTA,1,265,46,94,48.9,7,34,20.6,39,60,65,19,24,79.2,16,40,56,27,5,11,18,21
1897,LAC,1,240,44,90,48.9,13,39,33.3,31,51,60.78,12,14,85.7,5,35,40,31,5,6,11,21
1898,IND,1,240,56,85,65.9,16,32,50,40,53,75.47,16,20,80,3,29,32,35,4,8,10,24
1899,OKC,1,240,44,100,44,20,44,45.5,24,56,42.86,18,22,81.8,16,34,50,24,8,5,13,24
1900,CHI,1,240,48,88,54.5,17,40,42.5,31,48,64.58,11,15,73.3,12,29,41,32,6,8,13,21
1901,MEM,0,240,39,86,45.3,9,31,29,30,55,54.55,22,24,91.7,8,32,40,14,9,8,17,31
1902,SAC,1,240,48,99,48.5,16,34,47.1,32,65,49.23,11,15,73.3,9,38,47,33,7,5,11,14
1903,TOR,0,240,44,100,44,6,32,18.8,38,68,55.88,12,17,70.6,19,29,48,32,7,6,12,19
1904,DAL,0,240,34,92,37,12,39,30.8,22,53,41.51,14,21,66.7,13,29,42,27,9,5,12,13
1905,NYK,1,240,45,90,50,16,36,44.4,29,54,53.7,13,16,81.3,11,32,43,30,6,3,13,15
1906,ORL,1,240,46,89,51.7,12,31,38.7,34,58,58.62,26,33,78.8,10,34,44,35,6,8,15,23
1907,NOP,1,240,42,85,49.4,10,31,32.3,32,54,59.26,27,29,93.1,10,32,42,26,8,6,12,15
1908,MEM,1,240,44,90,48.9,11,34,32.4,33,56,58.93,9,11,81.8,13,39,52,27,8,12,15,23
1909,PHI,0,240,43,94,45.7,16,35,45.7,27,59,45.76,17,23,73.9,15,27,42,16,16,5,16,24
1910,SAS,0,240,38,83,45.8,16,39,41,22,44,50,14,17,82.4,8,31,39,28,5,5,20,21
1911,DEN,1,240,50,88,56.8,12,32,37.5,38,56,67.86,7,12,58.3,4,28,32,38,8,4,9,21
1912,WAS,0,240,45,89,50.6,13,28,46.4,32,61,52.46,22,31,71,8,32,40,25,8,5,14,29
1913,BOS,1,240,39,77,50.6,16,33,48.5,23,44,52.27,31,36,86.1,10,36,46,25,10,8,20,18
1914,PHX,0,240,39,84,46.4,9,27,33.3,30,57,52.63,24,26,92.3,8,35,43,22,4,9,12,17
1915,UTA,0,240,33,87,37.9,11,34,32.4,22,53,41.51,13,14,92.9,13,38,51,22,6,4,21,19
1916,CHI,1,265,45,98,45.9,13,37,35.1,32,61,52.46,17,22,77.3,14,37,51,32,14,4,21,18
1917,OKC,1,240,50,94,53.2,14,42,33.3,36,52,69.23,19,22,86.4,8,40,48,29,9,6,9,24
1918,NYK,1,240,41,88,46.6,16,41,39,25,47,53.19,20,28,71.4,12,29,41,25,8,3,11,17
1919,SAS,0,240,48,89,53.9,18,41,43.9,30,48,62.5,21,23,91.3,11,36,47,34,4,7,21,22
1920,DET,0,240,43,81,53.1,15,35,42.9,28,46,60.87,11,17,64.7,8,34,42,22,4,3,20,25
1921,IND,0,240,50,98,51,11,43,25.6,39,55,70.91,21,32,65.6,10,24,34,30,11,5,10,31
1922,GSW,1,240,41,82,50,15,39,38.5,26,43,60.47,23,31,74.2,10,37,47,30,3,4,9,18
1923,MIL,0,265,44,98,44.9,16,48,33.3,28,50,56,9,13,69.2,9,34,43,28,12,6,21,21
1924,LAL,0,240,36,81,44.4,11,33,33.3,25,48,52.08,27,32,84.4,7,34,41,24,6,2,14,20
1925,CLE,0,240,38,89,42.7,7,32,21.9,31,57,54.39,12,12,100,14,21,35,25,12,2,19,15
1926,POR,1,240,39,77,50.6,14,35,40,25,42,59.52,11,11,100,9,31,40,29,10,4,23,17
1927,CHA,1,240,46,91,50.5,21,36,58.3,25,55,45.45,16,16,100,13,28,41,30,6,7,9,16
1928,BKN,0,240,52,105,49.5,14,36,38.9,38,69,55.07,10,15,66.7,22,30,52,21,6,4,9,11
1929,ATL,1,240,49,96,51,14,33,42.4,35,63,55.56,25,29,86.2,8,29,37,24,14,2,10,25
1930,LAC,0,240,42,95,44.2,12,32,37.5,30,63,47.62,18,24,75,15,28,43,26,5,1,6,21
1931,MIN,1,240,39,89,43.8,13,35,37.1,26,54,48.15,10,13,76.9,10,32,42,29,13,7,12,16
1932,MIA,1,240,48,86,55.8,8,21,38.1,40,65,61.54,38,45,84.4,10,38,48,25,4,1,14,28
1933,PHX,0,240,38,94,40.4,7,26,26.9,31,68,45.59,22,23,95.7,12,35,47,25,3,5,10,15
1934,MEM,1,240,43,87,49.4,13,39,33.3,30,48,62.5,6,8,75,12,39,51,26,9,10,17,15
1935,NOP,1,240,42,78,53.8,10,30,33.3,32,48,66.67,30,34,88.2,13,27,40,33,11,4,21,22
1936,LAC,1,240,50,93,53.8,14,28,50,36,65,55.38,17,22,77.3,8,29,37,28,8,5,7,20
1937,SAC,0,240,40,86,46.5,13,41,31.7,27,45,60,24,28,85.7,13,34,47,22,1,1,14,20
1938,DET,0,240,40,97,41.2,15,36,41.7,25,61,40.98,12,14,85.7,10,29,39,28,8,3,14,31
1939,ORL,1,240,51,84,60.7,17,27,63,34,57,59.65,20,24,83.3,9,35,44,34,5,6,19,22
1940,DEN,1,240,48,95,50.5,19,43,44.2,29,52,55.77,19,26,73.1,13,28,41,37,4,2,4,18
1941,TOR,1,240,42,93,45.2,10,27,37,32,66,48.48,18,21,85.7,15,34,49,25,7,5,10,22
1942,UTA,0,240,34,90,37.8,16,39,41,18,51,35.29,7,12,58.3,12,27,39,26,8,8,18,14
1943,PHI,0,240,42,81,51.9,14,34,41.2,28,47,59.57,16,18,88.9,8,22,30,28,8,7,21,26
1944,LAL,1,240,45,88,51.1,12,34,35.3,33,54,61.11,31,38,81.6,8,41,49,28,7,10,12,12
1945,HOU,0,240,47,86,54.7,16,41,39,31,45,68.89,14,19,73.7,8,27,35,27,3,5,9,20
1946,WAS,0,240,41,87,47.1,11,29,37.9,30,58,51.72,27,35,77.1,7,22,29,28,14,3,10,20
1947,MIL,1,240,47,88,53.4,13,35,37.1,34,53,64.15,24,27,88.9,8,37,45,26,3,4,9,21
1948,SAC,1,240,41,91,45.1,15,44,34.1,26,47,55.32,27,42,64.3,12,34,46,25,8,7,10,23
1949,HOU,0,240,42,85,49.4,8,29,27.6,34,56,60.71,23,29,79.3,10,30,40,33,2,6,12,27
1950,NYK,1,240,41,88,46.6,15,38,39.5,26,50,52,18,20,90,15,39,54,21,10,7,16,12
1951,OKC,0,240,37,90,41.1,11,30,36.7,26,60,43.33,18,23,78.3,9,27,36,22,8,4,10,23
1952,ATL,0,240,35,101,34.7,13,44,29.5,22,57,38.6,22,24,91.7,14,30,44,21,9,3,11,16
1953,MIA,0,240,48,94,51.1,14,30,46.7,34,64,53.12,14,21,66.7,8,27,35,32,3,5,6,22
1954,CLE,1,240,50,93,53.8,13,36,36.1,37,57,64.91,15,17,88.2,12,43,55,27,8,12,17,20
1955,BOS,1,240,47,90,52.2,21,49,42.9,26,41,63.41,9,12,75,11,41,52,36,6,9,16,18
1956,MIN,1,240,33,78,42.3,14,33,42.4,19,45,42.22,26,32,81.3,10,41,51,18,3,9,20,17
1957,CHA,0,240,37,89,41.6,13,31,41.9,24,58,41.38,4,7,57.1,13,28,41,21,8,2,17,14
1958,DAL,1,240,42,89,47.2,12,34,35.3,30,55,54.55,25,29,86.2,9,29,38,25,5,4,7,25
1959,TOR,0,240,39,101,38.6,13,36,36.1,26,65,40,12,19,63.2,15,31,46,27,11,3,7,21
1960,GSW,0,240,40,83,48.2,17,41,41.5,23,42,54.76,26,30,86.7,9,43,52,25,6,6,20,31
1961,BKN,1,240,40,89,44.9,13,38,34.2,27,51,52.94,22,26,84.6,13,46,59,26,7,8,15,17
1962,CHI,0,240,39,90,43.3,9,28,32.1,30,62,48.39,10,18,55.6,9,28,37,25,11,7,8,13
1963,PHI,1,240,47,93,50.5,22,46,47.8,25,47,53.19,22,26,84.6,15,33,48,33,11,2,7,17
1964,DET,0,240,43,102,42.2,8,38,21.1,35,64,54.69,13,19,68.4,18,31,49,29,7,11,17,22
1965,DEN,1,240,44,92,47.8,10,22,45.5,34,70,48.57,15,28,53.6,18,34,52,28,8,6,11,22
1966,LAC,0,240,35,85,41.2,6,20,30,29,65,44.62,28,34,82.4,16,33,49,18,6,9,13,23
1967,NOP,0,240,44,88,50,7,22,31.8,37,66,56.06,17,25,68,11,37,48,27,5,1,8,25
1968,UTA,1,240,37,88,42,17,48,35.4,20,40,50,23,28,82.1,9,34,43,31,6,4,10,23
1969,POR,1,240,40,85,47.1,9,18,50,31,67,46.27,25,31,80.6,9,29,38,20,6,4,16,21
1970,LAL,0,240,39,83,47,7,28,25,32,55,58.18,9,13,69.2,6,26,32,23,3,4,17,18
1971,WAS,1,240,45,89,50.6,10,29,34.5,35,60,58.33,26,28,92.9,6,40,46,29,8,6,16,19
1972,IND,0,240,42,88,47.7,8,33,24.2,34,55,61.82,18,24,75,10,32,42,26,10,6,20,24
1973,CLE,1,240,45,97,46.4,10,31,32.3,35,66,53.03,5,6,83.3,12,37,49,29,2,5,14,18
1974,CHI,0,240,40,83,48.2,12,32,37.5,28,51,54.9,17,22,77.3,10,30,40,21,3,2,11,18
1975,MIL,1,240,35,89,39.3,14,42,33.3,21,47,44.68,24,32,75,18,34,52,19,13,11,17,20
1976,MEM,0,240,34,88,38.6,10,37,27,24,51,47.06,19,27,70.4,11,24,35,24,4,4,14,18
1977,ORL,1,240,47,87,54,10,27,37,37,60,61.67,26,33,78.8,7,37,44,33,10,3,15,26
1978,DEN,1,240,50,89,56.2,12,28,42.9,38,61,62.3,20,25,80,11,34,45,38,8,3,20,25
1979,POR,0,240,37,91,40.7,13,32,40.6,24,59,40.68,15,20,75,11,29,40,21,15,4,20,26
1980,PHX,1,240,42,91,46.2,16,38,42.1,26,53,49.06,16,21,76.2,18,29,47,27,4,11,13,25
1981,ATL,0,240,36,88,40.9,19,53,35.8,17,35,48.57,12,19,63.2,11,32,43,15,5,4,16,17
1982,TOR,0,240,37,89,41.6,8,32,25,29,57,50.88,20,29,69,17,33,50,17,9,3,12,11
1983,MIN,1,240,43,81,53.1,15,34,44.1,28,47,59.57,18,23,78.3,6,36,42,30,5,5,16,26
1984,CHA,0,240,44,83,53,13,30,43.3,31,53,58.49,16,25,64,5,31,36,27,6,7,18,26
1985,NYK,0,240,39,86,45.3,12,29,41.4,27,57,47.37,23,32,71.9,13,25,38,18,7,5,7,19
1986,BKN,1,240,41,83,49.4,25,53,47.2,16,30,53.33,11,15,73.3,8,31,39,29,7,2,11,19
1987,SAS,0,240,42,93,45.2,14,37,37.8,28,56,50,22,26,84.6,10,25,35,34,10,6,15,22
1988,BOS,1,240,42,95,44.2,13,47,27.7,29,48,60.42,16,20,80,18,40,58,24,9,3,13,19
1989,MIA,0,240,38,87,43.7,11,34,32.4,27,53,50.94,10,13,76.9,13,31,44,24,6,3,18,18
1990,UTA,1,240,38,87,43.7,15,43,34.9,23,44,52.27,14,17,82.4,14,38,52,23,8,6,24,13
1991,NOP,0,240,39,93,41.9,11,36,30.6,28,57,49.12,11,18,61.1,13,29,42,31,15,4,13,17
1992,ATL,1,240,52,102,51,18,37,48.6,34,65,52.31,14,20,70,17,32,49,29,13,2,10,15
1993,DAL,0,240,34,91,37.4,9,38,23.7,25,53,47.17,11,14,78.6,10,27,37,17,6,5,9,24
1994,WAS,0,240,43,88,48.9,10,38,26.3,33,50,66,12,12,100,8,33,41,33,5,6,20,17
1995,LAC,1,240,38,88,43.2,8,29,27.6,30,59,50.85,23,31,74.2,17,40,57,25,2,6,13,16
1996,LAL,1,240,47,90,52.2,9,27,33.3,38,63,60.32,18,21,85.7,9,35,44,34,9,8,18,15
1997,CLE,0,240,43,91,47.3,9,28,32.1,34,63,53.97,20,23,87,7,30,37,30,13,4,14,16
1998,BKN,1,240,39,78,50,14,36,38.9,25,42,59.52,20,23,87,8,34,42,27,11,9,13,18
1999,OKC,0,240,43,98,43.9,16,43,37.2,27,55,49.09,21,26,80.8,13,25,38,29,3,3,4,27
2000,PHI,1,240,38,83,45.8,14,41,34.1,24,42,57.14,37,45,82.2,17,32,49,30,2,9,13,26
2001,HOU,1,240,40,82,48.8,12,29,41.4,28,53,52.83,13,15,86.7,6,43,49,25,9,9,14,21
2002,MIN,0,240,36,82,43.9,12,33,36.4,24,49,48.98,27,29,93.1,10,34,44,25,6,9,18,18
2003,WAS,0,240,48,100,48,15,37,40.5,33,63,52.38,17,21,81,12,34,46,29,3,4,9,24
2004,SAC,1,240,49,100,49,17,35,48.6,32,65,49.23,9,11,81.8,14,32,46,25,7,4,13,19
2005,BOS,0,240,31,76,40.8,7,29,24.1,24,47,51.06,27,37,73,4,27,31,17,10,4,15,18
2006,DEN,0,240,32,94,34,7,30,23.3,25,64,39.06,15,21,71.4,16,30,46,17,8,4,15,14
2007,TOR,1,240,44,83,53,13,39,33.3,31,44,70.45,20,27,74.1,13,27,40,32,8,6,14,14
2008,NOP,1,240,43,88,48.9,10,24,41.7,33,64,51.56,20,27,74.1,12,38,50,26,6,5,15,19
2009,MEM,0,240,37,80,46.3,9,33,27.3,28,47,59.57,6,10,60,6,29,35,22,6,2,15,22
2010,PHX,1,240,39,76,51.3,11,31,35.5,28,45,62.22,21,28,75,7,34,41,22,10,6,13,12
2011,LAC,0,240,42,92,45.7,11,37,29.7,31,55,56.36,11,17,64.7,8,31,39,27,11,8,11,24
2012,IND,1,240,49,102,48,16,38,42.1,33,64,51.56,22,24,91.7,15,25,40,24,7,8,9,21
2013,MIA,0,240,34,87,39.1,10,37,27,24,50,48,20,21,95.2,10,31,41,20,11,0,11,19
2014,GSW,1,240,40,81,49.4,19,42,45.2,21,39,53.85,19,24,79.2,7,34,41,35,7,2,24,21
2015,NYK,1,240,39,81,48.1,10,29,34.5,29,52,55.77,12,18,66.7,6,40,46,21,7,2,19,14
2016,MIL,1,240,48,92,52.2,9,31,29,39,61,63.93,26,33,78.8,10,40,50,28,6,6,9,22
2017,DET,0,240,43,90,47.8,7,18,38.9,36,72,50,20,24,83.3,14,29,43,22,6,11,14,18
2018,SAS,0,240,45,100,45,12,47,25.5,33,53,62.26,10,12,83.3,15,31,46,28,10,3,20,18
2019,ORL,1,240,43,85,50.6,11,28,39.3,32,57,56.14,16,22,72.7,13,35,48,23,5,3,18,28
2020,CHI,0,240,42,82,51.2,12,27,44.4,30,55,54.55,12,19,63.2,9,28,37,20,5,2,13,20
2021,DAL,1,240,38,96,39.6,16,50,32,22,46,47.83,12,16,75,11,37,48,21,5,4,4,18
2022,LAC,1,240,39,85,45.9,9,28,32.1,30,57,52.63,22,29,75.9,11,39,50,29,10,3,16,23
2023,NOP,1,240,41,87,47.1,7,30,23.3,34,57,59.65,28,37,75.7,13,35,48,23,10,2,10,28
2024,OKC,1,240,37,75,49.3,11,29,37.9,26,46,56.52,31,38,81.6,11,34,45,24,4,12,14,17
2025,MIN,1,240,43,89,48.3,10,26,38.5,33,63,52.38,16,24,66.7,10,38,48,28,10,8,13,21
2026,BKN,0,265,55,113,48.7,15,35,42.9,40,78,51.28,20,24,83.3,22,37,59,28,8,6,16,24
2027,MEM,0,240,27,82,32.9,7,32,21.9,20,50,40,30,35,85.7,9,37,46,17,3,7,9,19
2028,DEN,0,240,44,93,47.3,15,35,42.9,29,58,50,16,21,76.2,17,25,42,29,6,2,12,25
2029,SAS,0,240,35,91,38.5,11,38,28.9,24,53,45.28,21,23,91.3,10,34,44,26,8,6,14,24
2030,PHI,0,240,34,87,39.1,7,32,21.9,27,55,49.09,24,30,80,16,32,48,21,9,12,15,23
2031,PHX,1,240,34,76,44.7,11,28,39.3,23,48,47.92,44,52,84.6,11,32,43,22,9,8,15,22
2032,CHI,0,240,34,88,38.6,17,44,38.6,17,44,38.64,17,17,100,11,27,38,22,7,2,12,26
2033,WAS,0,240,44,97,45.4,11,32,34.4,33,65,50.77,15,18,83.3,11,36,47,26,7,3,10,18
2034,HOU,1,240,40,92,43.5,14,43,32.6,26,49,53.06,17,20,85,6,43,49,22,6,6,7,22
2035,SAC,0,240,34,76,44.7,15,44,34.1,19,32,59.38,29,35,82.9,4,34,38,22,3,1,16,25
2036,GSW,0,240,43,90,47.8,10,32,31.3,33,58,56.9,19,29,65.5,11,32,43,29,10,3,16,34
2037,ATL,1,265,51,116,44,18,49,36.7,33,67,49.25,27,29,93.1,22,36,58,24,10,8,14,18
2038,LAL,0,240,39,84,46.4,11,29,37.9,28,55,50.91,12,19,63.2,9,42,51,26,1,2,13,17
2039,BOS,1,240,44,84,52.4,17,42,40.5,27,42,64.29,14,17,82.4,4,39,43,27,3,5,15,15
2040,IND,0,240,50,91,54.9,18,39,46.2,32,52,61.54,13,16,81.3,5,26,31,33,10,6,15,24
2041,TOR,1,240,48,90,53.3,11,27,40.7,37,63,58.73,25,30,83.3,13,33,46,26,7,3,19,15
2042,UTA,0,240,37,79,46.8,10,31,32.3,27,48,56.25,21,26,80.8,14,30,44,25,7,3,24,13
2043,MIA,1,240,46,88,52.3,20,35,57.1,26,53,49.06,17,21,81,10,31,41,30,11,7,12,19
2044,ORL,1,240,44,81,54.3,10,29,34.5,34,52,65.38,26,30,86.7,11,30,41,27,9,7,12,21
2045,MIL,0,240,45,101,44.6,13,34,38.2,32,67,47.76,13,17,76.5,13,34,47,23,9,2,9,19
2046,POR,1,240,47,92,51.1,17,39,43.6,30,53,56.6,10,15,66.7,14,23,37,31,9,6,14,21
2047,CLE,0,240,36,77,46.8,14,30,46.7,22,47,46.81,10,14,71.4,7,27,34,25,5,6,19,17
2048,CHA,1,240,43,91,47.3,16,37,43.2,27,54,50,15,21,71.4,11,38,49,27,6,4,13,15
2049,UTA,0,240,38,98,38.8,11,44,25,27,54,50,12,16,75,13,29,42,25,6,3,14,22
2050,TOR,0,240,38,75,50.7,14,28,50,24,47,51.06,17,22,77.3,5,33,38,29,6,6,24,20
2051,ORL,1,240,50,100,50,12,31,38.7,38,69,55.07,14,20,70,15,25,40,31,12,8,13,19
2052,POR,0,240,38,87,43.7,14,31,45.2,24,56,42.86,17,20,85,12,18,30,20,8,3,13,20
2053,ATL,0,240,57,95,60,15,31,48.4,42,64,65.62,23,28,82.1,12,27,39,28,8,4,15,23
2054,IND,1,240,57,94,60.6,22,45,48.9,35,49,71.43,21,28,75,7,22,29,35,7,11,14,25
2055,CLE,1,265,46,94,48.9,9,25,36,37,69,53.62,21,25,84,14,42,56,33,9,4,16,21
2056,LAL,1,240,49,86,57,11,29,37.9,38,57,66.67,22,27,81.5,9,43,52,35,6,5,15,15
2057,PHX,1,240,43,76,56.6,7,17,41.2,36,59,61.02,27,28,96.4,11,27,38,26,8,8,15,18
2058,PHI,0,265,40,96,41.7,11,35,31.4,29,61,47.54,28,34,82.4,14,30,44,19,12,8,14,25
2059,HOU,0,240,44,95,46.3,13,41,31.7,31,54,57.41,15,19,78.9,15,33,48,28,6,3,8,24
2060,SAS,0,240,39,90,43.3,10,38,26.3,29,52,55.77,11,14,78.6,13,36,49,23,4,7,16,17
2061,NYK,0,240,32,92,34.8,9,38,23.7,23,54,42.59,27,34,79.4,17,33,50,16,8,3,10,23
2062,SAC,0,240,33,87,37.9,11,45,24.4,22,42,52.38,16,24,66.7,9,27,36,27,4,5,13,21
2063,CHA,1,265,46,104,44.2,13,39,33.3,33,65,50.77,16,17,94.1,17,40,57,29,9,7,13,18
2064,MIL,1,240,55,94,58.5,11,29,37.9,44,65,67.69,21,28,75,16,39,55,33,3,6,15,13
2065,MIN,1,240,41,80,51.3,11,34,32.4,30,46,65.22,24,32,75,7,37,44,30,7,7,14,26
2066,LAC,1,240,45,95,47.4,12,36,33.3,33,59,55.93,22,25,88,10,41,51,30,15,3,7,10
2067,DEN,1,240,40,87,46,11,28,39.3,29,59,49.15,16,21,76.2,11,32,43,30,7,8,14,17
2068,CHI,0,240,37,81,45.7,11,37,29.7,26,44,59.09,15,16,93.8,7,29,36,21,2,7,11,16
2069,DET,0,240,36,81,44.4,7,21,33.3,29,60,48.33,24,26,92.3,11,32,43,21,7,5,18,24
2070,MIA,1,240,42,84,50,17,35,48.6,25,49,51.02,17,20,85,9,34,43,31,7,1,10,19
2071,GSW,1,240,36,77,46.8,21,43,48.8,15,34,44.12,28,33,84.8,8,35,43,26,3,1,8,21
2072,WAS,0,240,55,99,55.6,10,29,34.5,45,70,64.29,9,11,81.8,5,21,26,29,6,4,4,19
2073,NOP,1,240,50,92,54.3,12,28,42.9,38,64,59.38,17,21,81,10,45,55,38,8,6,12,19
2074,BOS,0,265,42,97,43.3,16,50,32,26,47,55.32,18,28,64.3,11,37,48,19,6,8,15,15
2075,TOR,1,240,55,102,53.9,14,36,38.9,41,66,62.12,18,29,62.1,12,35,47,44,10,5,8,23
2076,MEM,0,240,37,95,38.9,17,44,38.6,20,51,39.22,9,10,90,14,28,42,28,7,5,11,21
2077,PHX,1,290,50,102,49,18,45,40,32,57,56.14,22,26,84.6,11,33,44,36,11,13,18,28
2078,UTA,0,290,48,115,41.7,15,46,32.6,33,69,47.83,26,32,81.3,27,32,59,27,11,5,19,27
2079,SAC,1,240,48,90,53.3,17,40,42.5,31,50,62,16,21,76.2,14,34,48,34,9,3,13,20
2080,PHI,1,240,44,94,46.8,16,35,45.7,28,59,47.46,17,18,94.4,10,34,44,32,8,4,5,18
2081,IND,0,240,42,95,44.2,8,31,25.8,34,64,53.12,24,31,77.4,11,29,40,24,10,7,16,32
2082,CLE,1,240,45,82,54.9,11,27,40.7,34,55,61.82,20,26,76.9,11,36,47,30,6,5,14,18
2083,BKN,0,240,38,81,46.9,11,28,39.3,27,53,50.94,12,16,75,9,36,45,24,2,8,15,14
2084,BOS,1,240,35,77,45.5,12,31,38.7,23,46,50,20,25,80,9,36,45,20,6,10,17,19
2085,OKC,1,240,49,81,60.5,22,36,61.1,27,45,60,14,14,100,10,33,43,28,8,3,18,18
2086,LAL,1,240,39,83,47,6,29,20.7,33,54,61.11,21,29,72.4,10,32,42,26,13,1,18,13
2087,ORL,1,240,43,87,49.4,7,20,35,36,67,53.73,35,42,83.3,8,34,42,21,10,10,15,23
2088,POR,0,240,34,85,40,9,34,26.5,25,51,49.02,14,21,66.7,13,18,31,21,10,2,19,15
2089,DAL,0,240,41,88,46.6,12,34,35.3,29,54,53.7,19,26,73.1,11,29,40,23,8,2,10,15
2090,DET,0,240,39,83,47,9,26,34.6,30,57,52.63,26,35,74.3,7,34,41,25,3,3,17,23
2091,DEN,0,240,39,82,47.6,14,29,48.3,25,53,47.17,17,23,73.9,9,24,33,23,7,5,13,21
2092,HOU,0,240,41,84,48.8,14,37,37.8,27,47,57.45,8,10,80,6,28,34,35,7,3,18,25
2093,SAS,0,240,36,83,43.4,15,40,37.5,21,43,48.84,21,26,80.8,12,28,40,26,5,9,15,28
2094,NOP,0,240,44,86,51.2,12,29,41.4,32,57,56.14,20,23,87,13,27,40,27,9,5,17,26
2095,MIA,0,240,33,77,42.9,12,36,33.3,21,41,51.22,19,23,82.6,5,29,34,23,9,0,15,18
2096,DAL,0,240,51,103,49.5,16,47,34,35,56,62.5,7,10,70,11,38,49,27,1,2,12,16
2097,MEM,1,240,40,86,46.5,11,33,33.3,29,53,54.72,29,36,80.6,12,33,45,23,7,3,14,25
2098,CHA,0,240,40,82,48.8,17,35,48.6,23,47,48.94,11,13,84.6,4,32,36,29,5,5,13,22
2099,MIN,1,240,43,80,53.8,13,31,41.9,30,49,61.22,22,27,81.5,5,28,33,29,6,7,14,21
2100,NYK,1,240,46,91,50.5,16,37,43.2,30,54,55.56,14,19,73.7,13,34,47,27,7,4,12,13
2101,MIL,1,240,49,94,52.1,17,45,37.8,32,49,65.31,17,20,85,5,36,41,29,8,3,7,16
2102,CHI,1,240,36,81,44.4,16,45,35.6,20,36,55.56,14,19,73.7,10,34,44,24,9,6,13,22
2103,GSW,0,265,44,97,45.4,18,46,39.1,26,51,50.98,17,21,81,14,35,49,33,6,4,16,18
2104,OKC,1,265,52,100,52,8,23,34.8,44,77,57.14,18,20,90,9,38,47,26,8,7,12,16
2105,NOP,1,240,46,88,52.3,12,23,52.2,34,65,52.31,11,21,52.4,4,35,39,33,8,5,11,13
2106,HOU,0,240,38,88,43.2,10,31,32.3,28,57,49.12,14,20,70,12,35,47,24,6,5,17,28
2107,SAS,0,240,43,92,46.7,15,36,41.7,28,56,50,19,23,82.6,6,36,42,33,7,3,15,21
2108,LAL,1,240,40,81,49.4,12,29,41.4,28,52,53.85,15,22,68.2,11,33,44,27,11,6,18,16
2109,ATL,0,240,40,89,44.9,12,33,36.4,28,56,50,24,30,80,14,25,39,24,8,4,13,20
2110,LAC,1,240,36,83,43.4,13,34,38.2,23,49,46.94,21,30,70,8,39,47,22,10,7,14,19
2111,POR,0,240,36,89,40.4,10,37,27,26,52,50,13,18,72.2,19,29,48,17,11,2,19,17
2112,MIL,1,240,49,89,55.1,22,45,48.9,27,44,61.36,10,13,76.9,4,45,49,32,4,7,13,21
2113,CLE,1,240,42,82,51.2,9,21,42.9,33,61,54.1,15,21,71.4,7,32,39,21,9,6,12,9
2114,WAS,0,240,37,82,45.1,10,32,31.3,27,50,54,15,16,93.8,7,25,32,25,4,4,14,18
2115,NYK,1,240,45,91,49.5,16,38,42.1,29,53,54.72,14,20,70,14,34,48,26,5,6,11,21
2116,UTA,0,240,43,85,50.6,16,36,44.4,27,49,55.1,26,31,83.9,10,29,39,27,3,10,8,23
2117,TOR,0,240,42,87,48.3,12,33,36.4,30,54,55.56,9,14,64.3,5,36,41,29,4,1,13,11
2118,PHX,1,240,45,86,52.3,18,33,54.5,27,53,50.94,23,26,88.5,5,31,36,35,5,4,9,22
2119,PHI,1,240,43,88,48.9,13,30,43.3,30,58,51.72,27,28,96.4,13,30,43,32,9,4,17,20
2120,ORL,1,240,38,79,48.1,11,34,32.4,27,45,60,16,23,69.6,10,36,46,24,7,7,19,22
2121,CHI,0,240,35,79,44.3,10,29,34.5,25,50,50,17,22,77.3,5,29,34,19,10,3,16,21
2122,SAC,1,240,46,85,54.1,18,42,42.9,28,43,65.12,19,24,79.2,4,38,42,31,10,2,14,22
2123,DET,0,240,39,91,42.9,9,35,25.7,30,56,53.57,13,15,86.7,18,33,51,20,8,6,17,19
2124,BOS,1,240,42,92,45.7,16,46,34.8,26,46,56.52,8,9,88.9,8,36,44,29,5,4,11,13
2125,DEN,0,240,47,96,49,10,40,25,37,56,66.07,6,12,50,11,40,51,37,4,3,13,20
2126,CHA,0,240,37,91,40.7,6,26,23.1,31,65,47.69,19,22,86.4,9,34,43,18,5,2,12,14
2127,OKC,1,240,44,87,50.6,19,32,59.4,25,55,45.45,21,23,91.3,7,35,42,31,10,3,13,20
2128,BKN,0,240,40,85,47.1,14,36,38.9,26,49,53.06,21,27,77.8,10,30,40,29,5,3,15,20
2129,MIA,1,240,42,81,51.9,15,35,42.9,27,46,58.7,23,24,95.8,7,25,32,26,8,3,9,20
2130,GSW,0,240,40,98,40.8,14,41,34.1,26,57,45.61,15,19,78.9,20,29,49,27,5,4,16,19
2131,CLE,1,240,42,75,56,9,30,30,33,45,73.33,16,21,76.2,7,40,47,23,5,9,18,16
2132,ORL,1,240,32,82,39,8,28,28.6,24,54,44.44,24,30,80,12,34,46,20,12,3,15,21
2133,POR,0,240,34,91,37.4,13,38,34.2,21,53,39.62,14,16,87.5,8,22,30,24,9,3,14,21
2134,CHI,0,240,33,83,39.8,9,33,27.3,24,50,48,19,22,86.4,14,39,53,16,7,4,19,25
2135,WAS,0,240,43,89,48.3,12,36,33.3,31,53,58.49,19,23,82.6,8,38,46,23,6,1,12,22
2136,PHI,0,240,39,85,45.9,11,30,36.7,28,55,50.91,18,22,81.8,10,31,41,18,5,1,9,14
2137,ATL,0,240,41,75,54.7,12,31,38.7,29,44,65.91,20,26,76.9,6,24,30,28,11,6,15,20
2138,TOR,0,240,38,96,39.6,9,33,27.3,29,63,46.03,27,31,87.1,26,29,55,28,10,8,14,19
2139,MIL,1,240,44,85,51.8,20,39,51.3,24,46,52.17,20,21,95.2,9,32,41,25,8,9,13,25
2140,SAC,1,240,48,96,50,16,44,36.4,32,52,61.54,13,17,76.5,11,34,45,31,20,1,16,20
2141,NYK,1,240,45,94,47.9,16,34,47.1,29,60,48.33,10,11,90.9,14,28,42,29,9,2,17,20
2142,BOS,1,240,42,88,47.7,18,50,36,24,38,63.16,15,19,78.9,12,33,45,23,7,8,10,15
2143,LAL,0,240,42,83,50.6,11,29,37.9,31,54,57.41,15,19,78.9,7,36,43,25,12,6,23,17
2144,DAL,1,240,48,92,52.2,17,42,40.5,31,50,62,17,29,58.6,9,37,46,32,6,4,10,16
2145,PHX,1,240,51,85,60,17,31,54.8,34,54,62.96,14,15,93.3,5,27,32,31,1,4,9,21
2146,MIN,0,240,42,92,45.7,5,27,18.5,37,65,56.92,26,28,92.9,16,24,40,18,8,5,6,14
2147,MEM,0,240,39,106,36.8,20,53,37.7,19,53,35.85,9,12,75,13,20,33,28,8,9,9,15
2148,MIA,1,240,40,83,48.2,8,31,25.8,32,52,61.54,23,28,82.1,10,32,42,26,12,5,8,19
2149,NOP,1,240,49,94,52.1,14,38,36.8,35,56,62.5,19,26,73.1,12,30,42,33,17,6,13,20
2150,LAC,0,240,37,86,43,13,29,44.8,24,57,42.11,21,24,87.5,14,28,42,21,10,1,11,24
2151,UTA,1,240,44,95,46.3,13,43,30.2,31,52,59.62,14,15,93.3,16,36,52,26,11,6,13,18
2152,ORL,0,240,36,82,43.9,16,46,34.8,20,36,55.56,16,21,76.2,9,28,37,23,9,4,16,16
2153,MIN,1,240,36,81,44.4,14,34,41.2,22,47,46.81,18,21,85.7,9,33,42,24,9,5,20,19
2154,DEN,1,240,39,73,53.4,8,23,34.8,31,50,62,25,32,78.1,6,30,36,26,4,2,14,19
2155,ATL,1,240,45,87,51.7,12,33,36.4,33,54,61.11,24,26,92.3,10,31,41,28,9,7,14,19
2156,POR,0,240,37,88,42,11,35,31.4,26,53,49.06,14,20,70,13,30,43,23,5,6,17,15
2157,LAL,1,240,47,81,58,22,35,62.9,25,46,54.35,18,24,75,10,44,54,30,4,10,19,13
2158,IND,1,240,48,93,51.6,13,37,35.1,35,56,62.5,23,33,69.7,10,31,41,32,7,5,11,28
2159,PHI,0,240,43,86,50,6,22,27.3,37,64,57.81,34,35,97.1,5,33,38,22,5,3,16,26
2160,DAL,0,240,38,90,42.2,14,42,33.3,24,48,50,20,26,76.9,16,29,45,25,4,3,20,16
2161,CHA,0,240,36,81,44.4,15,32,46.9,21,49,42.86,18,22,81.8,13,32,45,21,6,0,18,21
2162,BKN,1,240,46,85,54.1,19,39,48.7,27,46,58.7,13,20,65,13,31,44,22,13,3,16,24
2163,DET,0,240,47,90,52.2,10,29,34.5,37,61,60.66,16,23,69.6,14,28,42,36,9,6,17,20
2164,SAS,0,240,36,93,38.7,9,30,30,27,63,42.86,6,9,66.7,13,30,43,24,7,6,25,13
2165,OKC,1,240,46,89,51.7,15,39,38.5,31,50,62,16,20,80,4,36,40,34,19,6,16,17
2166,GSW,0,240,37,88,42,13,39,33.3,24,49,48.98,14,16,87.5,13,33,46,28,11,2,20,22
2167,SAC,1,240,49,83,59,20,42,47.6,29,41,70.73,14,22,63.6,8,29,37,32,3,4,10,19
2168,BOS,1,240,40,79,50.6,19,43,44.2,21,36,58.33,15,16,93.8,8,29,37,27,3,3,11,22
2169,CHI,0,240,38,100,38,14,42,33.3,24,58,41.38,19,21,90.5,18,29,47,24,9,7,8,25
2170,CLE,0,240,45,91,49.5,16,35,45.7,29,56,51.79,14,17,82.4,14,25,39,24,3,1,11,18
2171,NYK,0,240,33,79,41.8,15,35,42.9,18,44,40.91,17,24,70.8,12,25,37,17,5,2,12,16
2172,MIL,1,240,42,89,47.2,15,47,31.9,27,42,64.29,19,27,70.4,13,40,53,23,3,5,17,23
2173,WAS,0,240,43,84,51.2,12,26,46.2,31,58,53.45,9,12,75,8,30,38,32,11,5,22,22
2174,TOR,1,240,45,90,50,4,20,20,41,70,58.57,17,25,68,16,32,48,28,11,4,19,13
2175,HOU,1,240,37,87,42.5,10,32,31.3,27,55,49.09,23,29,79.3,12,33,45,20,7,4,9,16
2176,MIA,1,240,39,89,43.8,12,31,38.7,27,58,46.55,28,30,93.3,11,30,41,26,7,3,7,12
2177,DAL,1,240,50,102,49,20,53,37.7,30,49,61.22,16,21,76.2,8,34,42,29,7,6,6,19
2178,IND,0,240,47,90,52.2,16,39,41,31,51,60.78,16,19,84.2,8,24,32,31,8,9,10,14
2179,PHX,0,240,32,83,38.6,9,29,31,23,54,42.59,26,31,83.9,16,35,51,20,4,7,17,19
2180,BKN,1,240,37,98,37.8,12,49,24.5,25,49,51.02,16,20,80,20,46,66,22,6,6,19,18
2181,MIN,1,240,43,82,52.4,9,27,33.3,34,55,61.82,21,30,70,9,38,47,27,8,6,14,19
2182,NOP,0,240,47,92,51.1,17,36,47.2,30,56,53.57,13,22,59.1,13,41,54,31,2,3,18,20
2183,DEN,0,240,42,91,46.2,9,32,28.1,33,59,55.93,11,14,78.6,12,37,49,24,3,5,11,20
2184,LAL,1,240,41,84,48.8,4,19,21.1,37,65,56.92,30,37,81.1,7,34,41,27,8,4,9,11
2185,CHI,1,240,44,91,48.4,11,30,36.7,33,61,54.1,20,25,80,11,29,40,22,12,6,7,21
2186,MEM,1,240,37,88,42,13,41,31.7,24,47,51.06,18,24,75,11,30,41,25,7,6,16,23
2187,LAC,0,240,37,85,43.5,12,34,35.3,25,51,49.02,15,23,65.2,8,33,41,26,9,3,16,23
2188,SAS,0,240,42,91,46.2,19,44,43.2,23,47,48.94,10,12,83.3,11,39,50,35,3,6,17,21
2189,DET,0,240,38,88,43.2,11,32,34.4,27,56,48.21,21,26,80.8,16,33,49,26,4,6,16,19
2190,OKC,1,240,40,82,48.8,10,27,37,30,55,54.55,21,25,84,6,27,33,23,9,8,9,21
2191,WAS,0,240,33,88,37.5,10,41,24.4,23,47,48.94,18,25,72,7,35,42,20,14,3,12,15
2192,GSW,0,240,37,96,38.5,12,43,27.9,25,53,47.17,24,28,85.7,19,32,51,24,9,0,14,28
2193,POR,0,240,45,90,50,13,37,35.1,32,53,60.38,7,9,77.8,5,33,38,29,2,8,16,25
2194,NYK,1,240,47,87,54,15,36,41.7,32,51,62.75,20,30,66.7,10,30,40,25,8,4,9,18
2195,CHA,0,240,44,94,46.8,12,35,34.3,32,59,54.24,7,11,63.6,15,21,36,21,5,4,12,25
2196,PHI,1,240,53,105,50.5,14,33,42.4,39,72,54.17,17,20,85,23,31,54,28,5,7,12,15
2197,MIL,0,240,38,77,49.4,9,29,31,29,48,60.42,12,25,48,5,31,36,25,9,6,19,24
2198,MIA,1,240,41,84,48.8,12,38,31.6,29,46,63.04,23,25,92,7,32,39,23,10,4,15,14
2199,GSW,0,240,37,90,41.1,13,38,34.2,24,52,46.15,23,30,76.7,15,40,55,26,5,3,20,29
2200,ATL,0,240,38,87,43.7,18,46,39.1,20,41,48.78,15,18,83.3,15,33,48,23,6,6,22,19
2201,TOR,0,240,35,91,38.5,10,37,27,25,54,46.3,14,16,87.5,7,30,37,25,8,1,9,14
2202,BOS,1,240,47,86,54.7,15,44,34.1,32,42,76.19,8,13,61.5,5,41,46,30,1,4,13,14
2203,ORL,1,240,36,84,42.9,10,26,38.5,26,58,44.83,30,35,85.7,15,28,43,24,9,2,16,17
2204,CLE,1,240,37,86,43,11,30,36.7,26,56,46.43,33,43,76.7,11,34,45,23,13,3,11,24
2205,DET,0,240,40,86,46.5,8,28,28.6,32,58,55.17,18,22,81.8,11,37,48,28,3,5,17,26
2206,WAS,0,240,43,88,48.9,14,38,36.8,29,50,58,17,20,85,7,29,36,28,4,6,15,23
2207,LAL,1,240,42,84,50,12,27,44.4,30,57,52.63,26,34,76.5,9,34,43,27,9,7,11,20
2208,DAL,1,240,51,98,52,19,42,45.2,32,56,57.14,23,26,88.5,15,26,41,30,7,1,9,23
2209,BOS,1,240,41,94,43.6,19,52,36.5,22,42,52.38,20,28,71.4,17,35,52,29,5,3,8,13
2210,HOU,1,240,36,88,40.9,10,35,28.6,26,53,49.06,22,28,78.6,9,33,42,20,9,5,9,22
2211,PHI,1,240,35,83,42.2,9,28,32.1,26,55,47.27,35,41,85.4,11,35,46,23,13,5,9,23
2212,NOP,0,240,34,75,45.3,8,25,32,26,50,52,25,34,73.5,8,41,49,12,6,6,18,26
2213,LAC,0,240,43,88,48.9,8,27,29.6,35,61,57.38,32,36,88.9,19,28,47,21,7,2,14,27
2214,BKN,0,240,38,85,44.7,15,37,40.5,23,48,47.92,16,18,88.9,9,37,46,26,0,3,12,25
2215,CHA,1,240,50,110,45.5,6,28,21.4,44,82,53.66,18,28,64.3,28,39,67,31,10,4,10,19
2216,SAS,0,240,43,92,46.7,12,34,35.3,31,58,53.45,12,19,63.2,7,31,38,29,9,8,14,21
2217,SAC,1,240,38,91,41.8,13,47,27.7,25,44,56.82,16,21,76.2,16,36,52,28,10,9,18,22
2218,MEM,0,240,46,101,45.5,19,48,39.6,27,53,50.94,10,13,76.9,14,23,37,23,5,5,11,23
2219,MIN,1,240,43,87,49.4,10,27,37,33,60,55,21,27,77.8,13,38,51,23,6,4,18,19
2220,UTA,1,240,41,76,53.9,18,37,48.6,23,39,58.97,27,29,93.1,8,30,38,28,10,12,21,17
2221,PHX,0,240,42,94,44.7,15,37,40.5,27,57,47.37,20,27,74.1,17,35,52,22,9,1,13,24
2222,OKC,0,240,39,87,44.8,7,30,23.3,32,57,56.14,13,16,81.3,5,33,38,22,9,5,16,15
2223,ORL,0,240,42,90,46.7,10,27,37,32,63,50.79,25,35,71.4,18,29,47,19,12,6,19,24
2224,ATL,1,240,41,85,48.2,15,39,38.5,26,46,56.52,23,30,76.7,8,28,36,22,13,7,18,25
2225,IND,1,240,44,92,47.8,20,48,41.7,24,44,54.55,18,20,90,9,31,40,27,6,6,13,25
2226,MIL,0,240,46,87,52.9,9,27,33.3,37,60,61.67,23,26,88.5,5,36,41,23,6,5,14,19
2227,OKC,1,240,44,86,51.2,12,28,42.9,32,58,55.17,28,30,93.3,12,29,41,23,10,8,14,27
2228,MIL,1,240,41,90,45.6,11,37,29.7,30,53,56.6,27,32,84.4,5,31,36,19,8,7,10,18
2229,DEN,1,240,41,92,44.6,11,35,31.4,30,57,52.63,15,22,68.2,10,35,45,24,7,4,6,20
2230,NYK,1,240,46,100,46,19,42,45.2,27,58,46.55,15,22,68.2,13,34,47,28,7,0,4,14
2231,UTA,0,240,45,96,46.9,11,27,40.7,34,69,49.28,17,18,94.4,16,31,47,26,3,5,22,17
2232,MIA,1,240,35,77,45.5,11,28,39.3,24,49,48.98,27,32,84.4,9,35,44,22,9,8,19,24
2233,DET,0,240,48,98,49,7,29,24.1,41,69,59.42,15,16,93.8,11,42,53,28,2,5,19,24
2234,SAS,0,240,44,90,48.9,9,34,26.5,35,56,62.5,8,13,61.5,11,35,46,31,2,7,13,22
2235,TOR,1,240,49,99,49.5,11,36,30.6,38,63,60.32,18,27,66.7,15,35,50,27,10,4,12,25
2236,PHI,1,240,42,95,44.2,9,34,26.5,33,61,54.1,13,15,86.7,12,44,56,20,7,7,14,16
2237,MEM,0,240,35,90,38.9,11,37,29.7,24,53,45.28,21,28,75,13,25,38,20,10,4,14,27
2238,BKN,1,240,37,92,40.2,15,41,36.6,22,51,43.14,11,13,84.6,14,35,49,22,10,10,14,14
2239,LAL,0,240,36,85,42.4,7,25,28,29,60,48.33,15,24,62.5,5,29,34,20,7,6,9,18
2240,WAS,1,240,47,97,48.5,18,43,41.9,29,54,53.7,20,25,80,13,27,40,26,10,6,11,26
2241,NOP,0,240,36,93,38.7,8,28,28.6,28,65,43.08,21,22,95.5,11,29,40,23,6,1,17,23
2242,BOS,0,240,36,91,39.6,15,47,31.9,21,44,47.73,16,19,84.2,9,34,43,28,8,6,13,13
2243,CHI,0,265,42,96,43.8,14,33,42.4,28,63,44.44,17,23,73.9,9,30,39,30,12,7,14,22
2244,DAL,0,240,40,84,47.6,17,41,41.5,23,43,53.49,19,31,61.3,6,32,38,25,4,6,16,21
2245,GSW,0,240,37,86,43,11,35,31.4,26,51,50.98,20,26,76.9,11,38,49,21,5,0,9,20
2246,POR,0,265,44,87,50.6,8,22,36.4,36,65,55.38,22,29,75.9,7,29,36,26,10,5,18,29
2247,SAC,1,265,41,89,46.1,11,37,29.7,30,52,57.69,28,38,73.7,15,35,50,32,11,6,21,24
2248,CLE,0,240,42,83,50.6,9,29,31,33,54,61.11,27,37,73,11,30,41,26,9,5,20,24
2249,LAC,0,240,36,91,39.6,8,36,22.2,28,55,50.91,13,13,100,11,40,51,22,10,8,16,15
2250,HOU,1,240,51,93,54.8,14,33,42.4,37,60,61.67,12,19,63.2,14,43,57,26,4,4,13,23
2251,PHX,1,265,38,90,42.2,19,48,39.6,19,42,45.24,21,25,84,13,41,54,32,7,10,22,20
2252,IND,1,240,52,101,51.5,13,41,31.7,39,60,65,17,20,85,14,32,46,26,14,7,12,15
2253,MIN,1,240,45,82,54.9,15,37,40.5,30,45,66.67,17,24,70.8,8,40,48,30,9,7,18,23
2254,CHA,0,240,41,79,51.9,8,25,32,33,54,61.11,26,35,74.3,11,36,47,17,8,5,22,22
2255,HOU,1,240,43,75,57.3,15,31,48.4,28,44,63.64,21,27,77.8,5,34,39,28,8,4,11,19
2256,BOS,0,265,36,92,39.1,11,39,28.2,25,53,47.17,26,34,76.5,11,34,45,20,13,2,18,26
2257,BKN,0,240,49,101,48.5,16,45,35.6,33,56,58.93,11,13,84.6,11,35,46,22,2,4,8,16
2258,MIN,1,265,44,85,51.8,13,37,35.1,31,48,64.58,13,25,52,6,39,45,26,7,5,24,26
2259,GSW,1,240,46,97,47.4,12,41,29.3,34,56,60.71,16,21,76.2,17,27,44,26,8,4,11,14
2260,MIL,1,240,46,96,47.9,16,48,33.3,30,48,62.5,21,24,87.5,12,36,48,26,6,2,10,13
2261,UTA,0,240,41,86,47.7,16,43,37.2,25,43,58.14,15,17,88.2,17,35,52,32,1,7,23,20
2262,ATL,0,240,38,102,37.3,14,42,33.3,24,60,40,27,32,84.4,25,34,59,27,8,3,15,16
2263,IND,1,240,55,95,57.9,20,38,52.6,35,57,61.4,22,23,95.7,9,40,49,38,7,4,15,24
2264,PHI,1,240,51,91,56,12,31,38.7,39,60,65,32,36,88.9,10,35,45,37,12,7,16,15
2265,DET,0,240,38,80,47.5,13,30,43.3,25,50,50,20,21,95.2,7,32,39,23,8,2,16,20
2266,DAL,1,240,41,82,50,15,40,37.5,26,42,61.9,20,28,71.4,5,26,31,21,9,6,15,20
2267,DEN,1,240,51,95,53.7,15,39,38.5,36,56,64.29,17,23,73.9,11,34,45,37,6,5,10,16
2268,CHI,1,240,48,93,51.6,18,34,52.9,30,59,50.85,16,19,84.2,10,26,36,26,12,3,8,18
2269,OKC,1,240,45,94,47.9,14,35,40,31,59,52.54,22,23,95.7,11,38,49,27,7,7,13,22
2270,LAC,0,240,36,73,49.3,11,32,34.4,25,41,60.98,14,16,87.5,7,24,31,21,8,3,22,15
2271,ORL,0,240,40,85,47.1,8,27,29.6,32,58,55.17,14,18,77.8,6,32,38,27,6,4,21,24
2272,WAS,0,240,49,96,51,14,34,41.2,35,62,56.45,16,20,80,10,28,38,31,6,10,19,26
2273,MIA,1,240,41,88,46.6,12,37,32.4,29,51,56.86,14,16,87.5,11,33,44,30,11,4,18,14
2274,NYK,1,240,41,88,46.6,12,31,38.7,29,57,50.88,17,18,94.4,18,30,48,28,13,1,20,13
2275,SAC,0,240,36,81,44.4,14,40,35,22,41,53.66,11,20,55,12,22,34,22,5,2,15,22
2276,SAS,0,240,40,94,42.6,8,26,30.8,32,68,47.06,23,30,76.7,12,24,36,26,7,5,11,15
2277,NOP,0,240,45,90,50,13,30,43.3,32,60,53.33,13,15,86.7,8,30,38,24,6,2,13,18
2278,LAL,0,240,44,81,54.3,8,26,30.8,36,55,65.45,11,14,78.6,5,33,38,28,6,5,17,17
2279,DAL,1,240,43,91,47.3,14,42,33.3,29,49,59.18,24,32,75,9,38,47,31,3,6,11,19
2280,POR,0,240,37,95,38.9,14,45,31.1,23,50,46,12,15,80,16,31,47,23,11,5,14,21
2281,PHX,1,240,43,86,50,8,21,38.1,35,65,53.85,26,29,89.7,14,29,43,29,8,10,18,13
2282,CLE,1,240,41,83,49.4,11,37,29.7,30,46,65.22,22,28,78.6,13,41,54,26,8,2,18,21
2283,GSW,0,240,34,94,36.2,16,41,39,18,53,33.96,20,30,66.7,17,27,44,26,10,4,13,18
2284,TOR,1,265,44,97,45.4,19,48,39.6,25,49,51.02,16,26,61.5,13,34,47,29,12,6,15,15
2285,MEM,1,240,45,89,50.6,13,32,40.6,32,57,56.14,9,13,69.2,10,39,49,27,6,7,17,18
2286,CHA,0,240,49,99,49.5,8,30,26.7,41,69,59.42,12,21,57.1,10,33,43,30,5,2,9,25
2287,DET,0,240,43,87,49.4,8,23,34.8,35,64,54.69,12,14,85.7,10,23,33,25,7,6,16,23
2288,SAS,0,265,48,96,50,10,32,31.3,38,64,59.38,10,13,76.9,9,37,46,30,7,7,17,21
2289,MIN,1,240,45,81,55.6,9,24,37.5,36,57,63.16,24,31,77.4,9,34,43,25,10,11,11,23
2290,CHI,0,240,39,86,45.3,7,26,26.9,32,60,53.33,16,23,69.6,9,28,37,28,7,3,11,19
2291,CHA,1,240,47,88,53.4,8,20,40,39,68,57.35,23,23,100,12,29,41,23,5,10,13,20
2292,HOU,1,240,40,87,46,13,36,36.1,27,51,52.94,14,20,70,10,43,53,28,4,3,11,18
2293,DEN,1,240,42,81,51.9,16,36,44.4,26,45,57.78,23,30,76.7,10,39,49,31,10,4,12,18
2294,ATL,1,240,45,93,48.4,14,41,34.1,31,52,59.62,19,24,79.2,19,33,52,28,4,6,13,16
2295,PHX,0,240,32,89,36,9,35,25.7,23,54,42.59,27,33,81.8,15,27,42,22,11,12,11,11
2296,LAL,0,240,37,84,44,8,30,26.7,29,54,53.7,19,21,90.5,10,30,40,17,6,10,17,21
2297,UTA,0,240,35,91,38.5,12,43,27.9,23,48,47.92,13,17,76.5,17,22,39,20,3,7,18,20
2298,ORL,1,240,46,101,45.5,12,33,36.4,34,68,50,16,19,84.2,19,32,51,29,6,9,16,18
2299,BOS,1,240,43,90,47.8,15,45,33.3,28,45,62.22,23,27,85.2,10,40,50,22,4,6,11,17
2300,IND,0,240,45,93,48.4,22,45,48.9,23,48,47.92,12,16,75,11,25,36,31,7,5,15,18
2301,BKN,0,240,43,100,43,17,52,32.7,26,48,54.17,11,17,64.7,10,32,42,22,4,5,6,21
2302,NOP,0,240,40,84,47.6,8,31,25.8,32,53,60.38,17,21,81,9,26,35,24,9,7,11,15
2303,SAC,0,240,32,84,38.1,11,41,26.8,21,43,48.84,14,19,73.7,8,35,43,20,5,6,11,19
2304,PHI,1,240,43,90,47.8,11,30,36.7,32,60,53.33,15,18,83.3,15,36,51,24,5,6,18,24
2305,POR,1,265,39,96,40.6,9,32,28.1,30,64,46.88,28,36,77.8,15,35,50,19,12,7,14,15
2306,BKN,1,240,44,96,45.8,18,45,40,26,51,50.98,3,5,60,8,31,39,32,4,4,11,12
2307,DEN,1,240,49,93,52.7,13,30,43.3,36,63,57.14,14,19,73.7,19,32,51,33,11,6,20,17
2308,CLE,0,240,44,84,52.4,8,28,28.6,36,56,64.29,20,25,80,5,30,35,27,10,9,13,20
2309,OKC,0,240,50,83,60.2,15,29,51.7,35,54,64.81,24,30,80,7,25,32,26,3,1,19,20
2310,GSW,1,240,49,92,53.3,18,40,45,31,52,59.62,25,30,83.3,13,25,38,36,9,2,15,25
2311,WAS,0,240,46,81,56.8,13,28,46.4,33,53,62.26,9,17,52.9,4,26,30,33,7,4,20,18
2312,DAL,0,240,41,86,47.7,17,42,40.5,24,44,54.55,15,17,88.2,10,24,34,27,12,6,15,19
2313,IND,1,240,45,86,52.3,15,31,48.4,30,55,54.55,16,24,66.7,7,33,40,28,7,5,19,18
2314,MEM,0,265,47,96,49,10,35,28.6,37,61,60.66,9,13,69.2,7,41,48,29,8,10,17,25
2315,CHI,0,240,43,89,48.3,11,28,39.3,32,61,52.46,10,14,71.4,9,33,42,21,4,4,10,13
2316,MIL,1,240,35,82,42.7,20,39,51.3,15,43,34.88,20,28,71.4,7,34,41,24,6,11,14,16
2317,MIA,1,240,48,80,60,13,27,48.1,35,53,66.04,12,14,85.7,7,30,37,35,9,1,21,18
2318,NYK,0,240,38,96,39.6,10,39,25.6,28,57,49.12,19,25,76,16,40,56,18,6,1,11,22
2319,NOP,1,240,39,80,48.8,14,32,43.8,25,48,52.08,33,35,94.3,7,29,36,27,5,7,12,18
2320,UTA,0,240,41,89,46.1,12,33,36.4,29,56,51.79,19,26,73.1,13,35,48,27,9,7,20,27
2321,ORL,1,240,39,85,45.9,10,29,34.5,29,56,51.79,27,36,75,10,33,43,27,17,9,17,25
2322,SAS,1,240,51,98,52,18,37,48.6,33,61,54.1,12,13,92.3,9,32,41,37,7,5,8,21
2323,PHX,0,240,43,80,53.8,16,32,50,27,48,56.25,19,26,73.1,5,29,34,26,5,4,14,15
2324,DET,0,240,41,94,43.6,13,38,34.2,28,56,50,21,26,80.8,19,29,48,30,4,5,16,31
2325,PHI,1,240,42,92,45.7,9,25,36,33,67,49.25,21,25,84,15,31,46,21,12,3,14,19
2326,TOR,0,240,38,79,48.1,10,28,35.7,28,51,54.9,13,19,68.4,9,32,41,30,4,3,19,20
2327,CHA,0,240,45,90,50,11,27,40.7,34,63,53.97,18,25,72,15,29,44,21,9,8,16,19
2328,DEN,0,240,38,96,39.6,6,33,18.2,32,63,50.79,7,10,70,12,31,43,23,6,10,16,22
2329,LAL,1,265,46,90,51.1,11,32,34.4,35,58,60.34,27,36,75,9,42,51,28,10,9,14,24
2330,SAC,0,240,36,88,40.9,11,35,31.4,25,53,47.17,18,23,78.3,14,34,48,24,8,4,15,17
2331,MIL,0,240,35,76,46.1,13,34,38.2,22,42,52.38,28,38,73.7,7,22,29,19,9,2,12,17
2332,WAS,0,240,51,101,50.5,10,40,25,41,61,67.21,9,14,64.3,6,29,35,32,14,3,11,25
2333,CLE,1,240,32,74,43.2,12,32,37.5,20,42,47.62,19,20,95,6,40,46,22,7,5,18,27
2334,BOS,1,240,54,95,56.8,20,35,57.1,34,60,56.67,27,28,96.4,11,46,57,27,5,2,13,19
2335,MIN,1,240,38,83,45.8,8,21,38.1,30,62,48.39,26,27,96.3,8,39,47,20,9,5,14,15
2336,OKC,0,240,38,88,43.2,7,34,20.6,31,54,57.41,23,25,92,6,43,49,23,6,5,15,24
2337,NOP,1,240,40,102,39.2,13,42,31,27,60,45,17,29,58.6,22,36,58,23,8,5,11,20
2338,ATL,1,240,46,92,50,9,32,28.1,37,60,61.67,29,32,90.6,14,43,57,26,8,3,21,16
2339,BKN,1,240,37,82,45.1,16,36,44.4,21,46,45.65,19,26,73.1,7,40,47,27,11,4,18,18
2340,DAL,1,240,37,81,45.7,20,48,41.7,17,33,51.52,20,28,71.4,13,32,45,23,7,2,15,11
2341,LAC,0,265,47,99,47.5,14,34,41.2,33,65,50.77,17,27,63,12,34,46,22,12,1,13,31
2342,NYK,0,240,32,92,34.8,5,30,16.7,27,62,43.55,20,30,66.7,16,34,50,18,10,3,14,16
2343,MIA,0,240,39,91,42.9,13,38,34.2,26,53,49.06,14,18,77.8,11,35,46,22,10,5,18,20
2344,POR,1,240,38,81,46.9,7,20,35,31,61,50.82,27,33,81.8,7,37,44,23,10,7,17,15
2345,UTA,1,240,47,87,54,22,43,51.2,25,44,56.82,17,24,70.8,10,40,50,35,7,3,21,22
2346,DET,0,240,40,90,44.4,11,29,37.9,29,61,47.54,10,11,90.9,6,32,38,24,12,4,18,31
2347,TOR,1,240,51,91,56,15,38,39.5,36,53,67.92,13,14,92.9,15,35,50,35,7,6,18,25
2348,IND,0,240,46,101,45.5,5,37,13.5,41,64,64.06,7,12,58.3,8,23,31,26,6,6,9,20
2349,HOU,1,240,44,84,52.4,21,37,56.8,23,47,48.94,19,23,82.6,7,31,38,35,10,2,17,22
2350,CHI,0,240,42,89,47.2,11,33,33.3,31,56,55.36,10,11,90.9,12,31,43,19,10,3,13,23
2351,GSW,1,240,39,81,48.1,11,31,35.5,28,50,56,13,15,86.7,7,29,36,32,5,6,18,17
2352,MEM,0,240,35,96,36.5,14,54,25.9,21,42,50,25,32,78.1,14,28,42,25,12,7,16,22
2353,ORL,0,240,38,81,46.9,7,30,23.3,31,51,60.78,19,33,57.6,7,33,40,23,9,3,16,24
2354,PHX,0,240,42,83,50.6,18,39,46.2,24,44,54.55,12,15,80,6,37,43,29,8,7,19,18
2355,LAC,1,240,44,89,49.4,14,31,45.2,30,58,51.72,16,23,69.6,9,35,44,29,10,4,16,26
2356,NYK,1,240,38,86,44.2,13,34,38.2,25,52,48.08,20,25,80,12,36,48,18,9,1,14,17
2357,SAS,1,240,43,92,46.7,14,37,37.8,29,55,52.73,15,20,75,8,29,37,25,10,9,12,17
2358,CLE,0,240,36,92,39.1,10,38,26.3,26,54,48.15,9,12,75,14,32,46,19,6,6,15,19
2359,CHI,1,240,40,87,46,6,17,35.3,34,70,48.57,26,31,83.9,10,34,44,19,8,6,13,17
2360,BKN,1,240,49,87,56.3,12,33,36.4,37,54,68.52,23,32,71.9,10,36,46,25,4,8,14,19
2361,POR,1,240,38,85,44.7,11,35,31.4,27,50,54,12,15,80,13,38,51,20,6,7,16,19
2362,CHA,0,240,47,96,49,8,31,25.8,39,65,60,19,20,95,8,31,39,33,8,5,10,23
2363,ORL,0,240,38,95,40,14,35,40,24,60,40,13,18,72.2,12,32,44,28,10,3,11,22
2364,WAS,0,240,39,87,44.8,11,36,30.6,28,51,54.9,18,26,69.2,11,29,40,26,12,4,15,13
2365,MIL,1,240,44,87,50.6,12,37,32.4,32,50,64,22,30,73.3,9,34,43,24,8,5,15,23
2366,TOR,0,240,38,94,40.4,4,29,13.8,34,65,52.31,11,15,73.3,14,33,47,19,10,4,12,17
2367,BOS,1,240,51,102,50,19,53,35.8,32,49,65.31,5,7,71.4,15,36,51,31,11,6,18,21
2368,MEM,0,240,42,92,45.7,14,37,37.8,28,55,50.91,12,20,60,10,34,44,22,9,4,12,22
2369,ATL,1,240,48,86,55.8,14,30,46.7,34,56,60.71,17,18,94.4,4,32,36,28,6,7,11,12
2370,MIA,0,240,41,86,47.7,13,34,38.2,28,52,53.85,19,20,95,7,33,40,27,7,2,15,20
2371,UTA,0,240,42,98,42.9,11,37,29.7,31,61,50.82,7,15,46.7,17,34,51,30,6,2,13,21
2372,DEN,1,240,47,84,56,9,28,32.1,38,56,67.86,7,17,41.2,7,36,43,32,4,8,13,14
2373,MIN,0,240,44,90,48.9,16,33,48.5,28,57,49.12,9,15,60,10,28,38,24,5,5,14,17
2374,OKC,1,240,44,83,53,13,29,44.8,31,54,57.41,23,28,82.1,6,38,44,21,9,10,15,19
2375,DAL,1,240,42,84,50,23,47,48.9,19,37,51.35,18,24,75,6,42,48,24,4,7,15,17
2376,DET,0,240,39,91,42.9,15,28,53.6,24,63,38.1,19,24,79.2,13,28,41,31,6,5,17,25
2377,LAL,1,240,42,79,53.2,8,27,29.6,34,52,65.38,14,18,77.8,3,37,40,28,7,10,16,17
2378,GSW,1,240,51,98,52,15,41,36.6,36,57,63.16,13,20,65,21,43,64,28,6,7,15,21
2379,NOP,0,240,38,93,40.9,10,39,25.6,28,54,51.85,16,26,61.5,14,25,39,23,8,3,11,18
2380,IND,0,240,36,88,40.9,12,46,26.1,24,42,57.14,21,25,84,11,36,47,26,7,5,17,24
2381,DEN,1,240,53,88,60.2,11,27,40.7,42,61,68.85,11,13,84.6,10,38,48,34,8,5,13,21
2382,SAC,1,265,49,104,47.1,17,48,35.4,32,56,57.14,17,24,70.8,6,41,47,30,6,7,10,28
2383,SAS,0,240,30,80,37.5,11,33,33.3,19,47,40.43,12,16,75,6,31,37,21,9,6,25,23
2384,GSW,1,240,35,81,43.2,18,45,40,17,36,47.22,18,23,78.3,8,41,49,27,6,6,14,18
2385,POR,0,240,36,94,38.3,7,31,22.6,29,63,46.03,19,22,86.4,14,28,42,19,10,9,16,26
2386,MIL,0,240,39,86,45.3,16,44,36.4,23,42,54.76,16,20,80,12,27,39,22,10,3,23,22
2387,HOU,0,240,34,90,37.8,9,33,27.3,25,57,43.86,18,19,94.7,10,32,42,22,7,4,7,20
2388,ATL,1,240,47,93,50.5,15,37,40.5,32,56,57.14,18,22,81.8,13,33,46,32,15,2,17,17
2389,OKC,0,240,37,90,41.1,6,32,18.8,31,58,53.45,15,18,83.3,7,22,29,22,8,4,10,14
2390,PHI,1,240,40,82,48.8,11,28,39.3,29,54,53.7,35,40,87.5,11,40,51,28,10,17,16,20
2391,LAL,0,265,43,98,43.9,15,45,33.3,28,53,52.83,26,34,76.5,8,45,53,27,4,4,12,22
2392,LAC,1,240,47,91,51.6,16,42,38.1,31,49,63.27,13,21,61.9,9,39,48,23,15,5,16,16
2393,CHI,0,240,39,93,41.9,11,28,39.3,28,65,43.08,13,16,81.3,13,20,33,16,10,5,8,20
2394,NOP,1,240,40,87,46,9,33,27.3,31,54,57.41,7,16,43.8,4,39,43,20,8,5,13,22
2395,UTA,0,240,40,91,44,12,37,32.4,28,54,51.85,12,14,85.7,15,30,45,26,6,5,19,20
2396,PHI,1,240,43,86,50,10,28,35.7,33,58,56.9,18,21,85.7,9,33,42,25,8,7,11,18
2397,CLE,0,240,43,99,43.4,12,31,38.7,31,68,45.59,15,24,62.5,18,33,51,29,2,6,7,16
2398,PHX,1,240,45,85,52.9,10,37,27,35,48,72.92,26,28,92.9,7,32,39,31,10,7,11,19
2399,TOR,0,240,38,87,43.7,17,32,53.1,21,55,38.18,14,19,73.7,13,28,41,28,5,5,13,19
2400,IND,1,240,48,98,49,15,38,39.5,33,60,55,14,17,82.4,11,37,48,36,3,4,8,20
2401,MIA,0,240,35,87,40.2,12,38,31.6,23,49,46.94,8,14,57.1,9,33,42,24,6,1,15,12
2402,NYK,0,240,33,90,36.7,7,37,18.9,26,53,49.06,14,18,77.8,16,43,59,19,7,3,19,17
2403,MEM,0,240,39,91,42.9,19,47,40.4,20,44,45.45,9,9,100,6,39,45,27,7,8,18,21
2404,WAS,1,240,40,93,43,16,46,34.8,24,47,51.06,17,22,77.3,11,34,45,24,9,5,12,15
2405,DET,1,240,45,86,52.3,12,28,42.9,33,58,56.9,16,20,80,15,38,53,29,4,4,17,18
2406,MIN,1,240,44,86,51.2,12,34,35.3,32,52,61.54,6,8,75,7,40,47,30,9,3,16,17
2407,OKC,1,240,40,87,46,13,26,50,27,61,44.26,15,19,78.9,6,41,47,22,8,10,18,17
2408,LAC,0,240,41,77,53.2,14,35,40,27,42,64.29,22,28,78.6,6,30,36,17,8,6,16,22
2409,DAL,1,240,44,91,48.4,15,36,41.7,29,55,52.73,22,28,78.6,8,32,40,20,5,2,9,15
2410,SAC,0,240,41,94,43.6,12,40,30,29,54,53.7,20,29,69,10,31,41,24,10,3,14,16
2411,BKN,0,240,45,92,48.9,21,43,48.8,24,49,48.98,9,10,90,10,37,47,30,5,4,16,28
2412,MIA,0,240,38,89,42.7,16,33,48.5,22,56,39.29,19,23,82.6,11,34,45,24,8,6,12,16
2413,CLE,0,240,38,92,41.3,12,45,26.7,26,47,55.32,17,23,73.9,8,40,48,20,10,8,14,16
2414,DET,1,240,40,88,45.5,10,30,33.3,30,58,51.72,21,25,84,12,41,53,28,7,6,24,29
2415,CHA,0,240,33,88,37.5,7,28,25,26,60,43.33,26,34,76.5,11,30,41,20,13,7,18,23
2416,BOS,1,240,45,95,47.4,16,39,41,29,56,51.79,13,19,68.4,16,39,55,20,7,6,15,19
2417,GSW,1,240,48,87,55.2,14,32,43.8,34,55,61.82,12,14,85.7,7,32,39,32,14,3,19,24
2418,POR,0,240,35,88,39.8,9,32,28.1,26,56,46.43,18,21,85.7,15,32,47,15,6,1,16,24
2419,UTA,1,240,42,96,43.8,16,41,39,26,55,47.27,20,22,90.9,17,28,45,27,7,4,14,24
2420,NYK,1,240,43,90,47.8,20,44,45.5,23,46,50,20,28,71.4,12,33,45,30,9,6,16,21
2421,MEM,0,240,37,85,43.5,10,33,30.3,27,52,51.92,20,24,83.3,13,35,48,22,13,7,21,23
2422,ATL,0,240,42,87,48.3,12,32,37.5,30,55,54.55,24,30,80,9,35,44,28,7,6,14,20
2423,TOR,0,265,39,84,46.4,9,36,25,30,48,62.5,16,25,64,8,45,53,25,5,2,23,29
2424,CHI,1,265,37,99,37.4,8,39,20.5,29,60,48.33,22,28,78.6,15,37,52,18,10,5,17,22
2425,HOU,0,265,52,100,52,8,32,25,44,68,64.71,10,20,50,11,32,43,30,7,2,18,26
2426,ORL,1,240,36,79,45.6,9,28,32.1,27,51,52.94,21,32,65.6,10,35,45,22,10,5,14,16
2427,SAS,1,265,46,94,48.9,13,42,31,33,52,63.46,21,28,75,12,31,43,32,11,4,18,17
2428,DEN,1,240,41,88,46.6,14,37,37.8,27,51,52.94,12,18,66.7,6,34,40,27,11,10,19,18
2429,MIL,1,240,41,81,50.6,11,30,36.7,30,51,58.82,25,36,69.4,8,35,43,20,9,4,14,23
2430,LAL,1,240,36,84,42.9,5,29,17.2,31,55,56.36,23,29,79.3,8,34,42,24,14,7,16,23
2431,PHI,0,240,41,80,51.3,16,35,45.7,25,45,55.56,19,28,67.9,4,35,39,25,8,4,15,28
2432,PHX,0,240,34,81,42,9,31,29,25,50,50,18,23,78.3,10,39,49,16,7,3,24,21
2433,POR,0,240,44,93,47.3,10,32,31.3,34,61,55.74,13,17,76.5,15,25,40,20,10,4,18,20
2434,LAC,1,240,47,90,52.2,16,34,47.1,31,56,55.36,13,16,81.3,14,31,45,36,11,7,18,20
2435,NOP,1,240,40,85,47.1,14,32,43.8,26,53,49.06,17,22,77.3,11,41,52,22,8,5,21,21
2436,SAC,1,240,47,102,46.1,19,51,37.3,28,51,54.9,17,20,85,15,30,45,29,6,8,12,25
2437,UTA,0,240,41,91,45.1,9,28,32.1,32,63,50.79,23,31,74.2,16,38,54,22,6,2,14,20
2438,DAL,1,240,47,99,47.5,15,47,31.9,32,52,61.54,17,23,73.9,13,35,48,24,6,3,12,20
2439,CLE,1,240,44,94,46.8,17,43,39.5,27,51,52.94,9,10,90,9,29,38,25,10,6,10,23
2440,BOS,1,240,37,77,48.1,12,39,30.8,25,38,65.79,22,26,84.6,7,39,46,18,6,11,13,22
2441,DET,0,240,41,92,44.6,11,32,34.4,30,60,50,9,15,60,17,39,56,28,3,13,17,23
2442,MIA,1,240,37,92,40.2,8,22,36.4,29,70,41.43,21,26,80.8,16,32,48,22,11,3,7,18
2443,HOU,0,240,32,79,40.5,12,34,35.3,20,45,44.44,10,16,62.5,7,24,31,19,6,3,19,24
2444,TOR,1,240,36,90,40,14,35,40,22,55,40,11,16,68.8,8,39,47,27,9,11,14,18
2445,NYK,0,240,36,97,37.1,18,41,43.9,18,56,32.14,14,26,53.8,17,30,47,24,9,0,11,22
2446,CHA,1,240,43,86,50,11,37,29.7,32,49,65.31,19,26,73.1,12,39,51,34,5,3,19,21
2447,OKC,1,240,45,82,54.9,19,39,48.7,26,43,60.47,15,18,83.3,5,38,43,30,6,4,16,19
2448,IND,1,240,56,107,52.3,20,43,46.5,36,64,56.25,11,12,91.7,10,41,51,38,10,8,12,23
2449,ORL,1,240,42,87,48.3,9,34,26.5,33,53,62.26,23,26,88.5,17,40,57,19,8,6,16,20
2450,MEM,0,240,38,91,41.8,12,43,27.9,26,48,54.17,16,20,80,8,29,37,23,8,7,13,19
2451,WAS,0,240,44,96,45.8,9,24,37.5,35,72,48.61,23,29,79.3,11,34,45,28,6,9,14,11
2452,CHI,0,240,39,94,41.5,12,42,28.6,27,52,51.92,14,18,77.8,13,29,42,26,10,3,13,16
2453,ATL,0,240,39,93,41.9,5,29,17.2,34,64,53.12,27,33,81.8,12,30,42,24,12,1,12,19
2454,MIN,0,240,34,100,34,8,31,25.8,26,69,37.68,18,22,81.8,16,46,62,20,8,9,14,14
2455,BKN,0,240,42,84,50,9,27,33.3,33,57,57.89,20,26,76.9,13,37,50,30,6,6,18,16
2456,SAS,0,240,46,89,51.7,11,35,31.4,35,54,64.81,16,22,72.7,9,36,45,33,8,5,19,23
2457,LAL,0,240,41,90,45.6,10,29,34.5,31,61,50.82,15,20,75,13,31,44,23,5,4,12,18
2458,PHX,1,240,42,95,44.2,11,33,33.3,31,62,50,13,17,76.5,17,43,60,23,5,7,19,22
2459,DEN,1,240,48,91,52.7,14,34,41.2,34,57,59.65,9,12,75,9,33,42,29,9,6,12,15
2460,GSW,0,240,36,101,35.6,10,43,23.3,26,58,44.83,22,28,78.6,18,31,49,19,11,6,11,23
